name_admin_unit,part_of_district,admin_unit,sex___age_group__in_years_,all_sexes_overall,male_overall,female_overall,transgender_overall,all_sexes_rural,male_rural,female_rural,transgender_rural,all_sexes_urban,male_urban,female_urban,transgender_urban
ATTOCK,ATTOCK,DISTRICT,ALL AGES,2133005,1071693,1061231,81,1546356,775739,770599,18,586649,295954,290632,63
ATTOCK,ATTOCK,DISTRICT,UNDER 1,36042,18112,17930,,26655,13481,13174,,9387,4631,4756,
ATTOCK,ATTOCK,DISTRICT,UNDER 5,242301,121659,120642,,176066,88443,87623,,66235,33216,33019,
ATTOCK,ATTOCK,DISTRICT,UNDER 10,473463,237549,235914,,342189,171683,170506,,131274,65866,65408,
ATTOCK,ATTOCK,DISTRICT,UNDER 15,704284,353986,350297,1,505659,253890,251768,1,198625,100096,98529,
ATTOCK,ATTOCK,DISTRICT,05 - 24,838749,421934,416790,25,600830,301502,299320,8,237919,120432,117470,17
ATTOCK,ATTOCK,DISTRICT,15 - 49,1085185,538321,546791,73,782199,387552,394632,15,302986,150769,152159,58
ATTOCK,ATTOCK,DISTRICT,15 - 64,1311285,656132,655075,78,949693,474262,475415,16,361592,181870,179660,62
ATTOCK,ATTOCK,DISTRICT,18 - 60,1140222,567567,572584,71,826114,410873,415229,12,314108,156694,157355,59
ATTOCK,ATTOCK,DISTRICT,18 &  ABOVE,1304558,654717,649767,74,952003,477354,474636,13,352555,177363,175131,61
ATTOCK,ATTOCK,DISTRICT,60 &  ABOVE,178447,94363,84081,3,136384,71869,64514,1,42063,22494,19567,2
ATTOCK,ATTOCK,DISTRICT,65 &  ABOVE,117436,61575,55859,2,91004,47587,43416,1,26432,13988,12443,1
ATTOCK,ATTOCK,TEHSIL,ALL AGES,479094,241706,237360,28,226155,114308,111842,5,252939,127398,125518,23
ATTOCK,ATTOCK,TEHSIL,UNDER 1,8288,4108,4180,,4277,2149,2128,,4011,1959,2052,
ATTOCK,ATTOCK,TEHSIL,UNDER 5,56259,28224,28035,,28033,14069,13964,,28226,14155,14071,
ATTOCK,ATTOCK,TEHSIL,UNDER 10,109174,54907,54267,,52707,26572,26135,,56467,28335,28132,
ATTOCK,ATTOCK,TEHSIL,UNDER 15,162025,81349,80676,,76503,38346,38157,,85522,43003,42519,
ATTOCK,ATTOCK,TEHSIL,05 - 24,191932,96339,95585,8,89524,44877,44645,2,102408,51462,50940,6
ATTOCK,ATTOCK,TEHSIL,15 - 49,249604,124623,124954,27,117059,58796,58258,5,132545,65827,66696,22
ATTOCK,ATTOCK,TEHSIL,15 - 64,296296,149287,146981,28,139174,70336,68833,5,157122,78951,78148,23
ATTOCK,ATTOCK,TEHSIL,18 - 60,258515,129731,128758,26,121451,61311,60136,4,137064,68420,68622,22
ATTOCK,ATTOCK,TEHSIL,18 &  ABOVE,288646,145903,142716,27,136322,69324,66994,4,152324,76579,75722,23
ATTOCK,ATTOCK,TEHSIL,60 &  ABOVE,33120,17728,15391,1,16354,8790,7564,,16766,8938,7827,1
ATTOCK,ATTOCK,TEHSIL,65 &  ABOVE,20773,11070,9703,,10478,5626,4852,,10295,5444,4851,
FATEH JANG,ATTOCK,TEHSIL,ALL AGES,374726,189283,185426,17,293405,148263,145137,5,81321,41020,40289,12
FATEH JANG,ATTOCK,TEHSIL,UNDER 1,6295,3239,3056,,4838,2500,2338,,1457,739,718,
FATEH JANG,ATTOCK,TEHSIL,UNDER 5,43356,21980,21376,,33418,16853,16565,,9938,5127,4811,
FATEH JANG,ATTOCK,TEHSIL,UNDER 10,84285,42511,41774,,64969,32649,32320,,19316,9862,9454,
FATEH JANG,ATTOCK,TEHSIL,UNDER 15,124395,62746,61649,,95143,47712,47431,,29252,15034,14218,
FATEH JANG,ATTOCK,TEHSIL,05 - 24,145097,73163,71930,4,111387,56010,55376,1,33710,17153,16554,3
FATEH JANG,ATTOCK,TEHSIL,15 - 49,188187,93861,94312,14,147647,73938,73705,4,40540,19923,20607,10
FATEH JANG,ATTOCK,TEHSIL,15 - 64,228821,115169,113635,17,180362,91114,89243,5,48459,24055,24392,12
FATEH JANG,ATTOCK,TEHSIL,18 - 60,199545,99883,99645,17,157524,79223,78296,5,42021,20660,21349,12
FATEH JANG,ATTOCK,TEHSIL,18 &  ABOVE,229306,115806,113483,17,182082,92328,89749,5,47224,23478,23734,12
FATEH JANG,ATTOCK,TEHSIL,60 &  ABOVE,32295,17229,15066,,26555,14160,12395,,5740,3069,2671,
FATEH JANG,ATTOCK,TEHSIL,65 &  ABOVE,21510,11368,10142,,17900,9437,8463,,3610,1931,1679,
HASAN ABDAL,ATTOCK,TEHSIL,ALL AGES,253435,128983,124439,13,184082,93489,90592,1,69353,35494,33847,12
HASAN ABDAL,ATTOCK,TEHSIL,UNDER 1,4687,2351,2336,,3532,1788,1744,,1155,563,592,
HASAN ABDAL,ATTOCK,TEHSIL,UNDER 5,31316,15735,15581,,23166,11722,11444,,8150,4013,4137,
HASAN ABDAL,ATTOCK,TEHSIL,UNDER 10,61389,30785,30604,,45358,22874,22484,,16031,7911,8120,
HASAN ABDAL,ATTOCK,TEHSIL,UNDER 15,90911,45684,45227,,66740,33666,33074,,24171,12018,12153,
HASAN ABDAL,ATTOCK,TEHSIL,05 - 24,105454,53537,51912,5,76024,38486,37537,1,29430,15051,14375,4
HASAN ABDAL,ATTOCK,TEHSIL,15 - 49,126356,63898,62446,12,90753,45638,45114,1,35603,18260,17332,11
HASAN ABDAL,ATTOCK,TEHSIL,15 - 64,151028,77037,73978,13,108545,54996,53548,1,42483,22041,20430,12
HASAN ABDAL,ATTOCK,TEHSIL,18 - 60,130434,66078,64343,13,94024,47388,46635,1,36410,18690,17708,12
HASAN ABDAL,ATTOCK,TEHSIL,18 &  ABOVE,147039,75255,71771,13,106566,54332,52233,1,40473,20923,19538,12
HASAN ABDAL,ATTOCK,TEHSIL,60 &  ABOVE,18029,9914,8115,,13610,7504,6106,,4419,2410,2009,
HASAN ABDAL,ATTOCK,TEHSIL,65 &  ABOVE,11496,6262,5234,,8797,4827,3970,,2699,1435,1264,
HAZRO,ATTOCK,TEHSIL,ALL AGES,386544,195013,191525,6,323572,163256,160314,2,62972,31757,31211,4
HAZRO,ATTOCK,TEHSIL,UNDER 1,6868,3497,3371,,5918,3010,2908,,950,487,463,
HAZRO,ATTOCK,TEHSIL,UNDER 5,45130,22578,22552,,38251,19155,19096,,6879,3423,3456,
HAZRO,ATTOCK,TEHSIL,UNDER 10,87196,43560,43636,,73639,36823,36816,,13557,6737,6820,
HAZRO,ATTOCK,TEHSIL,UNDER 15,131073,66132,64940,1,110179,55576,54602,1,20894,10556,10338,
HAZRO,ATTOCK,TEHSIL,05 - 24,159076,80572,78502,2,133206,67333,65871,2,25870,13239,12631,
HAZRO,ATTOCK,TEHSIL,15 - 49,196446,97715,98726,5,164398,81771,82626,1,32048,15944,16100,4
HAZRO,ATTOCK,TEHSIL,15 - 64,235136,117919,117212,5,196476,98549,97926,1,38660,19370,19286,4
HAZRO,ATTOCK,TEHSIL,18 - 60,203317,101518,101795,4,169903,84942,84961,,33414,16576,16834,4
HAZRO,ATTOCK,TEHSIL,18 &  ABOVE,231471,116748,114719,4,193263,97577,95686,,38208,19171,19033,4
HAZRO,ATTOCK,TEHSIL,60 &  ABOVE,30921,16569,14352,,25675,13764,11911,,5246,2805,2441,
HAZRO,ATTOCK,TEHSIL,65 &  ABOVE,20335,10962,9373,,16917,9131,7786,,3418,1831,1587,
JAND,ATTOCK,TEHSIL,ALL AGES,330328,162882,167439,7,274074,135158,138913,3,56254,27724,28526,4
JAND,ATTOCK,TEHSIL,UNDER 1,4817,2425,2392,,3867,1967,1900,,950,458,492,
JAND,ATTOCK,TEHSIL,UNDER 5,33625,16872,16753,,27633,13883,13750,,5992,2989,3003,
JAND,ATTOCK,TEHSIL,UNDER 10,67180,33716,33464,,54916,27536,27380,,12264,6180,6084,
JAND,ATTOCK,TEHSIL,UNDER 15,100155,50334,49821,,81759,41113,40646,,18396,9221,9175,
JAND,ATTOCK,TEHSIL,05 - 24,122016,60826,61188,2,99756,49713,50041,2,22260,11113,11147,
JAND,ATTOCK,TEHSIL,15 - 49,167794,81175,86613,6,138824,67269,71553,2,28970,13906,15060,4
JAND,ATTOCK,TEHSIL,15 - 64,207241,101082,106153,6,172334,84081,88251,2,34907,17001,17902,4
JAND,ATTOCK,TEHSIL,18 - 60,180338,87381,92953,4,150110,72820,77290,,30228,14561,15663,4
JAND,ATTOCK,TEHSIL,18 &  ABOVE,211896,103386,108505,5,177430,86617,90812,1,34466,16769,17693,4
JAND,ATTOCK,TEHSIL,60 &  ABOVE,33813,17162,16650,1,29258,14784,14473,1,4555,2378,2177,
JAND,ATTOCK,TEHSIL,65 &  ABOVE,22932,11466,11465,1,19981,9964,10016,1,2951,1502,1449,
PINDI GHEB,ATTOCK,TEHSIL,ALL AGES,308878,153826,155042,10,245068,121265,123801,2,63810,32561,31241,8
PINDI GHEB,ATTOCK,TEHSIL,UNDER 1,5087,2492,2595,,4223,2067,2156,,864,425,439,
PINDI GHEB,ATTOCK,TEHSIL,UNDER 5,32615,16270,16345,,25565,12761,12804,,7050,3509,3541,
PINDI GHEB,ATTOCK,TEHSIL,UNDER 10,64239,32070,32169,,50600,25229,25371,,13639,6841,6798,
PINDI GHEB,ATTOCK,TEHSIL,UNDER 15,95725,47741,47984,,75335,37477,37858,,20390,10264,10126,
PINDI GHEB,ATTOCK,TEHSIL,05 - 24,115174,57497,57673,4,90933,45083,45850,,24241,12414,11823,4
PINDI GHEB,ATTOCK,TEHSIL,15 - 49,156798,77049,79740,9,123518,60140,63376,2,33280,16909,16364,7
PINDI GHEB,ATTOCK,TEHSIL,15 - 64,192763,95638,97116,9,152802,75186,77614,2,39961,20452,19502,7
PINDI GHEB,ATTOCK,TEHSIL,18 - 60,168073,82976,85090,7,133102,65189,67911,2,34971,17787,17179,5
PINDI GHEB,ATTOCK,TEHSIL,18 &  ABOVE,196200,97619,98573,8,156340,77176,79162,2,39860,20443,19411,6
PINDI GHEB,ATTOCK,TEHSIL,60 &  ABOVE,30269,15761,14507,1,24932,12867,12065,,5337,2894,2442,1
PINDI GHEB,ATTOCK,TEHSIL,65 &  ABOVE,20390,10447,9942,1,16931,8602,8329,,3459,1845,1613,1
BAHAWALNAGAR,BAHAWALNAGAR,DISTRICT,ALL AGES,3544911,1842888,1701653,370,2571296,1336950,1234246,100,973615,505938,467407,270
BAHAWALNAGAR,BAHAWALNAGAR,DISTRICT,UNDER 1,82644,42545,40099,,62428,32064,30364,,20216,10481,9735,
BAHAWALNAGAR,BAHAWALNAGAR,DISTRICT,UNDER 5,492678,255505,237173,,372426,193408,179018,,120252,62097,58155,
BAHAWALNAGAR,BAHAWALNAGAR,DISTRICT,UNDER 10,971921,506050,465871,,730322,380606,349716,,241599,125444,116155,
BAHAWALNAGAR,BAHAWALNAGAR,DISTRICT,UNDER 15,1422368,750449,671905,14,1054742,555502,499229,11,367626,194947,172676,3
BAHAWALNAGAR,BAHAWALNAGAR,DISTRICT,05 - 24,1564111,823528,740475,108,1130720,594490,536191,39,433391,229038,204284,69
BAHAWALNAGAR,BAHAWALNAGAR,DISTRICT,15 - 49,1656708,843332,813067,309,1176647,599750,576820,77,480061,243582,236247,232
BAHAWALNAGAR,BAHAWALNAGAR,DISTRICT,15 - 64,1978187,1013649,964189,349,1407922,721982,685852,88,570265,291667,278337,261
BAHAWALNAGAR,BAHAWALNAGAR,DISTRICT,18 - 60,1699512,864400,834789,323,1210292,616534,593687,71,489220,247866,241102,252
BAHAWALNAGAR,BAHAWALNAGAR,DISTRICT,18 &  ABOVE,1905181,976156,928692,333,1363059,699601,663386,72,542122,276555,265306,261
BAHAWALNAGAR,BAHAWALNAGAR,DISTRICT,60 &  ABOVE,225309,122029,103265,15,167221,90600,76618,3,58088,31429,26647,12
BAHAWALNAGAR,BAHAWALNAGAR,DISTRICT,65 &  ABOVE,144356,78790,65559,7,108632,59466,49165,1,35724,19324,16394,6
BAHAWALNAGAR,BAHAWALNAGAR,TEHSIL,ALL AGES,973483,507811,465575,97,692476,361246,331203,27,281007,146565,134372,70
BAHAWALNAGAR,BAHAWALNAGAR,TEHSIL,UNDER 1,23473,12032,11441,,17787,9103,8684,,5686,2929,2757,
BAHAWALNAGAR,BAHAWALNAGAR,TEHSIL,UNDER 5,137252,71251,66001,,103356,53869,49487,,33896,17382,16514,
BAHAWALNAGAR,BAHAWALNAGAR,TEHSIL,UNDER 10,273672,143051,130621,,204674,107264,97410,,68998,35787,33211,
BAHAWALNAGAR,BAHAWALNAGAR,TEHSIL,UNDER 15,400969,212511,188452,6,296406,157065,139337,4,104563,55446,49115,2
BAHAWALNAGAR,BAHAWALNAGAR,TEHSIL,05 - 24,438220,232028,206167,25,313821,166093,147718,10,124399,65935,58449,15
BAHAWALNAGAR,BAHAWALNAGAR,TEHSIL,15 - 49,452028,231501,220451,76,311094,159229,151846,19,140934,72272,68605,57
BAHAWALNAGAR,BAHAWALNAGAR,TEHSIL,15 - 64,536751,276386,260276,89,370258,190393,179842,23,166493,85993,80434,66
BAHAWALNAGAR,BAHAWALNAGAR,TEHSIL,18 - 60,461784,235920,225782,82,317875,162279,155577,19,143909,73641,70205,63
BAHAWALNAGAR,BAHAWALNAGAR,TEHSIL,18 &  ABOVE,513416,263377,249953,86,354689,181903,172767,19,158727,81474,77186,67
BAHAWALNAGAR,BAHAWALNAGAR,TEHSIL,60 &  ABOVE,56643,30070,26567,6,40433,21528,18905,,16210,8542,7662,6
BAHAWALNAGAR,BAHAWALNAGAR,TEHSIL,65 &  ABOVE,35763,18914,16847,2,25812,13788,12024,,9951,5126,4823,2
CHISHTIAN,BAHAWALNAGAR,TEHSIL,ALL AGES,843342,437370,405853,119,614192,318904,295242,46,229150,118466,110611,73
CHISHTIAN,BAHAWALNAGAR,TEHSIL,UNDER 1,19327,9984,9343,,14771,7616,7155,,4556,2368,2188,
CHISHTIAN,BAHAWALNAGAR,TEHSIL,UNDER 5,112296,57928,54368,,85651,44211,41440,,26645,13717,12928,
CHISHTIAN,BAHAWALNAGAR,TEHSIL,UNDER 10,225170,117080,108090,,170773,89064,81709,,54397,28016,26381,
CHISHTIAN,BAHAWALNAGAR,TEHSIL,UNDER 15,332180,175378,156797,5,247909,130766,117139,4,84271,44612,39658,1
CHISHTIAN,BAHAWALNAGAR,TEHSIL,05 - 24,369621,194662,174926,33,268555,141280,127258,17,101066,53382,47668,16
CHISHTIAN,BAHAWALNAGAR,TEHSIL,15 - 49,397702,201243,196356,103,283770,143923,139810,37,113932,57320,56546,66
CHISHTIAN,BAHAWALNAGAR,TEHSIL,15 - 64,476294,242852,233329,113,340142,173759,166342,41,136152,69093,66987,72
CHISHTIAN,BAHAWALNAGAR,TEHSIL,18 - 60,409744,207204,202437,103,293067,148670,144363,34,116677,58534,58074,69
CHISHTIAN,BAHAWALNAGAR,TEHSIL,18 &  ABOVE,459735,234503,225128,104,330124,168944,161145,35,129611,65559,63983,69
CHISHTIAN,BAHAWALNAGAR,TEHSIL,60 &  ABOVE,54830,29925,24903,2,40686,22248,18436,2,14144,7677,6467,
CHISHTIAN,BAHAWALNAGAR,TEHSIL,65 &  ABOVE,34868,19140,15727,1,26141,14379,11761,1,8727,4761,3966,
FORT ABBAS,BAHAWALNAGAR,TEHSIL,ALL AGES,509974,266077,243865,32,375999,195869,180124,6,133975,70208,63741,26
FORT ABBAS,BAHAWALNAGAR,TEHSIL,UNDER 1,13364,7003,6361,,9865,5135,4730,,3499,1868,1631,
FORT ABBAS,BAHAWALNAGAR,TEHSIL,UNDER 5,77593,40709,36884,,58036,30489,27547,,19557,10220,9337,
FORT ABBAS,BAHAWALNAGAR,TEHSIL,UNDER 10,144248,75414,68834,,107541,56191,51350,,36707,19223,17484,
FORT ABBAS,BAHAWALNAGAR,TEHSIL,UNDER 15,206665,109474,97189,2,152166,80206,71958,2,54499,29268,25231,
FORT ABBAS,BAHAWALNAGAR,TEHSIL,05 - 24,218646,115117,103523,6,158998,83145,75849,4,59648,31972,27674,2
FORT ABBAS,BAHAWALNAGAR,TEHSIL,15 - 49,235904,119932,115950,22,172850,87927,84919,4,63054,32005,31031,18
FORT ABBAS,BAHAWALNAGAR,TEHSIL,15 - 64,281926,144648,137249,29,207146,106333,100809,4,74780,38315,36440,25
FORT ABBAS,BAHAWALNAGAR,TEHSIL,18 - 60,242320,123454,118841,25,178531,91139,87390,2,63789,32315,31451,23
FORT ABBAS,BAHAWALNAGAR,TEHSIL,18 &  ABOVE,272512,140156,132329,27,201833,104021,97810,2,70679,36135,34519,25
FORT ABBAS,BAHAWALNAGAR,TEHSIL,60 &  ABOVE,32978,18159,14816,3,25359,13933,11426,,7619,4226,3390,3
FORT ABBAS,BAHAWALNAGAR,TEHSIL,65 &  ABOVE,21383,11955,9427,1,16687,9330,7357,,4696,2625,2070,1
HAROONABAD,BAHAWALNAGAR,TEHSIL,ALL AGES,614987,317548,297346,93,403740,208182,195545,13,211247,109366,101801,80
HAROONABAD,BAHAWALNAGAR,TEHSIL,UNDER 1,13582,6919,6663,,9578,4869,4709,,4004,2050,1954,
HAROONABAD,BAHAWALNAGAR,TEHSIL,UNDER 5,78818,40943,37875,,54298,28225,26073,,24520,12718,11802,
HAROONABAD,BAHAWALNAGAR,TEHSIL,UNDER 10,154213,79954,74259,,104202,53848,50354,,50011,26106,23905,
HAROONABAD,BAHAWALNAGAR,TEHSIL,UNDER 15,228438,119739,108698,1,152113,79264,72848,1,76325,40475,35850,
HAROONABAD,BAHAWALNAGAR,TEHSIL,05 - 24,263998,137712,126248,38,170366,88508,81852,6,93632,49204,44396,32
HAROONABAD,BAHAWALNAGAR,TEHSIL,15 - 49,298426,150890,147451,85,192170,97388,94771,11,106256,53502,52680,74
HAROONABAD,BAHAWALNAGAR,TEHSIL,15 - 64,358230,182233,175907,90,231517,117894,113611,12,126713,64339,62296,78
HAROONABAD,BAHAWALNAGAR,TEHSIL,18 - 60,307175,155193,151895,87,198625,100613,98002,10,108550,54580,53893,77
HAROONABAD,BAHAWALNAGAR,TEHSIL,18 &  ABOVE,347451,177140,170222,89,226686,115821,110855,10,120765,61319,59367,79
HAROONABAD,BAHAWALNAGAR,TEHSIL,60 &  ABOVE,43838,23742,20094,2,30387,16367,14020,,13451,7375,6074,2
HAROONABAD,BAHAWALNAGAR,TEHSIL,65 &  ABOVE,28319,15576,12741,2,20110,11024,9086,,8209,4552,3655,2
MINCHINABAD,BAHAWALNAGAR,TEHSIL,ALL AGES,603125,314082,289014,29,484889,252749,232132,8,118236,61333,56882,21
MINCHINABAD,BAHAWALNAGAR,TEHSIL,UNDER 1,12898,6607,6291,,10427,5341,5086,,2471,1266,1205,
MINCHINABAD,BAHAWALNAGAR,TEHSIL,UNDER 5,86719,44674,42045,,71085,36614,34471,,15634,8060,7574,
MINCHINABAD,BAHAWALNAGAR,TEHSIL,UNDER 10,174618,90551,84067,,143132,74239,68893,,31486,16312,15174,
MINCHINABAD,BAHAWALNAGAR,TEHSIL,UNDER 15,254116,133347,120769,,206148,108201,97947,,47968,25146,22822,
MINCHINABAD,BAHAWALNAGAR,TEHSIL,05 - 24,273626,144009,129611,6,218980,115464,103514,2,54646,28545,26097,4
MINCHINABAD,BAHAWALNAGAR,TEHSIL,15 - 49,272648,139766,132859,23,216763,111283,105474,6,55885,28483,27385,17
MINCHINABAD,BAHAWALNAGAR,TEHSIL,15 - 64,324986,167530,157428,28,258859,133603,125248,8,66127,33927,32180,20
MINCHINABAD,BAHAWALNAGAR,TEHSIL,18 - 60,278489,142629,135834,26,222194,113833,108355,6,56295,28796,27479,20
MINCHINABAD,BAHAWALNAGAR,TEHSIL,18 &  ABOVE,312067,160980,151060,27,249727,128912,120809,6,62340,32068,30251,21
MINCHINABAD,BAHAWALNAGAR,TEHSIL,60 &  ABOVE,37020,20133,16885,2,30356,16524,13831,1,6664,3609,3054,1
MINCHINABAD,BAHAWALNAGAR,TEHSIL,65 &  ABOVE,24023,13205,10817,1,19882,10945,8937,,4141,2260,1880,1
BAHAWALPUR,BAHAWALPUR,DISTRICT,ALL AGES,4264457,2165158,2098830,469,2662487,1350146,1312204,137,1601970,815012,786626,332
BAHAWALPUR,BAHAWALPUR,DISTRICT,UNDER 1,98488,49555,48933,,65236,33071,32165,,33252,16484,16768,
BAHAWALPUR,BAHAWALPUR,DISTRICT,UNDER 5,648391,327153,321238,,425688,214443,211245,,222703,112710,109993,
BAHAWALPUR,BAHAWALPUR,DISTRICT,UNDER 10,1231401,621096,610305,,810526,408308,402218,,420875,212788,208087,
BAHAWALPUR,BAHAWALPUR,DISTRICT,UNDER 15,1743712,880903,862791,18,1134011,572023,561978,10,609701,308880,300813,8
BAHAWALPUR,BAHAWALPUR,DISTRICT,05 - 24,1867130,942704,924269,157,1168874,589304,579525,45,698256,353400,344744,112
BAHAWALPUR,BAHAWALPUR,DISTRICT,15 - 49,2012350,1013130,998815,405,1212500,610455,601937,108,799850,402675,396878,297
BAHAWALPUR,BAHAWALPUR,DISTRICT,15 - 64,2365200,1200957,1163802,441,1427203,724072,703010,121,937997,476885,460792,320
BAHAWALPUR,BAHAWALPUR,DISTRICT,18 - 60,2047295,1036582,1010307,406,1233367,624817,608444,106,813928,411765,401863,300
BAHAWALPUR,BAHAWALPUR,DISTRICT,18 &  ABOVE,2270437,1156101,1113919,417,1375694,700450,675132,112,894743,455651,438787,305
BAHAWALPUR,BAHAWALPUR,DISTRICT,60 &  ABOVE,244347,130869,113462,16,155150,82487,72656,7,89197,48382,40806,9
BAHAWALPUR,BAHAWALPUR,DISTRICT,65 &  ABOVE,155545,83298,72237,10,101273,54051,47216,6,54272,29247,25021,4
AHMADPUR EAST,BAHAWALPUR,TEHSIL,ALL AGES,1307408,665954,641322,132,958833,488288,470526,19,348575,177666,170796,113
AHMADPUR EAST,BAHAWALPUR,TEHSIL,UNDER 1,39552,20116,19436,,28893,14659,14234,,10659,5457,5202,
AHMADPUR EAST,BAHAWALPUR,TEHSIL,UNDER 5,245824,125847,119977,,181006,91874,89132,,64818,33973,30845,
AHMADPUR EAST,BAHAWALPUR,TEHSIL,UNDER 10,445252,227467,217785,,332758,169106,163652,,112494,58361,54133,
AHMADPUR EAST,BAHAWALPUR,TEHSIL,UNDER 15,605430,309479,295947,4,451282,229814,221465,3,154148,79665,74482,1
AHMADPUR EAST,BAHAWALPUR,TEHSIL,05 - 24,576808,293006,283761,41,428238,218013,210217,8,148570,74993,73544,33
AHMADPUR EAST,BAHAWALPUR,TEHSIL,15 - 49,562602,283588,278899,115,406665,205917,200734,14,155937,77671,78165,101
AHMADPUR EAST,BAHAWALPUR,TEHSIL,15 - 64,657752,333520,324105,127,474992,241524,233452,16,182760,91996,90653,111
AHMADPUR EAST,BAHAWALPUR,TEHSIL,18 - 60,566290,286781,279394,115,408939,207704,201221,14,157351,79077,78173,101
AHMADPUR EAST,BAHAWALPUR,TEHSIL,18 &  ABOVE,628886,319063,309706,117,454646,231226,223406,14,174240,87837,86300,103
AHMADPUR EAST,BAHAWALPUR,TEHSIL,60 &  ABOVE,68161,35263,32892,6,49698,25637,24060,1,18463,9626,8832,5
AHMADPUR EAST,BAHAWALPUR,TEHSIL,65 &  ABOVE,44226,22955,21270,1,32559,16950,15609,,11667,6005,5661,1
BAHAWALPUR CITY,BAHAWALPUR,TEHSIL,ALL AGES,813422,414027,399293,102,,,,,813422,414027,399293,102
BAHAWALPUR CITY,BAHAWALPUR,TEHSIL,UNDER 1,14972,7309,7663,,,,,,14972,7309,7663,
BAHAWALPUR CITY,BAHAWALPUR,TEHSIL,UNDER 5,100598,49995,50603,,,,,,100598,49995,50603,
BAHAWALPUR CITY,BAHAWALPUR,TEHSIL,UNDER 10,197025,98686,98339,,,,,,197025,98686,98339,
BAHAWALPUR CITY,BAHAWALPUR,TEHSIL,UNDER 15,291481,147126,144355,,,,,,291481,147126,144355,
BAHAWALPUR CITY,BAHAWALPUR,TEHSIL,05 - 24,360631,183625,176968,38,,,,,360631,183625,176968,38
BAHAWALPUR CITY,BAHAWALPUR,TEHSIL,15 - 49,423183,213417,209669,97,,,,,423183,213417,209669,97
BAHAWALPUR CITY,BAHAWALPUR,TEHSIL,15 - 64,495209,252164,242944,101,,,,,495209,252164,242944,101
BAHAWALPUR CITY,BAHAWALPUR,TEHSIL,18 - 60,430986,217813,213074,99,,,,,430986,217813,213074,99
BAHAWALPUR CITY,BAHAWALPUR,TEHSIL,18 &  ABOVE,471673,240406,231167,100,,,,,471673,240406,231167,100
BAHAWALPUR CITY,BAHAWALPUR,TEHSIL,60 &  ABOVE,45042,24891,20150,1,,,,,45042,24891,20150,1
BAHAWALPUR CITY,BAHAWALPUR,TEHSIL,65 &  ABOVE,26732,14737,11994,1,,,,,26732,14737,11994,1
BAHAWALPUR SADDAR,BAHAWALPUR,TEHSIL,ALL AGES,661543,338536,322907,100,524996,266854,258100,42,136547,71682,64807,58
BAHAWALPUR SADDAR,BAHAWALPUR,TEHSIL,UNDER 1,14552,7412,7140,,12606,6468,6138,,1946,944,1002,
BAHAWALPUR SADDAR,BAHAWALPUR,TEHSIL,UNDER 5,101681,51436,50245,,83052,41976,41076,,18629,9460,9169,
BAHAWALPUR SADDAR,BAHAWALPUR,TEHSIL,UNDER 10,193562,98068,95494,,157481,79687,77794,,36081,18381,17700,
BAHAWALPUR SADDAR,BAHAWALPUR,TEHSIL,UNDER 15,273668,139071,134584,13,221058,112139,108913,6,52610,26932,25671,7
BAHAWALPUR SADDAR,BAHAWALPUR,TEHSIL,05 - 24,289335,147022,142270,43,230344,116601,113725,18,58991,30421,28545,25
BAHAWALPUR SADDAR,BAHAWALPUR,TEHSIL,15 - 49,312282,159201,153002,79,243126,122678,120417,31,69156,36523,32585,48
BAHAWALPUR SADDAR,BAHAWALPUR,TEHSIL,15 - 64,365429,187586,177758,85,285371,144992,140345,34,80058,42594,37413,51
BAHAWALPUR SADDAR,BAHAWALPUR,TEHSIL,18 - 60,317114,162580,154460,74,247317,125501,121790,26,69797,37079,32670,48
BAHAWALPUR SADDAR,BAHAWALPUR,TEHSIL,18 &  ABOVE,349447,179818,169553,76,273790,139434,134328,28,75657,40384,35225,48
BAHAWALPUR SADDAR,BAHAWALPUR,TEHSIL,60 &  ABOVE,35644,19048,16594,2,29023,15322,13699,2,6621,3726,2895,
BAHAWALPUR SADDAR,BAHAWALPUR,TEHSIL,65 &  ABOVE,22446,11879,10565,2,18567,9723,8842,2,3879,2156,1723,
HASILPUR,BAHAWALPUR,TEHSIL,ALL AGES,506604,253429,253133,42,310921,155620,155294,7,195683,97809,97839,35
HASILPUR,BAHAWALPUR,TEHSIL,UNDER 1,9785,4873,4912,,6149,3099,3050,,3636,1774,1862,
HASILPUR,BAHAWALPUR,TEHSIL,UNDER 5,65669,32790,32879,,40833,20372,20461,,24836,12418,12418,
HASILPUR,BAHAWALPUR,TEHSIL,UNDER 10,129785,64593,65192,,81075,40298,40777,,48710,24295,24415,
HASILPUR,BAHAWALPUR,TEHSIL,UNDER 15,190381,94463,95917,1,118231,58742,59488,1,72150,35721,36429,
HASILPUR,BAHAWALPUR,TEHSIL,05 - 24,216731,107489,109228,14,132817,65865,66950,2,83914,41624,42278,12
HASILPUR,BAHAWALPUR,TEHSIL,15 - 49,245678,121419,124221,38,148534,73273,75255,6,97144,48146,48966,32
HASILPUR,BAHAWALPUR,TEHSIL,15 - 64,293716,146794,146883,39,177997,88861,89130,6,115719,57933,57753,33
HASILPUR,BAHAWALPUR,TEHSIL,18 - 60,253830,126448,127348,34,153753,76478,77270,5,100077,49970,50078,29
HASILPUR,BAHAWALPUR,TEHSIL,18 &  ABOVE,285701,143569,142096,36,174270,87594,86671,5,111431,55975,55425,31
HASILPUR,BAHAWALPUR,TEHSIL,60 &  ABOVE,34760,18655,16103,2,22330,12075,10255,,12430,6580,5848,2
HASILPUR,BAHAWALPUR,TEHSIL,65 &  ABOVE,22507,12172,10333,2,14693,8017,6676,,7814,4155,3657,2
KHAIRPUR TAMEWALI,BAHAWALPUR,TEHSIL,ALL AGES,288741,145773,142952,16,241592,122056,119525,11,47149,23717,23427,5
KHAIRPUR TAMEWALI,BAHAWALPUR,TEHSIL,UNDER 1,5883,2913,2970,,5019,2503,2516,,864,410,454,
KHAIRPUR TAMEWALI,BAHAWALPUR,TEHSIL,UNDER 5,39021,19322,19699,,33076,16372,16704,,5945,2950,2995,
KHAIRPUR TAMEWALI,BAHAWALPUR,TEHSIL,UNDER 10,77730,38739,38991,,66289,33120,33169,,11441,5619,5822,
KHAIRPUR TAMEWALI,BAHAWALPUR,TEHSIL,UNDER 15,112747,56410,56337,,95614,47906,47708,,17133,8504,8629,
KHAIRPUR TAMEWALI,BAHAWALPUR,TEHSIL,05 - 24,125963,63047,62912,4,105587,52889,52696,2,20376,10158,10216,2
KHAIRPUR TAMEWALI,BAHAWALPUR,TEHSIL,15 - 49,138649,69515,69123,11,114797,57578,57211,8,23852,11937,11912,3
KHAIRPUR TAMEWALI,BAHAWALPUR,TEHSIL,15 - 64,163903,82957,80933,13,135716,68688,67020,8,28187,14269,13913,5
KHAIRPUR TAMEWALI,BAHAWALPUR,TEHSIL,18 - 60,142415,71957,70447,11,118001,59666,58328,7,24414,12291,12119,4
KHAIRPUR TAMEWALI,BAHAWALPUR,TEHSIL,18 &  ABOVE,159085,80831,78240,14,132057,67149,64898,10,27028,13682,13342,4
KHAIRPUR TAMEWALI,BAHAWALPUR,TEHSIL,60 &  ABOVE,18256,9708,8545,3,15354,8161,7190,3,2902,1547,1355,
KHAIRPUR TAMEWALI,BAHAWALPUR,TEHSIL,65 &  ABOVE,12091,6406,5682,3,10262,5462,4797,3,1829,944,885,
YAZMAN,BAHAWALPUR,TEHSIL,ALL AGES,686739,347439,339223,77,626145,317328,308759,58,60594,30111,30464,19
YAZMAN,BAHAWALPUR,TEHSIL,UNDER 1,13744,6932,6812,,12569,6342,6227,,1175,590,585,
YAZMAN,BAHAWALPUR,TEHSIL,UNDER 5,95598,47763,47835,,87721,43849,43872,,7877,3914,3963,
YAZMAN,BAHAWALPUR,TEHSIL,UNDER 10,188047,93543,94504,,172923,86097,86826,,15124,7446,7678,
YAZMAN,BAHAWALPUR,TEHSIL,UNDER 15,270005,134354,135651,,247826,123422,124404,,22179,10932,11247,
YAZMAN,BAHAWALPUR,TEHSIL,05 - 24,297662,148515,149130,17,271888,135936,135937,15,25774,12579,13193,2
YAZMAN,BAHAWALPUR,TEHSIL,15 - 49,329956,165990,163901,65,299378,151009,148320,49,30578,14981,15581,16
YAZMAN,BAHAWALPUR,TEHSIL,15 - 64,389191,197936,191179,76,353127,180007,173063,57,36064,17929,18116,19
YAZMAN,BAHAWALPUR,TEHSIL,18 - 60,336660,171003,165584,73,305357,155468,149835,54,31303,15535,15749,19
YAZMAN,BAHAWALPUR,TEHSIL,18 &  ABOVE,375645,192414,183157,74,340931,175047,165829,55,34714,17367,17328,19
YAZMAN,BAHAWALPUR,TEHSIL,60 &  ABOVE,42484,23304,19178,2,38745,21292,17452,1,3739,2012,1726,1
YAZMAN,BAHAWALPUR,TEHSIL,65 &  ABOVE,27543,15149,12393,1,25192,13899,11292,1,2351,1250,1101,
BHAKKAR,BHAKKAR,DISTRICT,ALL AGES,1956971,1016124,940770,77,1604680,833033,771611,36,352291,183091,169159,41
BHAKKAR,BHAKKAR,DISTRICT,UNDER 1,74322,40225,34097,,61743,33508,28235,,12579,6717,5862,
BHAKKAR,BHAKKAR,DISTRICT,UNDER 5,350083,188537,161546,,290240,155990,134250,,59843,32547,27296,
BHAKKAR,BHAKKAR,DISTRICT,UNDER 10,593924,314658,279266,,493889,261481,232408,,100035,53177,46858,
BHAKKAR,BHAKKAR,DISTRICT,UNDER 15,810806,429024,381779,3,673154,355791,317360,3,137652,73233,64419,
BHAKKAR,BHAKKAR,DISTRICT,05 - 24,801860,416700,385136,24,661033,343482,317536,15,140827,73218,67600,9
BHAKKAR,BHAKKAR,DISTRICT,15 - 49,902627,456285,446278,64,732486,370118,362339,29,170141,86167,83939,35
BHAKKAR,BHAKKAR,DISTRICT,15 - 64,1070920,545969,524878,73,869179,442971,426175,33,201741,102998,98703,40
BHAKKAR,BHAKKAR,DISTRICT,18 - 60,923928,468016,455851,61,749521,379710,369785,26,174407,88306,86066,35
BHAKKAR,BHAKKAR,DISTRICT,18 &  ABOVE,1032028,527089,504875,64,838142,428258,409858,26,193886,98831,95017,38
BHAKKAR,BHAKKAR,DISTRICT,60 &  ABOVE,117485,64170,53311,4,96215,52712,43503,,21270,11458,9808,4
BHAKKAR,BHAKKAR,DISTRICT,65 &  ABOVE,75245,41131,34113,1,62347,34271,28076,,12898,6860,6037,1
BHAKKAR,BHAKKAR,TEHSIL,ALL AGES,809649,421191,388421,37,650306,338051,312238,17,159343,83140,76183,20
BHAKKAR,BHAKKAR,TEHSIL,UNDER 1,27751,14793,12958,,22760,12131,10629,,4991,2662,2329,
BHAKKAR,BHAKKAR,TEHSIL,UNDER 5,150143,81262,68881,,121669,65431,56238,,28474,15831,12643,
BHAKKAR,BHAKKAR,TEHSIL,UNDER 10,250537,133335,117202,,204400,108474,95926,,46137,24861,21276,
BHAKKAR,BHAKKAR,TEHSIL,UNDER 15,341477,180980,160495,2,278490,147140,131348,2,62987,33840,29147,
BHAKKAR,BHAKKAR,TEHSIL,05 - 24,333263,173106,160144,13,270969,140771,130190,8,62294,32335,29954,5
BHAKKAR,BHAKKAR,TEHSIL,15 - 49,370750,187638,183083,29,294972,149438,145521,13,75778,38200,37562,16
BHAKKAR,BHAKKAR,TEHSIL,15 - 64,439193,224277,214881,35,348584,178101,170468,15,90609,46176,44413,20
BHAKKAR,BHAKKAR,TEHSIL,18 - 60,377703,191637,186038,28,299286,152048,147226,12,78417,39589,38812,16
BHAKKAR,BHAKKAR,TEHSIL,18 &  ABOVE,419712,214781,204901,30,332582,170376,162194,12,87130,44405,42707,18
BHAKKAR,BHAKKAR,TEHSIL,60 &  ABOVE,45740,25193,20544,3,36194,19940,16254,,9546,5253,4290,3
BHAKKAR,BHAKKAR,TEHSIL,65 &  ABOVE,28979,15934,13045,,23232,12810,10422,,5747,3124,2623,
DARYA KHAN,BHAKKAR,TEHSIL,ALL AGES,421233,218489,202719,25,327385,170074,157304,7,93848,48415,45415,18
DARYA KHAN,BHAKKAR,TEHSIL,UNDER 1,13571,7214,6357,,10426,5583,4843,,3145,1631,1514,
DARYA KHAN,BHAKKAR,TEHSIL,UNDER 5,72209,38551,33658,,57109,30640,26469,,15100,7911,7189,
DARYA KHAN,BHAKKAR,TEHSIL,UNDER 10,125463,66103,59360,,99183,52445,46738,,26280,13658,12622,
DARYA KHAN,BHAKKAR,TEHSIL,UNDER 15,171852,90632,81220,,135485,71639,63846,,36367,18993,17374,
DARYA KHAN,BHAKKAR,TEHSIL,05 - 24,172763,89901,82856,6,134276,69966,64308,2,38487,19935,18548,4
DARYA KHAN,BHAKKAR,TEHSIL,15 - 49,196185,99635,96526,24,150055,76132,73916,7,46130,23503,22610,17
DARYA KHAN,BHAKKAR,TEHSIL,15 - 64,232964,119050,113890,24,178774,91313,87454,7,54190,27737,26436,17
DARYA KHAN,BHAKKAR,TEHSIL,18 - 60,201802,102437,99343,22,154936,78588,76342,6,46866,23849,23001,16
DARYA KHAN,BHAKKAR,TEHSIL,18 &  ABOVE,225622,115232,110367,23,173721,88760,84955,6,51901,26472,25412,17
DARYA KHAN,BHAKKAR,TEHSIL,60 &  ABOVE,25781,13869,11911,1,20285,11000,9285,,5496,2869,2626,1
DARYA KHAN,BHAKKAR,TEHSIL,65 &  ABOVE,16417,8807,7609,1,13126,7122,6004,,3291,1685,1605,1
KALUR KOT,BHAKKAR,TEHSIL,ALL AGES,415546,215118,200419,9,359947,186423,173516,8,55599,28695,26903,1
KALUR KOT,BHAKKAR,TEHSIL,UNDER 1,23194,12857,10337,,20263,11259,9004,,2931,1598,1333,
KALUR KOT,BHAKKAR,TEHSIL,UNDER 5,78018,42021,35997,,68518,36936,31582,,9500,5085,4415,
KALUR KOT,BHAKKAR,TEHSIL,UNDER 10,129407,68437,60970,,113520,60153,53367,,15887,8284,7603,
KALUR KOT,BHAKKAR,TEHSIL,UNDER 15,175019,92646,82373,,153194,81178,72016,,21825,11468,10357,
KALUR KOT,BHAKKAR,TEHSIL,05 - 24,168882,87806,81073,3,146399,76136,70260,3,22483,11670,10813,
KALUR KOT,BHAKKAR,TEHSIL,15 - 49,188081,94626,93448,7,161292,81056,80229,7,26789,13570,13219,
KALUR KOT,BHAKKAR,TEHSIL,15 - 64,223438,113283,110146,9,191839,97206,94625,8,31599,16077,15521,1
KALUR KOT,BHAKKAR,TEHSIL,18 - 60,192379,96783,95589,7,165180,83065,82109,6,27199,13718,13480,1
KALUR KOT,BHAKKAR,TEHSIL,18 &  ABOVE,216524,109717,106800,7,186096,94287,91803,6,30428,15430,14997,1
KALUR KOT,BHAKKAR,TEHSIL,60 &  ABOVE,26195,14009,12186,,22681,12157,10524,,3514,1852,1662,
KALUR KOT,BHAKKAR,TEHSIL,65 &  ABOVE,17089,9189,7900,,14914,8039,6875,,2175,1150,1025,
MANKERA,BHAKKAR,TEHSIL,ALL AGES,310543,161326,149211,6,267042,138485,128553,4,43501,22841,20658,2
MANKERA,BHAKKAR,TEHSIL,UNDER 1,9806,5361,4445,,8294,4535,3759,,1512,826,686,
MANKERA,BHAKKAR,TEHSIL,UNDER 5,49713,26703,23010,,42944,22983,19961,,6769,3720,3049,
MANKERA,BHAKKAR,TEHSIL,UNDER 10,88517,46783,41734,,76786,40409,36377,,11731,6374,5357,
MANKERA,BHAKKAR,TEHSIL,UNDER 15,122458,64766,57691,1,105985,55834,50150,1,16473,8932,7541,
MANKERA,BHAKKAR,TEHSIL,05 - 24,126952,65887,61063,2,109389,56609,52778,2,17563,9278,8285,
MANKERA,BHAKKAR,TEHSIL,15 - 49,147611,74386,73221,4,126167,63492,62673,2,21444,10894,10548,2
MANKERA,BHAKKAR,TEHSIL,15 - 64,175325,89359,85961,5,149982,76351,73628,3,25343,13008,12333,2
MANKERA,BHAKKAR,TEHSIL,18 - 60,152044,77159,74881,4,130119,66009,64108,2,21925,11150,10773,2
MANKERA,BHAKKAR,TEHSIL,18 &  ABOVE,170170,87359,82807,4,145743,74835,70906,2,24427,12524,11901,2
MANKERA,BHAKKAR,TEHSIL,60 &  ABOVE,19769,11099,8670,,17055,9615,7440,,2714,1484,1230,
MANKERA,BHAKKAR,TEHSIL,65 &  ABOVE,12760,7201,5559,,11075,6300,4775,,1685,901,784,
CHAKWAL,CHAKWAL,DISTRICT,ALL AGES,1731689,862509,869091,89,1296931,643656,653260,15,434758,218853,215831,74
CHAKWAL,CHAKWAL,DISTRICT,UNDER 1,41580,19629,21951,,31300,14863,16437,,10280,4766,5514,
CHAKWAL,CHAKWAL,DISTRICT,UNDER 5,223007,110124,112883,,164308,81422,82886,,58699,28702,29997,
CHAKWAL,CHAKWAL,DISTRICT,UNDER 10,398401,198531,199870,,293390,146627,146763,,105011,51904,53107,
CHAKWAL,CHAKWAL,DISTRICT,UNDER 15,571696,288862,282829,5,420098,212459,207639,,151598,76403,75190,5
CHAKWAL,CHAKWAL,DISTRICT,05 - 24,635359,325385,309943,31,466912,238257,228651,4,168447,87128,81292,27
CHAKWAL,CHAKWAL,DISTRICT,15 - 49,852566,418660,433835,71,636908,311352,325543,13,215658,107308,108292,58
CHAKWAL,CHAKWAL,DISTRICT,15 - 64,1045873,515709,530083,81,785656,385538,400104,14,260217,130171,129979,67
CHAKWAL,CHAKWAL,DISTRICT,18 - 60,907706,443248,464388,70,682872,332145,350714,13,224834,111103,113674,57
CHAKWAL,CHAKWAL,DISTRICT,18 &  ABOVE,1065414,523722,541617,75,808107,395293,412800,14,257307,128429,128817,61
CHAKWAL,CHAKWAL,DISTRICT,60 &  ABOVE,168649,86082,82561,6,133485,67374,66110,1,35164,18708,16451,5
CHAKWAL,CHAKWAL,DISTRICT,65 &  ABOVE,114120,57938,56179,3,91177,45659,45517,1,22943,12279,10662,2
CHAKWAL,CHAKWAL,TEHSIL,ALL AGES,768622,377549,391013,60,524580,256175,268392,13,244042,121374,122621,47
CHAKWAL,CHAKWAL,TEHSIL,UNDER 1,20687,9469,11218,,14796,6713,8083,,5891,2756,3135,
CHAKWAL,CHAKWAL,TEHSIL,UNDER 5,106341,51628,54713,,70911,34386,36525,,35430,17242,18188,
CHAKWAL,CHAKWAL,TEHSIL,UNDER 10,184189,90800,93389,,122509,60525,61984,,61680,30275,31405,
CHAKWAL,CHAKWAL,TEHSIL,UNDER 15,262088,131287,130796,5,173802,87147,86655,,88286,44140,44141,5
CHAKWAL,CHAKWAL,TEHSIL,05 - 24,282457,143982,138451,24,187070,95202,91864,4,95387,48780,46587,20
CHAKWAL,CHAKWAL,TEHSIL,15 - 49,371476,178642,192786,48,252695,120697,131986,12,118781,57945,60800,36
CHAKWAL,CHAKWAL,TEHSIL,15 - 64,456696,220889,235754,53,313339,150405,162922,12,143357,70484,72832,41
CHAKWAL,CHAKWAL,TEHSIL,18 - 60,395674,189066,206564,44,271809,128930,142868,11,123865,60136,63696,33
CHAKWAL,CHAKWAL,TEHSIL,18 &  ABOVE,464421,224101,240273,47,322976,154488,168476,12,141445,69613,71797,35
CHAKWAL,CHAKWAL,TEHSIL,60 &  ABOVE,73700,37560,36136,4,54597,27310,27286,1,19103,10250,8850,3
CHAKWAL,CHAKWAL,TEHSIL,65 &  ABOVE,49838,25373,24463,2,37439,18623,18815,1,12399,6750,5648,1
CHOA SAIDAN SHAH,CHAKWAL,TEHSIL,ALL AGES,167537,83599,83922,16,126463,62826,63637,,41074,20773,20285,16
CHOA SAIDAN SHAH,CHAKWAL,TEHSIL,UNDER 1,5580,2366,3214,,4159,1762,2397,,1421,604,817,
CHOA SAIDAN SHAH,CHAKWAL,TEHSIL,UNDER 5,25898,11698,14200,,19993,8990,11003,,5905,2708,3197,
CHOA SAIDAN SHAH,CHAKWAL,TEHSIL,UNDER 10,43152,20235,22917,,32357,15104,17253,,10795,5131,5664,
CHOA SAIDAN SHAH,CHAKWAL,TEHSIL,UNDER 15,60022,28932,31090,,44582,21372,23210,,15440,7560,7880,
CHOA SAIDAN SHAH,CHAKWAL,TEHSIL,05 - 24,61050,31144,29901,5,44337,22497,21840,,16713,8647,8061,5
CHOA SAIDAN SHAH,CHAKWAL,TEHSIL,15 - 49,81374,41359,40001,14,61376,31099,30277,,19998,10260,9724,14
CHOA SAIDAN SHAH,CHAKWAL,TEHSIL,15 - 64,98459,50142,48302,15,74555,37831,36724,,23904,12311,11578,15
CHOA SAIDAN SHAH,CHAKWAL,TEHSIL,18 - 60,85806,43483,42308,15,65217,33041,32176,,20589,10442,10132,15
CHOA SAIDAN SHAH,CHAKWAL,TEHSIL,18 &  ABOVE,98574,49920,48638,16,75473,38151,37322,,23101,11769,11316,16
CHOA SAIDAN SHAH,CHAKWAL,TEHSIL,60 &  ABOVE,13666,6903,6762,1,10959,5472,5487,,2707,1431,1275,1
CHOA SAIDAN SHAH,CHAKWAL,TEHSIL,65 &  ABOVE,9056,4525,4530,1,7326,3623,3703,,1730,902,827,1
KALLAR KAHAR,CHAKWAL,TEHSIL,ALL AGES,193284,99444,93838,2,143692,73193,70498,1,49592,26251,23340,1
KALLAR KAHAR,CHAKWAL,TEHSIL,UNDER 1,2750,1395,1355,,2009,1031,978,,741,364,377,
KALLAR KAHAR,CHAKWAL,TEHSIL,UNDER 5,20446,10425,10021,,15243,7757,7486,,5203,2668,2535,
KALLAR KAHAR,CHAKWAL,TEHSIL,UNDER 10,39463,20017,19446,,29404,14944,14460,,10059,5073,4986,
KALLAR KAHAR,CHAKWAL,TEHSIL,UNDER 15,58694,30162,28532,,43539,22364,21175,,15155,7798,7357,
KALLAR KAHAR,CHAKWAL,TEHSIL,05 - 24,71293,37415,33877,1,51856,26950,24906,,19437,10465,8971,1
KALLAR KAHAR,CHAKWAL,TEHSIL,15 - 49,99727,51561,48164,2,73310,37394,35915,1,26417,14167,12249,1
KALLAR KAHAR,CHAKWAL,TEHSIL,15 - 64,121579,62782,58795,2,89936,45777,44158,1,31643,17005,14637,1
KALLAR KAHAR,CHAKWAL,TEHSIL,18 - 60,104991,53861,51129,1,78116,39522,38593,1,26875,14339,12536,
KALLAR KAHAR,CHAKWAL,TEHSIL,18 &  ABOVE,122843,62833,60009,1,92068,46443,45624,1,30775,16390,14385,
KALLAR KAHAR,CHAKWAL,TEHSIL,60 &  ABOVE,19247,9666,9581,,14996,7430,7566,,4251,2236,2015,
KALLAR KAHAR,CHAKWAL,TEHSIL,65 &  ABOVE,13011,6500,6511,,10217,5052,5165,,2794,1448,1346,
LAWA,CHAKWAL,TEHSIL,ALL AGES,144611,72904,71707,,123992,62596,61396,,20619,10308,10311,
LAWA,CHAKWAL,TEHSIL,UNDER 1,3963,1904,2059,,3026,1524,1502,,937,380,557,
LAWA,CHAKWAL,TEHSIL,UNDER 5,20414,10386,10028,,16765,8758,8007,,3649,1628,2021,
LAWA,CHAKWAL,TEHSIL,UNDER 10,34983,17929,17054,,29438,15270,14168,,5545,2659,2886,
LAWA,CHAKWAL,TEHSIL,UNDER 15,49149,25452,23697,,41702,21762,19940,,7447,3690,3757,
LAWA,CHAKWAL,TEHSIL,05 - 24,52151,27115,25036,,45248,23395,21853,,6903,3720,3183,
LAWA,CHAKWAL,TEHSIL,15 - 49,68867,34131,34736,,59313,29305,30008,,9554,4826,4728,
LAWA,CHAKWAL,TEHSIL,15 - 64,84737,42064,42673,,72963,36136,36827,,11774,5928,5846,
LAWA,CHAKWAL,TEHSIL,18 - 60,73382,36061,37321,,63162,31004,32158,,10220,5057,5163,
LAWA,CHAKWAL,TEHSIL,18 &  ABOVE,87962,43483,44479,,75819,37454,38365,,12143,6029,6114,
LAWA,CHAKWAL,TEHSIL,60 &  ABOVE,15375,7831,7544,,13332,6793,6539,,2043,1038,1005,
LAWA,CHAKWAL,TEHSIL,65 &  ABOVE,10725,5388,5337,,9327,4698,4629,,1398,690,708,
TALA GANG,CHAKWAL,TEHSIL,ALL AGES,457635,229013,228611,11,378204,188866,189337,1,79431,40147,39274,10
TALA GANG,CHAKWAL,TEHSIL,UNDER 1,8600,4495,4105,,7310,3833,3477,,1290,662,628,
TALA GANG,CHAKWAL,TEHSIL,UNDER 5,49908,25987,23921,,41396,21531,19865,,8512,4456,4056,
TALA GANG,CHAKWAL,TEHSIL,UNDER 10,96614,49550,47064,,79682,40784,38898,,16932,8766,8166,
TALA GANG,CHAKWAL,TEHSIL,UNDER 15,141743,73029,68714,,116473,59814,56659,,25270,13215,12055,
TALA GANG,CHAKWAL,TEHSIL,05 - 24,168408,85729,82678,1,138401,70213,68188,,30007,15516,14490,1
TALA GANG,CHAKWAL,TEHSIL,15 - 49,231122,112967,118148,7,190214,92857,97357,,40908,20110,20791,7
TALA GANG,CHAKWAL,TEHSIL,15 - 64,284402,139832,144559,11,234863,115389,119473,1,49539,24443,25086,10
TALA GANG,CHAKWAL,TEHSIL,18 - 60,247853,120777,127066,10,204568,99648,104919,1,43285,21129,22147,9
TALA GANG,CHAKWAL,TEHSIL,18 &  ABOVE,291614,143385,148218,11,241771,118757,123013,1,49843,24628,25205,10
TALA GANG,CHAKWAL,TEHSIL,60 &  ABOVE,46661,24122,22538,1,39601,20369,19232,,7060,3753,3306,1
TALA GANG,CHAKWAL,TEHSIL,65 &  ABOVE,31490,16152,15338,,26868,13663,13205,,4622,2489,2133,
CHINIOT,CHINIOT,DISTRICT,ALL AGES,1563024,790731,772126,167,1071352,542708,528595,49,491672,248023,243531,118
CHINIOT,CHINIOT,DISTRICT,UNDER 1,36916,18690,18226,,27007,13710,13297,,9909,4980,4929,
CHINIOT,CHINIOT,DISTRICT,UNDER 5,216063,108882,107181,,155898,78799,77099,,60165,30083,30082,
CHINIOT,CHINIOT,DISTRICT,UNDER 10,417070,209934,207136,,298053,150589,147464,,119017,59345,59672,
CHINIOT,CHINIOT,DISTRICT,UNDER 15,603222,304122,299099,1,423677,214321,209355,1,179545,89801,89744,
CHINIOT,CHINIOT,DISTRICT,05 - 24,668831,336926,331854,51,455900,230501,225381,18,212931,106425,106473,33
CHINIOT,CHINIOT,DISTRICT,15 - 49,743672,371489,372035,148,496112,247599,248474,39,247560,123890,123561,109
CHINIOT,CHINIOT,DISTRICT,15 - 64,887859,447315,440384,160,595423,299871,295506,46,292436,147444,144878,114
CHINIOT,CHINIOT,DISTRICT,18 - 60,763091,383099,379848,144,511106,256308,254759,39,251985,126791,125089,105
CHINIOT,CHINIOT,DISTRICT,18 &  ABOVE,864151,437784,426215,152,583620,295473,288106,41,280531,142311,138109,111
CHINIOT,CHINIOT,DISTRICT,60 &  ABOVE,110984,59825,51150,9,79521,42781,36738,2,31463,17044,14412,7
CHINIOT,CHINIOT,DISTRICT,65 &  ABOVE,71943,39294,32643,6,52252,28516,23734,2,19691,10778,8909,4
BHAWANA,CHINIOT,TEHSIL,ALL AGES,428617,217050,211539,28,389347,197351,191978,18,39270,19699,19561,10
BHAWANA,CHINIOT,TEHSIL,UNDER 1,11440,5853,5587,,10754,5516,5238,,686,337,349,
BHAWANA,CHINIOT,TEHSIL,UNDER 5,63370,32204,31166,,58240,29578,28662,,5130,2626,2504,
BHAWANA,CHINIOT,TEHSIL,UNDER 10,121258,61412,59846,,110860,56213,54647,,10398,5199,5199,
BHAWANA,CHINIOT,TEHSIL,UNDER 15,172153,87107,85046,,156648,79365,77283,,15505,7742,7763,
BHAWANA,CHINIOT,TEHSIL,05 - 24,182781,92220,90551,10,165243,83526,81709,8,17538,8694,8842,2
BHAWANA,CHINIOT,TEHSIL,15 - 49,197304,98459,98822,23,178125,88928,89182,15,19179,9531,9640,8
BHAWANA,CHINIOT,TEHSIL,15 - 64,236867,119256,117584,27,214249,107913,106318,18,22618,11343,11266,9
BHAWANA,CHINIOT,TEHSIL,18 - 60,202951,101687,101241,23,183554,91983,91557,14,19397,9704,9684,9
BHAWANA,CHINIOT,TEHSIL,18 &  ABOVE,230653,116611,114018,24,209457,105947,103496,14,21196,10664,10522,10
BHAWANA,CHINIOT,TEHSIL,60 &  ABOVE,30378,16298,14078,2,28356,15222,13134,,2022,1076,944,2
BHAWANA,CHINIOT,TEHSIL,65 &  ABOVE,19597,10687,8909,1,18450,10073,8377,,1147,614,532,1
CHINIOT,CHINIOT,TEHSIL,ALL AGES,633621,322132,311426,63,315456,160356,155089,11,318165,161776,156337,52
CHINIOT,CHINIOT,TEHSIL,UNDER 1,13006,6554,6452,,6682,3383,3299,,6324,3171,3153,
CHINIOT,CHINIOT,TEHSIL,UNDER 5,82952,41579,41373,,43984,22182,21802,,38968,19397,19571,
CHINIOT,CHINIOT,TEHSIL,UNDER 10,163484,82050,81434,,85426,43118,42308,,78058,38932,39126,
CHINIOT,CHINIOT,TEHSIL,UNDER 15,241076,121589,119486,1,122593,62114,60478,1,118483,59475,59008,
CHINIOT,CHINIOT,TEHSIL,05 - 24,276660,139756,136880,24,136436,69354,67078,4,140224,70402,69802,20
CHINIOT,CHINIOT,TEHSIL,15 - 49,309426,155760,153608,58,148827,74670,74148,9,160599,81090,79460,49
CHINIOT,CHINIOT,TEHSIL,15 - 64,366087,185945,180081,61,177852,90015,87827,10,188235,95930,92254,51
CHINIOT,CHINIOT,TEHSIL,18 - 60,315096,159525,155517,54,152852,77026,75817,9,162244,82499,79700,45
CHINIOT,CHINIOT,TEHSIL,18 &  ABOVE,352629,180130,172442,57,173614,88331,85274,9,179015,91799,87168,48
CHINIOT,CHINIOT,TEHSIL,60 &  ABOVE,41763,22790,18970,3,23105,12507,10598,,18658,10283,8372,3
CHINIOT,CHINIOT,TEHSIL,65 &  ABOVE,26458,14598,11859,1,15011,8227,6784,,11447,6371,5075,1
LALIAN,CHINIOT,TEHSIL,ALL AGES,500786,251549,249161,76,366549,185001,181528,20,134237,66548,67633,56
LALIAN,CHINIOT,TEHSIL,UNDER 1,12470,6283,6187,,9571,4811,4760,,2899,1472,1427,
LALIAN,CHINIOT,TEHSIL,UNDER 5,69741,35099,34642,,53674,27039,26635,,16067,8060,8007,
LALIAN,CHINIOT,TEHSIL,UNDER 10,132328,66472,65856,,101767,51258,50509,,30561,15214,15347,
LALIAN,CHINIOT,TEHSIL,UNDER 15,189993,95426,94567,,144436,72842,71594,,45557,22584,22973,
LALIAN,CHINIOT,TEHSIL,05 - 24,209390,104950,104423,17,154221,77621,76594,6,55169,27329,27829,11
LALIAN,CHINIOT,TEHSIL,15 - 49,236942,117270,119605,67,169160,84001,85144,15,67782,33269,34461,52
LALIAN,CHINIOT,TEHSIL,15 - 64,284905,142114,142719,72,203322,101943,101361,18,81583,40171,41358,54
LALIAN,CHINIOT,TEHSIL,18 - 60,245044,121887,123090,67,174700,87299,87385,16,70344,34588,35705,51
LALIAN,CHINIOT,TEHSIL,18 &  ABOVE,280869,141043,139755,71,200549,101195,99336,18,80320,39848,40419,53
LALIAN,CHINIOT,TEHSIL,60 &  ABOVE,38843,20737,18102,4,28060,15052,13006,2,10783,5685,5096,2
LALIAN,CHINIOT,TEHSIL,65 &  ABOVE,25888,14009,11875,4,18791,10216,8573,2,7097,3793,3302,2
DERA GHAZI KHAN,DERA GHAZI KHAN,DISTRICT,ALL AGES,3386575,1709510,1676944,121,2581903,1302359,1279508,36,804672,407151,397436,85
DERA GHAZI KHAN,DERA GHAZI KHAN,DISTRICT,UNDER 1,87925,44459,43466,,69280,35211,34069,,18645,9248,9397,
DERA GHAZI KHAN,DERA GHAZI KHAN,DISTRICT,UNDER 5,623649,314290,309359,,494060,249067,244993,,129589,65223,64366,
DERA GHAZI KHAN,DERA GHAZI KHAN,DISTRICT,UNDER 10,1151122,580555,570567,,914339,461297,453042,,236783,119258,117525,
DERA GHAZI KHAN,DERA GHAZI KHAN,DISTRICT,UNDER 15,1582819,799820,782995,4,1247040,630570,616467,3,335779,169250,166528,1
DERA GHAZI KHAN,DERA GHAZI KHAN,DISTRICT,05 - 24,1555455,785506,769889,60,1199569,606038,593515,16,355886,179468,176374,44
DERA GHAZI KHAN,DERA GHAZI KHAN,DISTRICT,15 - 49,1461488,728783,732598,107,1081325,538454,542843,28,380163,190329,189755,79
DERA GHAZI KHAN,DERA GHAZI KHAN,DISTRICT,15 - 64,1690929,849340,841474,115,1248775,625766,622977,32,442154,223574,218497,83
DERA GHAZI KHAN,DERA GHAZI KHAN,DISTRICT,18 - 60,1448654,723104,725443,107,1068471,531980,536466,25,380183,191124,188977,82
DERA GHAZI KHAN,DERA GHAZI KHAN,DISTRICT,18 &  ABOVE,1605777,807240,798427,110,1186825,595157,591641,27,418952,212083,206786,83
DERA GHAZI KHAN,DERA GHAZI KHAN,DISTRICT,60 &  ABOVE,172025,92026,79995,4,129389,69063,60323,3,42636,22963,19672,1
DERA GHAZI KHAN,DERA GHAZI KHAN,DISTRICT,65 &  ABOVE,112827,60350,52475,2,86088,46023,40064,1,26739,14327,12411,1
DERA GHAZI KHAN,DERA GHAZI KHAN,TEHSIL,ALL AGES,1436937,722648,714235,54,913542,457122,456408,12,523395,265526,257827,42
DERA GHAZI KHAN,DERA GHAZI KHAN,TEHSIL,UNDER 1,34779,17278,17501,,23292,11560,11732,,11487,5718,5769,
DERA GHAZI KHAN,DERA GHAZI KHAN,TEHSIL,UNDER 5,258841,129802,129039,,177228,88973,88255,,81613,40829,40784,
DERA GHAZI KHAN,DERA GHAZI KHAN,TEHSIL,UNDER 10,477612,240599,237013,,329046,165978,163068,,148566,74621,73945,
DERA GHAZI KHAN,DERA GHAZI KHAN,TEHSIL,UNDER 15,661169,334159,327008,2,449124,227190,221933,1,212045,106969,105075,1
DERA GHAZI KHAN,DERA GHAZI KHAN,TEHSIL,05 - 24,661880,334628,327225,27,431868,217969,213892,7,230012,116659,113333,20
DERA GHAZI KHAN,DERA GHAZI KHAN,TEHSIL,15 - 49,632327,312462,319820,45,379217,185308,193900,9,253110,127154,125920,36
DERA GHAZI KHAN,DERA GHAZI KHAN,TEHSIL,15 - 64,730546,364159,366337,50,436229,214837,221382,10,294317,149322,144955,40
DERA GHAZI KHAN,DERA GHAZI KHAN,TEHSIL,18 - 60,627122,310300,316777,45,373352,182370,190977,5,253770,127930,125800,40
DERA GHAZI KHAN,DERA GHAZI KHAN,TEHSIL,18 &  ABOVE,690789,344550,346192,47,412097,203021,209070,6,278692,141529,137122,41
DERA GHAZI KHAN,DERA GHAZI KHAN,TEHSIL,60 &  ABOVE,70065,37606,32457,2,42521,22650,19870,1,27544,14956,12587,1
DERA GHAZI KHAN,DERA GHAZI KHAN,TEHSIL,65 &  ABOVE,45222,24330,20890,2,28189,15095,13093,1,17033,9235,7797,1
KOH-E-SULEMAN,DERA GHAZI KHAN,TEHSIL,ALL AGES,248683,126939,121737,7,248683,126939,121737,7,,,,
KOH-E-SULEMAN,DERA GHAZI KHAN,TEHSIL,UNDER 1,6729,3353,3376,,6729,3353,3376,,,,,
KOH-E-SULEMAN,DERA GHAZI KHAN,TEHSIL,UNDER 5,50758,25218,25540,,50758,25218,25540,,,,,
KOH-E-SULEMAN,DERA GHAZI KHAN,TEHSIL,UNDER 10,93743,46825,46918,,93743,46825,46918,,,,,
KOH-E-SULEMAN,DERA GHAZI KHAN,TEHSIL,UNDER 15,124494,62747,61747,,124494,62747,61747,,,,,
KOH-E-SULEMAN,DERA GHAZI KHAN,TEHSIL,05 - 24,113820,58278,55540,2,113820,58278,55540,2,,,,
KOH-E-SULEMAN,DERA GHAZI KHAN,TEHSIL,15 - 49,99915,51336,48573,6,99915,51336,48573,6,,,,
KOH-E-SULEMAN,DERA GHAZI KHAN,TEHSIL,15 - 64,115505,59521,55977,7,115505,59521,55977,7,,,,
KOH-E-SULEMAN,DERA GHAZI KHAN,TEHSIL,18 - 60,99598,50799,48794,5,99598,50799,48794,5,,,,
KOH-E-SULEMAN,DERA GHAZI KHAN,TEHSIL,18 &  ABOVE,111387,57124,54257,6,111387,57124,54257,6,,,,
KOH-E-SULEMAN,DERA GHAZI KHAN,TEHSIL,60 &  ABOVE,12987,6991,5995,1,12987,6991,5995,1,,,,
KOH-E-SULEMAN,DERA GHAZI KHAN,TEHSIL,65 &  ABOVE,8684,4671,4013,,8684,4671,4013,,,,,
KOT CHHUTTA,DERA GHAZI KHAN,TEHSIL,ALL AGES,904701,452413,452247,41,781423,391629,389784,10,123278,60784,62463,31
KOT CHHUTTA,DERA GHAZI KHAN,TEHSIL,UNDER 1,25047,12626,12421,,21566,10897,10669,,3481,1729,1752,
KOT CHHUTTA,DERA GHAZI KHAN,TEHSIL,UNDER 5,175500,88426,87074,,152102,76479,75623,,23398,11947,11451,
KOT CHHUTTA,DERA GHAZI KHAN,TEHSIL,UNDER 10,320022,161486,158536,,278284,140281,138003,,41738,21205,20533,
KOT CHHUTTA,DERA GHAZI KHAN,TEHSIL,UNDER 15,435801,220125,215674,2,378353,191229,187122,2,57448,28896,28552,
KOT CHHUTTA,DERA GHAZI KHAN,TEHSIL,05 - 24,418303,210214,208063,26,362527,182737,179785,5,55776,27477,28278,21
KOT CHHUTTA,DERA GHAZI KHAN,TEHSIL,15 - 49,380646,186507,194101,38,327172,160896,166269,7,53474,25611,27832,31
KOT CHHUTTA,DERA GHAZI KHAN,TEHSIL,15 - 64,439147,216608,222500,39,377350,186762,190580,8,61797,29846,31920,31
KOT CHHUTTA,DERA GHAZI KHAN,TEHSIL,18 - 60,376365,184402,191924,39,323410,158994,164408,8,52955,25408,27516,31
KOT CHHUTTA,DERA GHAZI KHAN,TEHSIL,18 &  ABOVE,417495,206096,211360,39,358874,177792,181074,8,58621,28304,30286,31
KOT CHHUTTA,DERA GHAZI KHAN,TEHSIL,60 &  ABOVE,45005,23686,21319,,38809,20525,18284,,6196,3161,3035,
KOT CHHUTTA,DERA GHAZI KHAN,TEHSIL,65 &  ABOVE,29753,15680,14073,,25720,13638,12082,,4033,2042,1991,
TAUNSA,DERA GHAZI KHAN,TEHSIL,ALL AGES,796254,407510,388725,19,638255,326669,311579,7,157999,80841,77146,12
TAUNSA,DERA GHAZI KHAN,TEHSIL,UNDER 1,21370,11202,10168,,17693,9401,8292,,3677,1801,1876,
TAUNSA,DERA GHAZI KHAN,TEHSIL,UNDER 5,138550,70844,67706,,113972,58397,55575,,24578,12447,12131,
TAUNSA,DERA GHAZI KHAN,TEHSIL,UNDER 10,259745,131645,128100,,213266,108213,105053,,46479,23432,23047,
TAUNSA,DERA GHAZI KHAN,TEHSIL,UNDER 15,361355,182789,178566,,295069,149404,145665,,66286,33385,32901,
TAUNSA,DERA GHAZI KHAN,TEHSIL,05 - 24,361452,182386,179061,5,291354,147054,144298,2,70098,35332,34763,3
TAUNSA,DERA GHAZI KHAN,TEHSIL,15 - 49,348600,178478,170104,18,275021,140914,134101,6,73579,37564,36003,12
TAUNSA,DERA GHAZI KHAN,TEHSIL,15 - 64,405731,209052,196660,19,319691,164646,155038,7,86040,44406,41622,12
TAUNSA,DERA GHAZI KHAN,TEHSIL,18 - 60,345569,177603,167948,18,272111,139817,132287,7,73458,37786,35661,11
TAUNSA,DERA GHAZI KHAN,TEHSIL,18 &  ABOVE,386106,199470,186618,18,304467,157220,147240,7,81639,42250,39378,11
TAUNSA,DERA GHAZI KHAN,TEHSIL,60 &  ABOVE,43968,23743,20224,1,35072,18897,16174,1,8896,4846,4050,
TAUNSA,DERA GHAZI KHAN,TEHSIL,65 &  ABOVE,29168,15669,13499,,23495,12619,10876,,5673,3050,2623,
FAISALABAD,FAISALABAD,DISTRICT,ALL AGES,9065306,4726182,4338162,962,4682740,2438955,2243493,292,4382566,2287227,2094669,670
FAISALABAD,FAISALABAD,DISTRICT,UNDER 1,193174,100353,92821,,110605,57546,53059,,82569,42807,39762,
FAISALABAD,FAISALABAD,DISTRICT,UNDER 5,1165432,603576,561856,,633713,328687,305026,,531719,274889,256830,
FAISALABAD,FAISALABAD,DISTRICT,UNDER 10,2200114,1133806,1066308,,1197733,618432,579301,,1002381,515374,487007,
FAISALABAD,FAISALABAD,DISTRICT,UNDER 15,3206901,1663385,1543489,27,1725619,896289,829315,15,1481282,767096,714174,12
FAISALABAD,FAISALABAD,DISTRICT,05 - 24,3769171,1961205,1807693,273,1958010,1018391,939524,95,1811161,942814,868169,178
FAISALABAD,FAISALABAD,DISTRICT,15 - 49,4662304,2409766,2251741,797,2327148,1199076,1127847,225,2335156,1210690,1123894,572
FAISALABAD,FAISALABAD,DISTRICT,15 - 64,5504718,2863176,2640633,909,2757707,1430160,1327285,262,2747011,1433016,1313348,647
FAISALABAD,FAISALABAD,DISTRICT,18 - 60,4786338,2480490,2304987,861,2384583,1231511,1152830,242,2401755,1248979,1152157,619
FAISALABAD,FAISALABAD,DISTRICT,18 &  ABOVE,5310172,2774294,2534980,898,2672530,1392940,1279329,261,2637642,1381354,1255651,637
FAISALABAD,FAISALABAD,DISTRICT,60 &  ABOVE,576731,321972,254710,49,315386,176016,139350,20,261345,145956,115360,29
FAISALABAD,FAISALABAD,DISTRICT,65 &  ABOVE,353687,199621,154040,26,199414,112506,86893,15,154273,87115,67147,11
CHAK JHUMRA,FAISALABAD,TEHSIL,ALL AGES,385169,203127,182016,26,325038,172179,152839,20,60131,30948,29177,6
CHAK JHUMRA,FAISALABAD,TEHSIL,UNDER 1,8397,4372,4025,,6913,3639,3274,,1484,733,751,
CHAK JHUMRA,FAISALABAD,TEHSIL,UNDER 5,51142,26726,24416,,43177,22610,20567,,7965,4116,3849,
CHAK JHUMRA,FAISALABAD,TEHSIL,UNDER 10,93185,48360,44825,,78992,41107,37885,,14193,7253,6940,
CHAK JHUMRA,FAISALABAD,TEHSIL,UNDER 15,135063,70193,64867,3,114348,59608,54737,3,20715,10585,10130,
CHAK JHUMRA,FAISALABAD,TEHSIL,05 - 24,157003,81850,75144,9,132715,69449,63257,9,24288,12401,11887,
CHAK JHUMRA,FAISALABAD,TEHSIL,15 - 49,196578,103672,92891,15,165023,87579,77433,11,31555,16093,15458,4
CHAK JHUMRA,FAISALABAD,TEHSIL,15 - 64,232489,122936,109532,21,195327,103815,91497,15,37162,19121,18035,6
CHAK JHUMRA,FAISALABAD,TEHSIL,18 - 60,202006,106862,95125,19,169604,90248,79343,13,32402,16614,15782,6
CHAK JHUMRA,FAISALABAD,TEHSIL,18 &  ABOVE,226671,120779,105870,22,190941,102331,88594,16,35730,18448,17276,6
CHAK JHUMRA,FAISALABAD,TEHSIL,60 &  ABOVE,27143,15251,11888,4,23432,13214,10214,4,3711,2037,1674,
CHAK JHUMRA,FAISALABAD,TEHSIL,65 &  ABOVE,17617,9998,7617,2,15363,8756,6605,2,2254,1242,1012,
FAISALABAD CITY,FAISALABAD,TEHSIL,ALL AGES,3682036,1924504,1756934,598,,,,,3682036,1924504,1756934,598
FAISALABAD CITY,FAISALABAD,TEHSIL,UNDER 1,68561,35570,32991,,,,,,68561,35570,32991,
FAISALABAD CITY,FAISALABAD,TEHSIL,UNDER 5,443903,229631,214272,,,,,,443903,229631,214272,
FAISALABAD CITY,FAISALABAD,TEHSIL,UNDER 10,836635,430436,406199,,,,,,836635,430436,406199,
FAISALABAD CITY,FAISALABAD,TEHSIL,UNDER 15,1236591,640889,595690,12,,,,,1236591,640889,595690,12
FAISALABAD CITY,FAISALABAD,TEHSIL,05 - 24,1520769,793001,727599,169,,,,,1520769,793001,727599,169
FAISALABAD CITY,FAISALABAD,TEHSIL,15 - 49,1970521,1024114,945893,514,,,,,1970521,1024114,945893,514
FAISALABAD CITY,FAISALABAD,TEHSIL,15 - 64,2316437,1210928,1104933,576,,,,,2316437,1210928,1104933,576
FAISALABAD CITY,FAISALABAD,TEHSIL,18 - 60,2027520,1056688,970282,550,,,,,2027520,1056688,970282,550
FAISALABAD CITY,FAISALABAD,TEHSIL,18 &  ABOVE,2225176,1167369,1057242,565,,,,,2225176,1167369,1057242,565
FAISALABAD CITY,FAISALABAD,TEHSIL,60 &  ABOVE,218991,122040,96926,25,,,,,218991,122040,96926,25
FAISALABAD CITY,FAISALABAD,TEHSIL,65 &  ABOVE,129008,72687,56311,10,,,,,129008,72687,56311,10
FAISALABAD SADAR,FAISALABAD,TEHSIL,ALL AGES,1742958,907402,835448,108,1646024,857751,788168,105,96934,49651,47280,3
FAISALABAD SADAR,FAISALABAD,TEHSIL,UNDER 1,41165,21498,19667,,39325,20541,18784,,1840,957,883,
FAISALABAD SADAR,FAISALABAD,TEHSIL,UNDER 5,231085,119941,111144,,218884,113697,105187,,12201,6244,5957,
FAISALABAD SADAR,FAISALABAD,TEHSIL,UNDER 10,432026,223163,208863,,409046,211508,197538,,22980,11655,11325,
FAISALABAD SADAR,FAISALABAD,TEHSIL,UNDER 15,630270,328554,301715,1,596525,311339,285185,1,33745,17215,16530,
FAISALABAD SADAR,FAISALABAD,TEHSIL,05 - 24,725967,378506,347434,27,685974,358100,327848,26,39993,20406,19586,1
FAISALABAD SADAR,FAISALABAD,TEHSIL,15 - 49,882861,454127,428647,87,833351,429157,404110,84,49510,24970,24537,3
FAISALABAD SADAR,FAISALABAD,TEHSIL,15 - 64,1043400,539836,503460,104,984229,509695,474433,101,59171,30141,29027,3
FAISALABAD SADAR,FAISALABAD,TEHSIL,18 - 60,903296,465183,438013,100,852033,439200,412736,97,51263,25983,25277,3
FAISALABAD SADAR,FAISALABAD,TEHSIL,18 &  ABOVE,1006056,522585,483367,104,948839,493226,455512,101,57217,29359,27855,3
FAISALABAD SADAR,FAISALABAD,TEHSIL,60 &  ABOVE,112489,62540,49945,4,105938,58837,47097,4,6551,3703,2848,
FAISALABAD SADAR,FAISALABAD,TEHSIL,65 &  ABOVE,69288,39012,30273,3,65270,36717,28550,3,4018,2295,1723,
JARANWALA,FAISALABAD,TEHSIL,ALL AGES,1731148,903122,827910,116,1463533,762403,701041,89,267615,140719,126869,27
JARANWALA,FAISALABAD,TEHSIL,UNDER 1,37730,19477,18253,,33090,17052,16038,,4640,2425,2215,
JARANWALA,FAISALABAD,TEHSIL,UNDER 5,226808,116876,109932,,194662,100213,94449,,32146,16663,15483,
JARANWALA,FAISALABAD,TEHSIL,UNDER 10,436439,224017,212422,,374751,192224,182527,,61688,31793,29895,
JARANWALA,FAISALABAD,TEHSIL,UNDER 15,630808,325363,305438,7,539247,277970,261270,7,91561,47393,44168,
JARANWALA,FAISALABAD,TEHSIL,05 - 24,727892,378095,349762,35,617325,320490,296801,34,110567,57605,52961,1
JARANWALA,FAISALABAD,TEHSIL,15 - 49,871811,453058,418661,92,729583,378376,351136,71,142228,74682,67525,21
JARANWALA,FAISALABAD,TEHSIL,15 - 64,1030860,538799,491956,105,863662,450535,413048,79,167198,88264,78908,26
JARANWALA,FAISALABAD,TEHSIL,18 - 60,892120,465337,426684,99,746374,388400,357900,74,145746,76937,68784,25
JARANWALA,FAISALABAD,TEHSIL,18 &  ABOVE,993719,522141,471474,104,834259,437402,396780,77,159460,84739,74694,27
JARANWALA,FAISALABAD,TEHSIL,60 &  ABOVE,111274,62051,49217,6,96084,53433,42648,3,15190,8618,6569,3
JARANWALA,FAISALABAD,TEHSIL,65 &  ABOVE,69480,38960,30516,4,60624,33898,26723,3,8856,5062,3793,1
SAMMUNDRI,FAISALABAD,TEHSIL,ALL AGES,729672,375174,354454,44,543301,280084,263196,21,186371,95090,91258,23
SAMMUNDRI,FAISALABAD,TEHSIL,UNDER 1,18421,9653,8768,,14464,7607,6857,,3957,2046,1911,
SAMMUNDRI,FAISALABAD,TEHSIL,UNDER 5,98854,51595,47259,,75267,39443,35824,,23587,12152,11435,
SAMMUNDRI,FAISALABAD,TEHSIL,UNDER 10,181799,94054,87745,,137160,71198,65962,,44639,22856,21783,
SAMMUNDRI,FAISALABAD,TEHSIL,UNDER 15,262237,135899,126337,1,196663,102164,94498,1,65574,33735,31839,
SAMMUNDRI,FAISALABAD,TEHSIL,05 - 24,299065,153184,145871,10,221410,113587,107817,6,77655,39597,38054,4
SAMMUNDRI,FAISALABAD,TEHSIL,15 - 49,363710,182281,181395,34,267859,134551,133294,14,95851,47730,48101,20
SAMMUNDRI,FAISALABAD,TEHSIL,15 - 64,434313,220262,214011,40,320573,162993,157563,17,113740,57269,56448,23
SAMMUNDRI,FAISALABAD,TEHSIL,18 - 60,375234,189163,186036,35,276701,139929,136759,13,98533,49234,49277,22
SAMMUNDRI,FAISALABAD,TEHSIL,18 &  ABOVE,423210,216467,206702,41,314071,161156,152897,18,109139,55311,53805,23
SAMMUNDRI,FAISALABAD,TEHSIL,60 &  ABOVE,52339,29653,22680,6,40557,22946,17606,5,11782,6707,5074,1
SAMMUNDRI,FAISALABAD,TEHSIL,65 &  ABOVE,33122,19013,14106,3,26065,14927,11135,3,7057,4086,2971,
TANDLIAN WALA,FAISALABAD,TEHSIL,ALL AGES,794323,412853,381400,70,704844,366538,338249,57,89479,46315,43151,13
TANDLIAN WALA,FAISALABAD,TEHSIL,UNDER 1,18900,9783,9117,,16813,8707,8106,,2087,1076,1011,
TANDLIAN WALA,FAISALABAD,TEHSIL,UNDER 5,113640,58807,54833,,101723,52724,48999,,11917,6083,5834,
TANDLIAN WALA,FAISALABAD,TEHSIL,UNDER 10,220030,113776,106254,,197784,102395,95389,,22246,11381,10865,
TANDLIAN WALA,FAISALABAD,TEHSIL,UNDER 15,311932,162487,149442,3,278836,145208,133625,3,33096,17279,15817,
TANDLIAN WALA,FAISALABAD,TEHSIL,05 - 24,338475,176569,161883,23,300586,156765,143801,20,37889,19804,18082,3
TANDLIAN WALA,FAISALABAD,TEHSIL,15 - 49,376823,192514,184254,55,331332,169413,161874,45,45491,23101,22380,10
TANDLIAN WALA,FAISALABAD,TEHSIL,15 - 64,447219,230415,216741,63,393916,203122,190744,50,53303,27293,25997,13
TANDLIAN WALA,FAISALABAD,TEHSIL,18 - 60,386162,197257,188847,58,339871,173734,166092,45,46291,23523,22755,13
TANDLIAN WALA,FAISALABAD,TEHSIL,18 &  ABOVE,435340,224953,210325,62,384420,198825,185546,49,50920,26128,24779,13
TANDLIAN WALA,FAISALABAD,TEHSIL,60 &  ABOVE,54495,30437,24054,4,49375,27586,21785,4,5120,2851,2269,
TANDLIAN WALA,FAISALABAD,TEHSIL,65 &  ABOVE,35172,19951,15217,4,32092,18208,13880,4,3080,1743,1337,
GUJRANWALA,GUJRANWALA,DISTRICT,ALL AGES,5940173,3018895,2920741,537,2365418,1193507,1171757,154,3574755,1825388,1748984,383
GUJRANWALA,GUJRANWALA,DISTRICT,UNDER 1,146099,73723,72376,,63674,32101,31573,,82425,41622,40803,
GUJRANWALA,GUJRANWALA,DISTRICT,UNDER 5,923550,466571,456979,,369663,186388,183275,,553887,280183,273704,
GUJRANWALA,GUJRANWALA,DISTRICT,UNDER 10,1594275,803782,790493,,643982,324204,319778,,950293,479578,470715,
GUJRANWALA,GUJRANWALA,DISTRICT,UNDER 15,2280331,1150513,1129799,19,917125,461743,455375,7,1363206,688770,674424,12
GUJRANWALA,GUJRANWALA,DISTRICT,05 - 24,2483033,1250706,1232139,188,998095,499147,498889,59,1484938,751559,733250,129
GUJRANWALA,GUJRANWALA,DISTRICT,15 - 49,2937561,1469437,1467666,458,1148205,567107,580975,123,1789356,902330,886691,335
GUJRANWALA,GUJRANWALA,DISTRICT,15 - 64,3447222,1745001,1701713,508,1354030,677797,676091,142,2093192,1067204,1025622,366
GUJRANWALA,GUJRANWALA,DISTRICT,18 - 60,2984037,1505832,1477738,467,1167006,582426,584455,125,1817031,923406,893283,342
GUJRANWALA,GUJRANWALA,DISTRICT,18 &  ABOVE,3294658,1684070,1610107,481,1301563,658811,642619,133,1993095,1025259,967488,348
GUJRANWALA,GUJRANWALA,DISTRICT,60 &  ABOVE,347142,198048,149072,22,148518,83829,64680,9,198624,114219,84392,13
GUJRANWALA,GUJRANWALA,DISTRICT,65 &  ABOVE,212620,123381,89229,10,94263,53967,40291,5,118357,69414,48938,5
GUJRANWALA CITY,GUJRANWALA,TEHSIL,ALL AGES,2510883,1290236,1220437,210,,,,,2510883,1290236,1220437,210
GUJRANWALA CITY,GUJRANWALA,TEHSIL,UNDER 1,56166,28520,27646,,,,,,56166,28520,27646,
GUJRANWALA CITY,GUJRANWALA,TEHSIL,UNDER 5,395253,201114,194139,,,,,,395253,201114,194139,
GUJRANWALA CITY,GUJRANWALA,TEHSIL,UNDER 10,670646,339902,330744,,,,,,670646,339902,330744,
GUJRANWALA CITY,GUJRANWALA,TEHSIL,UNDER 15,960383,487145,473230,8,,,,,960383,487145,473230,8
GUJRANWALA CITY,GUJRANWALA,TEHSIL,05 - 24,1041351,529704,511572,75,,,,,1041351,529704,511572,75
GUJRANWALA CITY,GUJRANWALA,TEHSIL,15 - 49,1260190,640878,619126,186,,,,,1260190,640878,619126,186
GUJRANWALA CITY,GUJRANWALA,TEHSIL,15 - 64,1470713,755690,714824,199,,,,,1470713,755690,714824,199
GUJRANWALA CITY,GUJRANWALA,TEHSIL,18 - 60,1277330,654481,622663,186,,,,,1277330,654481,622663,186
GUJRANWALA CITY,GUJRANWALA,TEHSIL,18 &  ABOVE,1396760,724264,672307,189,,,,,1396760,724264,672307,189
GUJRANWALA CITY,GUJRANWALA,TEHSIL,60 &  ABOVE,135472,78656,56809,7,,,,,135472,78656,56809,7
GUJRANWALA CITY,GUJRANWALA,TEHSIL,65 &  ABOVE,79787,47401,32383,3,,,,,79787,47401,32383,3
GUJRANWALA SADDAR,GUJRANWALA,TEHSIL,ALL AGES,1114167,562374,551752,41,770919,389691,381200,28,343248,172683,170552,13
GUJRANWALA SADDAR,GUJRANWALA,TEHSIL,UNDER 1,23974,11753,12221,,17155,8418,8737,,6819,3335,3484,
GUJRANWALA SADDAR,GUJRANWALA,TEHSIL,UNDER 5,163208,81393,81815,,115760,57765,57995,,47448,23628,23820,
GUJRANWALA SADDAR,GUJRANWALA,TEHSIL,UNDER 10,291771,145646,146125,,205333,102568,102765,,86438,43078,43360,
GUJRANWALA SADDAR,GUJRANWALA,TEHSIL,UNDER 15,421158,210245,210909,4,294996,147457,147537,2,126162,62788,63372,2
GUJRANWALA SADDAR,GUJRANWALA,TEHSIL,05 - 24,470906,234982,235910,14,327699,163931,163760,8,143207,71051,72150,6
GUJRANWALA SADDAR,GUJRANWALA,TEHSIL,15 - 49,558059,277801,280227,31,383211,191236,191952,23,174848,86565,88275,8
GUJRANWALA SADDAR,GUJRANWALA,TEHSIL,15 - 64,653567,329399,324131,37,448410,226458,221926,26,205157,102941,102205,11
GUJRANWALA SADDAR,GUJRANWALA,TEHSIL,18 - 60,566916,285097,281785,34,388320,195707,192588,25,178596,89390,89197,9
GUJRANWALA SADDAR,GUJRANWALA,TEHSIL,18 &  ABOVE,624474,317978,306462,34,428296,218462,209809,25,196178,99516,96653,9
GUJRANWALA SADDAR,GUJRANWALA,TEHSIL,60 &  ABOVE,64357,36582,27774,1,44508,25195,19313,,19849,11387,8461,1
GUJRANWALA SADDAR,GUJRANWALA,TEHSIL,65 &  ABOVE,39442,22730,16712,,27513,15776,11737,,11929,6954,4975,
KAMOKE,GUJRANWALA,TEHSIL,ALL AGES,681296,344833,336420,43,389316,197238,192067,11,291980,147595,144353,32
KAMOKE,GUJRANWALA,TEHSIL,UNDER 1,20624,10538,10086,,12434,6393,6041,,8190,4145,4045,
KAMOKE,GUJRANWALA,TEHSIL,UNDER 5,108837,54758,54079,,65587,33257,32330,,43250,21501,21749,
KAMOKE,GUJRANWALA,TEHSIL,UNDER 10,189667,95232,94435,,111986,56607,55379,,77681,38625,39056,
KAMOKE,GUJRANWALA,TEHSIL,UNDER 15,267697,133887,133809,1,156496,78675,77820,1,111201,55212,55989,
KAMOKE,GUJRANWALA,TEHSIL,05 - 24,290004,144583,145416,5,165288,82378,82908,2,124716,62205,62508,3
KAMOKE,GUJRANWALA,TEHSIL,15 - 49,332858,166376,166447,35,186095,92705,93380,10,146763,73671,73067,25
KAMOKE,GUJRANWALA,TEHSIL,15 - 64,389070,196853,192177,40,217917,109912,107995,10,171153,86941,84182,30
KAMOKE,GUJRANWALA,TEHSIL,18 - 60,336057,170021,165997,39,187556,94635,92911,10,148501,75386,73086,29
KAMOKE,GUJRANWALA,TEHSIL,18 &  ABOVE,371239,190105,181093,41,208626,106723,101893,10,162613,83382,79200,31
KAMOKE,GUJRANWALA,TEHSIL,60 &  ABOVE,39090,22164,16924,2,23369,13310,10059,,15721,8854,6865,2
KAMOKE,GUJRANWALA,TEHSIL,65 &  ABOVE,24529,14093,10434,2,14903,8651,6252,,9626,5442,4182,2
NOWSHERA VIRKAN,GUJRANWALA,TEHSIL,ALL AGES,640415,324370,315982,63,580780,294079,286648,53,59635,30291,29334,10
NOWSHERA VIRKAN,GUJRANWALA,TEHSIL,UNDER 1,17148,8609,8539,,15954,8012,7942,,1194,597,597,
NOWSHERA VIRKAN,GUJRANWALA,TEHSIL,UNDER 5,94975,47522,47453,,87881,44049,43832,,7094,3473,3621,
NOWSHERA VIRKAN,GUJRANWALA,TEHSIL,UNDER 10,170323,85540,84783,,156070,78451,77619,,14253,7089,7164,
NOWSHERA VIRKAN,GUJRANWALA,TEHSIL,UNDER 15,248611,125835,122775,1,225431,113936,111494,1,23180,11899,11281,
NOWSHERA VIRKAN,GUJRANWALA,TEHSIL,05 - 24,278446,140505,137914,27,250455,126075,124355,25,27991,14430,13559,2
NOWSHERA VIRKAN,GUJRANWALA,TEHSIL,15 - 49,312324,155163,157106,55,282615,140427,142142,46,29709,14736,14964,9
NOWSHERA VIRKAN,GUJRANWALA,TEHSIL,15 - 64,367332,184727,182543,62,332904,167461,165391,52,34428,17266,17152,10
NOWSHERA VIRKAN,GUJRANWALA,TEHSIL,18 - 60,315021,157898,157064,59,285731,143360,142322,49,29290,14538,14742,10
NOWSHERA VIRKAN,GUJRANWALA,TEHSIL,18 &  ABOVE,350153,177641,172452,60,317944,161484,156410,50,32209,16157,16042,10
NOWSHERA VIRKAN,GUJRANWALA,TEHSIL,60 &  ABOVE,38571,21565,17004,2,35347,19792,15554,1,3224,1773,1450,1
NOWSHERA VIRKAN,GUJRANWALA,TEHSIL,65 &  ABOVE,24472,13808,10664,,22445,12682,9763,,2027,1126,901,
WAZIRABAD,GUJRANWALA,TEHSIL,ALL AGES,993412,497082,496150,180,624403,312499,311842,62,369009,184583,184308,118
WAZIRABAD,GUJRANWALA,TEHSIL,UNDER 1,28187,14303,13884,,18131,9278,8853,,10056,5025,5031,
WAZIRABAD,GUJRANWALA,TEHSIL,UNDER 5,161277,81784,79493,,100435,51317,49118,,60842,30467,30375,
WAZIRABAD,GUJRANWALA,TEHSIL,UNDER 10,271868,137462,134406,,170593,86578,84015,,101275,50884,50391,
WAZIRABAD,GUJRANWALA,TEHSIL,UNDER 15,382482,193401,189076,5,240202,121675,118524,3,142280,71726,70552,2
WAZIRABAD,GUJRANWALA,TEHSIL,05 - 24,402326,200932,201327,67,254653,126763,127866,24,147673,74169,73461,43
WAZIRABAD,GUJRANWALA,TEHSIL,15 - 49,474130,229219,244760,151,296284,142739,153501,44,177846,86480,91259,107
WAZIRABAD,GUJRANWALA,TEHSIL,15 - 64,566540,278332,288038,170,354799,173966,180779,54,211741,104366,107259,116
WAZIRABAD,GUJRANWALA,TEHSIL,18 - 60,488713,238335,250229,149,305399,148724,156634,41,183314,89611,93595,108
WAZIRABAD,GUJRANWALA,TEHSIL,18 &  ABOVE,552032,274082,277793,157,346697,172142,174507,48,205335,101940,103286,109
WAZIRABAD,GUJRANWALA,TEHSIL,60 &  ABOVE,69652,39081,30561,10,45294,25532,19754,8,24358,13549,10807,2
WAZIRABAD,GUJRANWALA,TEHSIL,65 &  ABOVE,44390,25349,19036,5,29402,16858,12539,5,14988,8491,6497,
GUJRAT,GUJRAT,DISTRICT,ALL AGES,3216000,1606601,1609209,190,1892820,934454,958324,42,1323180,672147,650885,148
GUJRAT,GUJRAT,DISTRICT,UNDER 1,60971,30448,30523,,37840,18825,19015,,23131,11623,11508,
GUJRAT,GUJRAT,DISTRICT,UNDER 5,378857,188910,189947,,225969,112634,113335,,152888,76276,76612,
GUJRAT,GUJRAT,DISTRICT,UNDER 10,717826,358124,359702,,426133,212659,213474,,291693,145465,146228,
GUJRAT,GUJRAT,DISTRICT,UNDER 15,1068091,532399,535688,4,632055,314938,317116,1,436036,217461,218572,3
GUJRAT,GUJRAT,DISTRICT,05 - 24,1280088,636402,643637,49,753971,373171,380789,11,526117,263231,262848,38
GUJRAT,GUJRAT,DISTRICT,15 - 49,1644055,809992,833917,146,950623,458868,491729,26,693432,351124,342188,120
GUJRAT,GUJRAT,DISTRICT,15 - 64,1969462,977219,992067,176,1145128,557646,587446,36,824334,419573,404621,140
GUJRAT,GUJRAT,DISTRICT,18 - 60,1710528,846184,864187,157,990587,480335,510224,28,719941,365849,353963,129
GUJRAT,GUJRAT,DISTRICT,18 &  ABOVE,1959045,979843,979029,173,1148900,564146,584720,34,810145,415697,394309,139
GUJRAT,GUJRAT,DISTRICT,60 &  ABOVE,269808,144553,125239,16,171226,90350,80870,6,98582,54203,44369,10
GUJRAT,GUJRAT,DISTRICT,65 &  ABOVE,178447,96983,81454,10,115637,61870,53762,5,62810,35113,27692,5
GUJRAT,GUJRAT,TEHSIL,ALL AGES,1744046,871388,872564,94,812767,404398,408353,16,931279,466990,464211,78
GUJRAT,GUJRAT,TEHSIL,UNDER 1,30750,15322,15428,,15598,7705,7893,,15152,7617,7535,
GUJRAT,GUJRAT,TEHSIL,UNDER 5,203645,101187,102458,,96776,48071,48705,,106869,53116,53753,
GUJRAT,GUJRAT,TEHSIL,UNDER 10,387963,193242,194721,,182562,90920,91642,,205401,102322,103079,
GUJRAT,GUJRAT,TEHSIL,UNDER 15,578279,288175,290101,3,269898,134465,135432,1,308381,153710,154669,2
GUJRAT,GUJRAT,TEHSIL,05 - 24,700285,349009,351247,29,325120,161600,163514,6,375165,187409,187733,23
GUJRAT,GUJRAT,TEHSIL,15 - 49,892956,438478,454405,73,411258,201154,210095,9,481698,237324,244310,64
GUJRAT,GUJRAT,TEHSIL,15 - 64,1071327,531316,539924,87,494223,243907,250302,14,577104,287409,289622,73
GUJRAT,GUJRAT,TEHSIL,18 - 60,930208,459425,470709,74,428307,210815,217483,9,501901,248610,253226,65
GUJRAT,GUJRAT,TEHSIL,18 &  ABOVE,1062882,531588,531212,82,495180,246294,248875,11,567702,285294,282337,71
GUJRAT,GUJRAT,TEHSIL,60 &  ABOVE,144051,78048,65995,8,72174,38187,33985,2,71877,39861,32010,6
GUJRAT,GUJRAT,TEHSIL,65 &  ABOVE,94440,51897,42539,4,48646,26026,22619,1,45794,25871,19920,3
KHARIAN,GUJRAT,TEHSIL,ALL AGES,1174083,586443,587552,88,855985,417904,438059,22,318098,168539,149493,66
KHARIAN,GUJRAT,TEHSIL,UNDER 1,23458,11653,11805,,17016,8428,8588,,6442,3225,3217,
KHARIAN,GUJRAT,TEHSIL,UNDER 5,138366,69053,69313,,100978,50237,50741,,37388,18816,18572,
KHARIAN,GUJRAT,TEHSIL,UNDER 10,262744,131075,131669,,192687,96021,96666,,70057,35054,35003,
KHARIAN,GUJRAT,TEHSIL,UNDER 15,390690,194409,196280,1,287608,142888,144720,,103082,51521,51560,1
KHARIAN,GUJRAT,TEHSIL,05 - 24,463274,229297,233957,20,341870,168133,173732,5,121404,61164,60225,15
KHARIAN,GUJRAT,TEHSIL,15 - 49,598384,296408,301908,68,425329,201472,223841,16,173055,94936,78067,52
KHARIAN,GUJRAT,TEHSIL,15 - 64,715018,355257,359680,81,513920,245787,268115,18,201098,109470,91565,63
KHARIAN,GUJRAT,TEHSIL,18 - 60,621096,308154,312867,75,443198,210573,232610,15,177898,97581,80257,60
KHARIAN,GUJRAT,TEHSIL,18 &  ABOVE,714878,357972,356823,83,517199,249729,267451,19,197679,108243,89372,64
KHARIAN,GUJRAT,TEHSIL,60 &  ABOVE,101738,53821,47909,8,80079,42208,37867,4,21659,11613,10042,4
KHARIAN,GUJRAT,TEHSIL,65 &  ABOVE,68375,36777,31592,6,54457,29229,25224,4,13918,7548,6368,2
SARAI ALAMGIR,GUJRAT,TEHSIL,ALL AGES,297871,148770,149093,8,224068,112152,111912,4,73803,36618,37181,4
SARAI ALAMGIR,GUJRAT,TEHSIL,UNDER 1,6763,3473,3290,,5226,2692,2534,,1537,781,756,
SARAI ALAMGIR,GUJRAT,TEHSIL,UNDER 5,36846,18670,18176,,28215,14326,13889,,8631,4344,4287,
SARAI ALAMGIR,GUJRAT,TEHSIL,UNDER 10,67119,33807,33312,,50884,25718,25166,,16235,8089,8146,
SARAI ALAMGIR,GUJRAT,TEHSIL,UNDER 15,99122,49815,49307,,74549,37585,36964,,24573,12230,12343,
SARAI ALAMGIR,GUJRAT,TEHSIL,05 - 24,116529,58096,58433,,86981,43438,43543,,29548,14658,14890,
SARAI ALAMGIR,GUJRAT,TEHSIL,15 - 49,152715,75106,77604,5,114036,56242,57793,1,38679,18864,19811,4
SARAI ALAMGIR,GUJRAT,TEHSIL,15 - 64,183117,90646,92463,8,136985,67952,69029,4,46132,22694,23434,4
SARAI ALAMGIR,GUJRAT,TEHSIL,18 - 60,159224,78605,80611,8,119082,58947,60131,4,40142,19658,20480,4
SARAI ALAMGIR,GUJRAT,TEHSIL,18 &  ABOVE,181285,90283,90994,8,136521,68123,68394,4,44764,22160,22600,4
SARAI ALAMGIR,GUJRAT,TEHSIL,60 &  ABOVE,24019,12684,11335,,18973,9955,9018,,5046,2729,2317,
SARAI ALAMGIR,GUJRAT,TEHSIL,65 &  ABOVE,15632,8309,7323,,12534,6615,5919,,3098,1694,1404,
HAFIZABAD,HAFIZABAD,DISTRICT,ALL AGES,1319651,669900,649691,60,815517,414531,400966,20,504134,255369,248725,40
HAFIZABAD,HAFIZABAD,DISTRICT,UNDER 1,28927,14644,14283,,18207,9311,8896,,10720,5333,5387,
HAFIZABAD,HAFIZABAD,DISTRICT,UNDER 5,178061,89484,88577,,111224,56164,55060,,66837,33320,33517,
HAFIZABAD,HAFIZABAD,DISTRICT,UNDER 10,331008,166168,164840,,207105,104325,102780,,123903,61843,62060,
HAFIZABAD,HAFIZABAD,DISTRICT,UNDER 15,484473,243312,241159,2,301503,151754,149747,2,182970,91558,91412,
HAFIZABAD,HAFIZABAD,DISTRICT,05 - 24,555929,279186,276725,18,342353,172283,170062,8,213576,106903,106663,10
HAFIZABAD,HAFIZABAD,DISTRICT,15 - 49,656233,327975,328209,49,398949,199308,199624,17,257284,128667,128585,32
HAFIZABAD,HAFIZABAD,DISTRICT,15 - 64,776096,392770,383268,58,473686,239705,233963,18,302410,153065,149305,40
HAFIZABAD,HAFIZABAD,DISTRICT,18 - 60,670602,338764,331786,52,408774,206406,202353,15,261828,132358,129433,37
HAFIZABAD,HAFIZABAD,DISTRICT,18 &  ABOVE,752477,385101,367324,52,463481,237346,226120,15,288996,147755,141204,37
HAFIZABAD,HAFIZABAD,DISTRICT,60 &  ABOVE,90727,51092,39634,1,60336,33922,26414,,30391,17170,13220,1
HAFIZABAD,HAFIZABAD,DISTRICT,65 &  ABOVE,59082,33818,25264,,40328,23072,17256,,18754,10746,8008,
HAFIZABAD,HAFIZABAD,TEHSIL,ALL AGES,760900,385117,375749,34,418156,211293,206854,9,342744,173824,168895,25
HAFIZABAD,HAFIZABAD,TEHSIL,UNDER 1,16920,8511,8409,,9139,4648,4491,,7781,3863,3918,
HAFIZABAD,HAFIZABAD,TEHSIL,UNDER 5,103760,52093,51667,,57226,28783,28443,,46534,23310,23224,
HAFIZABAD,HAFIZABAD,TEHSIL,UNDER 10,187688,94111,93577,,103572,51896,51676,,84116,42215,41901,
HAFIZABAD,HAFIZABAD,TEHSIL,UNDER 15,274686,137437,137248,1,151068,75444,75623,1,123618,61993,61625,
HAFIZABAD,HAFIZABAD,TEHSIL,05 - 24,316462,158027,158424,11,173146,86185,86956,5,143316,71842,71468,6
HAFIZABAD,HAFIZABAD,TEHSIL,15 - 49,382228,190102,192100,26,207273,102805,104461,7,174955,87297,87639,19
HAFIZABAD,HAFIZABAD,TEHSIL,15 - 64,452242,228052,224157,33,246183,123813,122362,8,206059,104239,101795,25
HAFIZABAD,HAFIZABAD,TEHSIL,18 - 60,391135,196875,194232,28,212846,106884,105956,6,178289,89991,88276,22
HAFIZABAD,HAFIZABAD,TEHSIL,18 &  ABOVE,438362,223854,214480,28,241173,123023,118144,6,197189,100831,96336,22
HAFIZABAD,HAFIZABAD,TEHSIL,60 &  ABOVE,52584,29860,22723,1,31413,17766,13647,,21171,12094,9076,1
HAFIZABAD,HAFIZABAD,TEHSIL,65 &  ABOVE,33972,19628,14344,,20905,12036,8869,,13067,7592,5475,
PINDI BHATTIAN,HAFIZABAD,TEHSIL,ALL AGES,558751,284783,273942,26,397361,203238,194112,11,161390,81545,79830,15
PINDI BHATTIAN,HAFIZABAD,TEHSIL,UNDER 1,12007,6133,5874,,9068,4663,4405,,2939,1470,1469,
PINDI BHATTIAN,HAFIZABAD,TEHSIL,UNDER 5,74301,37391,36910,,53998,27381,26617,,20303,10010,10293,
PINDI BHATTIAN,HAFIZABAD,TEHSIL,UNDER 10,143320,72057,71263,,103533,52429,51104,,39787,19628,20159,
PINDI BHATTIAN,HAFIZABAD,TEHSIL,UNDER 15,209787,105875,103911,1,150435,76310,74124,1,59352,29565,29787,
PINDI BHATTIAN,HAFIZABAD,TEHSIL,05 - 24,239467,121159,118301,7,169207,86098,83106,3,70260,35061,35195,4
PINDI BHATTIAN,HAFIZABAD,TEHSIL,15 - 49,274005,137873,136109,23,191676,96503,95163,10,82329,41370,40946,13
PINDI BHATTIAN,HAFIZABAD,TEHSIL,15 - 64,323854,164718,159111,25,227503,115892,111601,10,96351,48826,47510,15
PINDI BHATTIAN,HAFIZABAD,TEHSIL,18 - 60,279467,141889,137554,24,195928,99522,96397,9,83539,42367,41157,15
PINDI BHATTIAN,HAFIZABAD,TEHSIL,18 &  ABOVE,314115,161247,152844,24,222308,114323,107976,9,91807,46924,44868,15
PINDI BHATTIAN,HAFIZABAD,TEHSIL,60 &  ABOVE,38143,21232,16911,,28923,16156,12767,,9220,5076,4144,
PINDI BHATTIAN,HAFIZABAD,TEHSIL,65 &  ABOVE,25110,14190,10920,,19423,11036,8387,,5687,3154,2533,
JHANG,JHANG,DISTRICT,ALL AGES,3065639,1585616,1479771,252,2264713,1172367,1092267,79,800926,413249,387504,173
JHANG,JHANG,DISTRICT,UNDER 1,74492,39238,35254,,56066,29712,26354,,18426,9526,8900,
JHANG,JHANG,DISTRICT,UNDER 5,432004,224909,207095,,329753,171747,158006,,102251,53162,49089,
JHANG,JHANG,DISTRICT,UNDER 10,837169,433834,403335,,640039,332021,308018,,197130,101813,95317,
JHANG,JHANG,DISTRICT,UNDER 15,1205557,628236,577318,3,914452,477042,437408,2,291105,151194,139910,1
JHANG,JHANG,DISTRICT,05 - 24,1329508,692549,636883,76,987477,515459,471999,19,342031,177090,164884,57
JHANG,JHANG,DISTRICT,15 - 49,1455060,740870,713970,220,1048997,534076,514859,62,406063,206794,199111,158
JHANG,JHANG,DISTRICT,15 - 64,1729240,885532,843468,240,1249518,639743,609703,72,479722,245789,233765,168
JHANG,JHANG,DISTRICT,18 - 60,1489393,757224,731947,222,1075057,546537,528457,63,414336,210687,203490,159
JHANG,JHANG,DISTRICT,18 &  ABOVE,1674414,858369,815808,237,1215627,623526,592031,70,458787,234843,223777,167
JHANG,JHANG,DISTRICT,60 &  ABOVE,201765,109868,91879,18,152933,83402,69523,8,48832,26466,22356,10
JHANG,JHANG,DISTRICT,65 &  ABOVE,130842,71848,58985,9,100743,55582,45156,5,30099,16266,13829,4
-HAZARI,JHANG,TEHSIL,ALL AGES,332295,170981,161284,30,302158,155424,146719,15,30137,15557,14565,15
-HAZARI,JHANG,TEHSIL,UNDER 1,7559,3932,3627,,6936,3626,3310,,623,306,317,
-HAZARI,JHANG,TEHSIL,UNDER 5,46956,24219,22737,,42856,22126,20730,,4100,2093,2007,
-HAZARI,JHANG,TEHSIL,UNDER 10,91255,46963,44292,,83289,42935,40354,,7966,4028,3938,
-HAZARI,JHANG,TEHSIL,UNDER 15,131565,68117,63447,1,119768,61971,57796,1,11797,6146,5651,
-HAZARI,JHANG,TEHSIL,05 - 24,145136,75206,69917,13,132027,68402,63622,3,13109,6804,6295,10
-HAZARI,JHANG,TEHSIL,15 - 49,157205,79675,77503,27,142647,72301,70334,12,14558,7374,7169,15
-HAZARI,JHANG,TEHSIL,15 - 64,186589,95079,91481,29,169441,86355,83072,14,17148,8724,8409,15
-HAZARI,JHANG,TEHSIL,18 - 60,160577,81231,79318,28,145769,73791,71964,14,14808,7440,7354,14
-HAZARI,JHANG,TEHSIL,18 &  ABOVE,180607,92205,88374,28,164084,83788,80282,14,16523,8417,8092,14
-HAZARI,JHANG,TEHSIL,60 &  ABOVE,21770,11857,9913,,19900,10804,9096,,1870,1053,817,
-HAZARI,JHANG,TEHSIL,65 &  ABOVE,14141,7785,6356,,12949,7098,5851,,1192,687,505,
AHMADPUR SIAL,JHANG,TEHSIL,ALL AGES,487905,252533,235336,36,407703,211372,196310,21,80202,41161,39026,15
AHMADPUR SIAL,JHANG,TEHSIL,UNDER 1,16058,8694,7364,,13662,7453,6209,,2396,1241,1155,
AHMADPUR SIAL,JHANG,TEHSIL,UNDER 5,76961,40301,36660,,65295,34272,31023,,11666,6029,5637,
AHMADPUR SIAL,JHANG,TEHSIL,UNDER 10,146052,76052,70000,,123721,64528,59193,,22331,11524,10807,
AHMADPUR SIAL,JHANG,TEHSIL,UNDER 15,206519,108229,98290,,174318,91432,82886,,32201,16797,15404,
AHMADPUR SIAL,JHANG,TEHSIL,05 - 24,212590,111006,101581,3,177781,93005,84773,3,34809,18001,16808,
AHMADPUR SIAL,JHANG,TEHSIL,15 - 49,220613,112267,108312,34,182545,93085,89441,19,38068,19182,18871,15
AHMADPUR SIAL,JHANG,TEHSIL,15 - 64,261440,133462,127943,35,216469,110720,105729,20,44971,22742,22214,15
AHMADPUR SIAL,JHANG,TEHSIL,18 - 60,225042,114270,110739,33,186183,94723,91442,18,38859,19547,19297,15
AHMADPUR SIAL,JHANG,TEHSIL,18 &  ABOVE,253150,129404,123712,34,209861,107473,102369,19,43289,21931,21343,15
AHMADPUR SIAL,JHANG,TEHSIL,60 &  ABOVE,30224,16261,13962,1,25453,13695,11757,1,4771,2566,2205,
AHMADPUR SIAL,JHANG,TEHSIL,65 &  ABOVE,19946,10842,9103,1,16916,9220,7695,1,3030,1622,1408,
JHANG,JHANG,TEHSIL,ALL AGES,1640676,849966,790594,116,1017583,527727,489836,20,623093,322239,300758,96
JHANG,JHANG,TEHSIL,UNDER 1,38657,20198,18459,,24502,12875,11627,,14155,7323,6832,
JHANG,JHANG,TEHSIL,UNDER 5,227445,118795,108650,,148534,77694,70840,,78911,41101,37810,
JHANG,JHANG,TEHSIL,UNDER 10,438589,227735,210854,,287225,149337,137888,,151364,78398,72966,
JHANG,JHANG,TEHSIL,UNDER 15,631926,329449,302475,2,408332,213214,195117,1,223594,116235,107358,1
JHANG,JHANG,TEHSIL,05 - 24,705089,367170,337883,36,439962,229580,210377,5,265127,137590,127506,31
JHANG,JHANG,TEHSIL,15 - 49,789266,402424,386746,96,470461,239471,230978,12,318805,162953,155768,84
JHANG,JHANG,TEHSIL,15 - 64,938926,481977,456841,108,562644,288504,274124,16,376282,193473,182717,92
JHANG,JHANG,TEHSIL,18 - 60,809429,412303,397030,96,484399,246461,237926,12,325030,165842,159104,84
JHANG,JHANG,TEHSIL,18 &  ABOVE,908620,466920,441593,107,549235,282435,266784,16,359385,184485,174809,91
JHANG,JHANG,TEHSIL,60 &  ABOVE,108519,59563,48944,12,70675,39070,31600,5,37844,20493,17344,7
JHANG,JHANG,TEHSIL,65 &  ABOVE,69824,38540,31278,6,46607,26009,20595,3,23217,12531,10683,3
SHORKOT,JHANG,TEHSIL,ALL AGES,604763,312136,292557,70,537269,277844,259402,23,67494,34292,33155,47
SHORKOT,JHANG,TEHSIL,UNDER 1,12218,6414,5804,,10966,5758,5208,,1252,656,596,
SHORKOT,JHANG,TEHSIL,UNDER 5,80642,41594,39048,,73068,37655,35413,,7574,3939,3635,
SHORKOT,JHANG,TEHSIL,UNDER 10,161273,83084,78189,,145804,75221,70583,,15469,7863,7606,
SHORKOT,JHANG,TEHSIL,UNDER 15,235547,122441,113106,,212034,110425,101609,,23513,12016,11497,
SHORKOT,JHANG,TEHSIL,05 - 24,266693,139167,127502,24,237707,124472,113227,8,28986,14695,14275,16
SHORKOT,JHANG,TEHSIL,15 - 49,287976,146504,141409,63,253344,129219,124106,19,34632,17285,17303,44
SHORKOT,JHANG,TEHSIL,15 - 64,342285,175014,167203,68,300964,154164,146778,22,41321,20850,20425,46
SHORKOT,JHANG,TEHSIL,18 - 60,294345,149420,144860,65,258706,131562,127125,19,35639,17858,17735,46
SHORKOT,JHANG,TEHSIL,18 &  ABOVE,332037,169840,162129,68,292447,149830,142596,21,39590,20010,19533,47
SHORKOT,JHANG,TEHSIL,60 &  ABOVE,41252,22187,19060,5,36905,19833,17070,2,4347,2354,1990,3
SHORKOT,JHANG,TEHSIL,65 &  ABOVE,26931,14681,12248,2,24271,13255,11015,1,2660,1426,1233,1
JHELUM,JHELUM,DISTRICT,ALL AGES,1366297,695983,670216,98,837927,425051,412859,17,528370,270932,257357,81
JHELUM,JHELUM,DISTRICT,UNDER 1,22792,11703,11089,,14355,7363,6992,,8437,4340,4097,
JHELUM,JHELUM,DISTRICT,UNDER 5,147274,75478,71796,,91780,47079,44701,,55494,28399,27095,
JHELUM,JHELUM,DISTRICT,UNDER 10,284927,145031,139896,,176313,89891,86422,,108614,55140,53474,
JHELUM,JHELUM,DISTRICT,UNDER 15,425753,219149,206603,1,261259,134356,126902,1,164494,84793,79701,
JHELUM,JHELUM,DISTRICT,05 - 24,521211,268749,252447,15,316496,162621,153869,6,204715,106128,98578,9
JHELUM,JHELUM,DISTRICT,15 - 49,709184,357147,351955,82,429836,215380,214442,14,279348,141767,137513,68
JHELUM,JHELUM,DISTRICT,15 - 64,859846,434113,425639,94,523313,262712,260585,16,336533,171401,165054,78
JHELUM,JHELUM,DISTRICT,18 - 60,748701,375765,372847,89,455130,227086,228029,15,293571,148679,144818,74
JHELUM,JHELUM,DISTRICT,18 &  ABOVE,862967,436007,426865,95,529746,266097,263634,15,333221,169910,163231,80
JHELUM,JHELUM,DISTRICT,60 &  ABOVE,123412,64955,58451,6,80213,41884,38329,,43199,23071,20122,6
JHELUM,JHELUM,DISTRICT,65 &  ABOVE,80698,42721,37974,3,53355,27983,25372,,27343,14738,12602,3
DINA,JHELUM,TEHSIL,ALL AGES,269927,139497,130385,45,170935,87601,83333,1,98992,51896,47052,44
DINA,JHELUM,TEHSIL,UNDER 1,4083,2071,2012,,2709,1361,1348,,1374,710,664,
DINA,JHELUM,TEHSIL,UNDER 5,28009,14330,13679,,17704,9042,8662,,10305,5288,5017,
DINA,JHELUM,TEHSIL,UNDER 10,54274,27609,26665,,33668,17092,16576,,20606,10517,10089,
DINA,JHELUM,TEHSIL,UNDER 15,82234,42516,39718,,50989,26295,24694,,31245,16221,15024,
DINA,JHELUM,TEHSIL,05 - 24,102906,53855,49043,8,64020,33414,30606,,38886,20441,18437,8
DINA,JHELUM,TEHSIL,15 - 49,143015,73992,68981,42,89540,45853,43686,1,53475,28139,25295,41
DINA,JHELUM,TEHSIL,15 - 64,171708,88596,83068,44,108655,55468,53186,1,63053,33128,29882,43
DINA,JHELUM,TEHSIL,18 - 60,149912,77032,72836,44,94678,48138,46539,1,55234,28894,26297,43
DINA,JHELUM,TEHSIL,18 &  ABOVE,172215,88661,83509,45,110271,56163,54107,1,61944,32498,29402,44
DINA,JHELUM,TEHSIL,60 &  ABOVE,24071,12529,11541,1,16742,8601,8141,,7329,3928,3400,1
DINA,JHELUM,TEHSIL,65 &  ABOVE,15985,8385,7599,1,11291,5838,5453,,4694,2547,2146,1
JHELUM,JHELUM,TEHSIL,ALL AGES,499032,254864,244139,29,194788,98909,95876,3,304244,155955,148263,26
JHELUM,JHELUM,TEHSIL,UNDER 1,8339,4255,4084,,3473,1784,1689,,4866,2471,2395,
JHELUM,JHELUM,TEHSIL,UNDER 5,53405,27343,26062,,21976,11255,10721,,31429,16088,15341,
JHELUM,JHELUM,TEHSIL,UNDER 10,103623,52753,50870,,41829,21369,20460,,61794,31384,30410,
JHELUM,JHELUM,TEHSIL,UNDER 15,156421,80485,75936,,62093,31874,30219,,94328,48611,45717,
JHELUM,JHELUM,TEHSIL,05 - 24,192973,99627,93343,3,74748,38351,36394,3,118225,61276,56949,
JHELUM,JHELUM,TEHSIL,15 - 49,260128,131129,128976,23,99555,49903,49649,3,160573,81226,79327,20
JHELUM,JHELUM,TEHSIL,15 - 64,314825,159362,155434,29,120694,60693,59998,3,194131,98669,95436,26
JHELUM,JHELUM,TEHSIL,18 - 60,274123,137942,136155,26,104860,52392,52465,3,169263,85550,83690,23
JHELUM,JHELUM,TEHSIL,18 &  ABOVE,313894,159305,154560,29,121603,61219,60381,3,192291,98086,94179,26
JHELUM,JHELUM,TEHSIL,60 &  ABOVE,43269,23154,20112,3,18047,9492,8555,,25222,13662,11557,3
JHELUM,JHELUM,TEHSIL,65 &  ABOVE,27786,15017,12769,,12001,6342,5659,,15785,8675,7110,
PIND DADAN KHAN,JHELUM,TEHSIL,ALL AGES,371971,188587,183370,14,307222,155576,151639,7,64749,33011,31731,7
PIND DADAN KHAN,JHELUM,TEHSIL,UNDER 1,6299,3274,3025,,5320,2756,2564,,979,518,461,
PIND DADAN KHAN,JHELUM,TEHSIL,UNDER 5,41381,21208,20173,,34434,17676,16758,,6947,3532,3415,
PIND DADAN KHAN,JHELUM,TEHSIL,UNDER 10,79720,40452,39268,,66328,33729,32599,,13392,6723,6669,
PIND DADAN KHAN,JHELUM,TEHSIL,UNDER 15,116631,59786,56845,,97017,49739,47278,,19614,10047,9567,
PIND DADAN KHAN,JHELUM,TEHSIL,05 - 24,139738,71241,68496,1,115679,58906,56773,,24059,12335,11723,1
PIND DADAN KHAN,JHELUM,TEHSIL,15 - 49,191857,95769,96078,10,157434,78431,78997,6,34423,17338,17081,4
PIND DADAN KHAN,JHELUM,TEHSIL,15 - 64,233926,117342,116571,13,191993,96058,95928,7,41933,21284,20643,6
PIND DADAN KHAN,JHELUM,TEHSIL,18 - 60,203887,101662,102213,12,167275,83173,84095,7,36612,18489,18118,5
PIND DADAN KHAN,JHELUM,TEHSIL,18 &  ABOVE,234849,118182,116654,13,193407,97154,96246,7,41442,21028,20408,6
PIND DADAN KHAN,JHELUM,TEHSIL,60 &  ABOVE,33397,17794,15602,1,28192,15053,13139,,5205,2741,2463,1
PIND DADAN KHAN,JHELUM,TEHSIL,65 &  ABOVE,21414,11459,9954,1,18212,9779,8433,,3202,1680,1521,1
SOHAWA,JHELUM,TEHSIL,ALL AGES,225367,113035,112322,10,164982,82965,82011,6,60385,30070,30311,4
SOHAWA,JHELUM,TEHSIL,UNDER 1,4071,2103,1968,,2853,1462,1391,,1218,641,577,
SOHAWA,JHELUM,TEHSIL,UNDER 5,24479,12597,11882,,17666,9106,8560,,6813,3491,3322,
SOHAWA,JHELUM,TEHSIL,UNDER 10,47310,24217,23093,,34488,17701,16787,,12822,6516,6306,
SOHAWA,JHELUM,TEHSIL,UNDER 15,70467,36362,34104,1,51160,26448,24711,1,19307,9914,9393,
SOHAWA,JHELUM,TEHSIL,05 - 24,85594,44026,41565,3,62049,31950,30096,3,23545,12076,11469,
SOHAWA,JHELUM,TEHSIL,15 - 49,114184,56257,57920,7,83307,41193,42110,4,30877,15064,15810,3
SOHAWA,JHELUM,TEHSIL,15 - 64,139387,68813,70566,8,101971,50493,51473,5,37416,18320,19093,3
SOHAWA,JHELUM,TEHSIL,18 - 60,120779,59129,61643,7,88317,43383,44930,4,32462,15746,16713,3
SOHAWA,JHELUM,TEHSIL,18 &  ABOVE,142009,69859,72142,8,104465,51561,52900,4,37544,18298,19242,4
SOHAWA,JHELUM,TEHSIL,60 &  ABOVE,22675,11478,11196,1,17232,8738,8494,,5443,2740,2702,1
SOHAWA,JHELUM,TEHSIL,65 &  ABOVE,15513,7860,7652,1,11851,6024,5827,,3662,1836,1825,1
KASUR,KASUR,DISTRICT,ALL AGES,4081568,2085912,1995257,399,2840199,1454358,1385702,139,1241369,631554,609555,260
KASUR,KASUR,DISTRICT,UNDER 1,108758,55399,53359,,75427,38332,37095,,33331,17067,16264,
KASUR,KASUR,DISTRICT,UNDER 5,633768,319609,314159,,446927,225335,221592,,186841,94274,92567,
KASUR,KASUR,DISTRICT,UNDER 10,1146988,577539,569449,,813116,409405,403711,,333872,168134,165738,
KASUR,KASUR,DISTRICT,UNDER 15,1625043,818658,806368,17,1150772,579660,571105,7,474271,238998,235263,10
KASUR,KASUR,DISTRICT,05 - 24,1751984,883123,868714,147,1234947,624105,610791,51,517037,259018,257923,96
KASUR,KASUR,DISTRICT,15 - 49,1981440,1010541,970555,344,1360393,697361,662913,119,621047,313180,307642,225
KASUR,KASUR,DISTRICT,15 - 64,2312789,1188243,1124177,369,1587112,818478,768508,126,725677,369765,355669,243
KASUR,KASUR,DISTRICT,18 - 60,1993932,1025537,968065,330,1363370,704369,658891,110,630562,321168,309174,220
KASUR,KASUR,DISTRICT,18 &  ABOVE,2201901,1139517,1062041,343,1510133,784600,725417,116,691768,354917,336624,227
KASUR,KASUR,DISTRICT,60 &  ABOVE,230095,125840,104240,15,162012,88386,73620,6,68083,37454,30620,9
KASUR,KASUR,DISTRICT,65 &  ABOVE,143736,79011,64712,13,102315,56220,46089,6,41421,22791,18623,7
CHUNIAN,KASUR,TEHSIL,ALL AGES,977028,497971,478944,113,773329,394565,378709,55,203699,103406,100235,58
CHUNIAN,KASUR,TEHSIL,UNDER 1,25033,12725,12308,,19847,10114,9733,,5186,2611,2575,
CHUNIAN,KASUR,TEHSIL,UNDER 5,150241,76214,74027,,119943,60841,59102,,30298,15373,14925,
CHUNIAN,KASUR,TEHSIL,UNDER 10,277574,140428,137146,,221338,111921,109417,,56236,28507,27729,
CHUNIAN,KASUR,TEHSIL,UNDER 15,397090,200919,196170,1,315916,159701,156214,1,81174,41218,39956,
CHUNIAN,KASUR,TEHSIL,05 - 24,425109,214265,210815,29,336420,169636,166766,18,88689,44629,44049,11
CHUNIAN,KASUR,TEHSIL,15 - 49,462353,234567,227685,101,363186,184787,178350,49,99167,49780,49335,52
CHUNIAN,KASUR,TEHSIL,15 - 64,542112,276753,265250,109,426460,218229,208178,53,115652,58524,57072,56
CHUNIAN,KASUR,TEHSIL,18 - 60,464358,237183,227072,103,365123,186999,178074,50,99235,50184,48998,53
CHUNIAN,KASUR,TEHSIL,18 &  ABOVE,517990,265840,252044,106,408802,210358,198393,51,109188,55482,53651,55
CHUNIAN,KASUR,TEHSIL,60 &  ABOVE,58689,31405,27280,4,47638,25510,22127,1,11051,5895,5153,3
CHUNIAN,KASUR,TEHSIL,65 &  ABOVE,37826,20299,17524,3,30953,16635,14317,1,6873,3664,3207,2
KASUR,KASUR,TEHSIL,ALL AGES,1603658,819603,783908,147,896310,458907,437393,10,707348,360696,346515,137
KASUR,KASUR,TEHSIL,UNDER 1,49653,25763,23890,,28713,14817,13896,,20940,10946,9994,
KASUR,KASUR,TEHSIL,UNDER 5,260605,132358,128247,,151040,76504,74536,,109565,55854,53711,
KASUR,KASUR,TEHSIL,UNDER 10,457899,231339,226560,,265477,133951,131526,,192422,97388,95034,
KASUR,KASUR,TEHSIL,UNDER 15,637951,322182,315768,1,368345,185870,182475,,269606,136312,133293,1
KASUR,KASUR,TEHSIL,05 - 24,673049,338300,334701,48,383567,193435,190129,3,289482,144865,144572,45
KASUR,KASUR,TEHSIL,15 - 49,779559,396059,383370,130,425697,217645,208044,8,353862,178414,175326,122
KASUR,KASUR,TEHSIL,15 - 64,909829,466397,443292,140,495789,255144,240636,9,414040,211253,202656,131
KASUR,KASUR,TEHSIL,18 - 60,788389,404570,383692,127,427130,220291,206832,7,361259,184279,176860,120
KASUR,KASUR,TEHSIL,18 &  ABOVE,869011,449229,419649,133,472776,245488,227280,8,396235,203741,192369,125
KASUR,KASUR,TEHSIL,60 &  ABOVE,89748,49529,40213,6,50751,27879,22871,1,38997,21650,17342,5
KASUR,KASUR,TEHSIL,65 &  ABOVE,55878,31024,24848,6,32176,17893,14282,1,23702,13131,10566,5
KOT RADHA KISHAN,KASUR,TEHSIL,ALL AGES,424875,218498,206359,18,322818,166439,156371,8,102057,52059,49988,10
KOT RADHA KISHAN,KASUR,TEHSIL,UNDER 1,11269,5594,5675,,8860,4432,4428,,2409,1162,1247,
KOT RADHA KISHAN,KASUR,TEHSIL,UNDER 5,68257,34319,33938,,52455,26386,26069,,15802,7933,7869,
KOT RADHA KISHAN,KASUR,TEHSIL,UNDER 10,122475,61612,60863,,94991,47730,47261,,27484,13882,13602,
KOT RADHA KISHAN,KASUR,TEHSIL,UNDER 15,172622,86765,85856,1,133770,67180,66589,1,38852,19585,19267,
KOT RADHA KISHAN,KASUR,TEHSIL,05 - 24,185993,94241,91746,6,143947,73086,70858,3,42046,21155,20888,3
KOT RADHA KISHAN,KASUR,TEHSIL,15 - 49,205802,106546,99240,16,154620,80613,74000,7,51182,25933,25240,9
KOT RADHA KISHAN,KASUR,TEHSIL,15 - 64,238905,124284,114604,17,179097,93706,85384,7,59808,30578,29220,10
KOT RADHA KISHAN,KASUR,TEHSIL,18 - 60,204612,106801,97796,15,152827,80392,72429,6,51785,26409,25367,9
KOT RADHA KISHAN,KASUR,TEHSIL,18 &  ABOVE,224646,117919,106712,15,167698,88631,79061,6,56948,29288,27651,9
KOT RADHA KISHAN,KASUR,TEHSIL,60 &  ABOVE,22210,12249,9961,,16501,9089,7412,,5709,3160,2549,
KOT RADHA KISHAN,KASUR,TEHSIL,65 &  ABOVE,13348,7449,5899,,9951,5553,4398,,3397,1896,1501,
PATTOKI,KASUR,TEHSIL,ALL AGES,1076007,549840,526046,121,847742,434447,413229,66,228265,115393,112817,55
PATTOKI,KASUR,TEHSIL,UNDER 1,22803,11317,11486,,18007,8969,9038,,4796,2348,2448,
PATTOKI,KASUR,TEHSIL,UNDER 5,154665,76718,77947,,123489,61604,61885,,31176,15114,16062,
PATTOKI,KASUR,TEHSIL,UNDER 10,289040,144160,144880,,231310,115803,115507,,57730,28357,29373,
PATTOKI,KASUR,TEHSIL,UNDER 15,417380,208792,208574,14,332741,166909,165827,5,84639,41883,42747,9
PATTOKI,KASUR,TEHSIL,05 - 24,467833,236317,231452,64,371013,187948,183038,27,96820,48369,48414,37
PATTOKI,KASUR,TEHSIL,15 - 49,533726,273369,260260,97,416890,214316,202519,55,116836,59053,57741,42
PATTOKI,KASUR,TEHSIL,15 - 64,621943,320809,301031,103,485766,251399,234310,57,136177,69410,66721,46
PATTOKI,KASUR,TEHSIL,18 - 60,536573,276983,259505,85,418290,216687,201556,47,118283,60296,57949,38
PATTOKI,KASUR,TEHSIL,18 &  ABOVE,590254,306529,283636,89,460857,240123,220683,51,129397,66406,62953,38
PATTOKI,KASUR,TEHSIL,60 &  ABOVE,59448,32657,26786,5,47122,25908,21210,4,12326,6749,5576,1
PATTOKI,KASUR,TEHSIL,65 &  ABOVE,36684,20239,16441,4,29235,16139,13092,4,7449,4100,3349,
KHANEWAL,KHANEWAL,DISTRICT,ALL AGES,3363589,1734421,1628782,386,2646990,1367101,1279743,146,716599,367320,349039,240
KHANEWAL,KHANEWAL,DISTRICT,UNDER 1,79144,41465,37679,,64169,33555,30614,,14975,7910,7065,
KHANEWAL,KHANEWAL,DISTRICT,UNDER 5,474879,247050,227829,,384489,200265,184224,,90390,46785,43605,
KHANEWAL,KHANEWAL,DISTRICT,UNDER 10,907441,470685,436756,,732862,380750,352112,,174579,89935,84644,
KHANEWAL,KHANEWAL,DISTRICT,UNDER 15,1305910,680244,625656,10,1047596,546686,500901,9,258314,133558,124755,1
KHANEWAL,KHANEWAL,DISTRICT,05 - 24,1445937,749911,695897,129,1142672,594133,548489,50,303265,155778,147408,79
KHANEWAL,KHANEWAL,DISTRICT,15 - 49,1635975,831159,804477,339,1269861,646464,623280,117,366114,184695,181197,222
KHANEWAL,KHANEWAL,DISTRICT,15 - 64,1928354,985058,942928,368,1495870,765060,730676,134,432484,219998,212252,234
KHANEWAL,KHANEWAL,DISTRICT,18 - 60,1664231,845468,818427,336,1289631,656051,633462,118,374600,189417,184965,218
KHANEWAL,KHANEWAL,DISTRICT,18 &  ABOVE,1852918,946381,906190,347,1439436,736034,703279,123,413482,210347,202911,224
KHANEWAL,KHANEWAL,DISTRICT,60 &  ABOVE,206230,110076,96140,14,163599,87202,76390,7,42631,22874,19750,7
KHANEWAL,KHANEWAL,DISTRICT,65 &  ABOVE,129325,69119,60198,8,103524,55355,48166,3,25801,13764,12032,5
JAHANIAN,KHANEWAL,TEHSIL,ALL AGES,384758,195971,188756,31,334488,170420,164049,19,50270,25551,24707,12
JAHANIAN,KHANEWAL,TEHSIL,UNDER 1,9576,4987,4589,,8524,4395,4129,,1052,592,460,
JAHANIAN,KHANEWAL,TEHSIL,UNDER 5,52159,26922,25237,,46279,23821,22458,,5880,3101,2779,
JAHANIAN,KHANEWAL,TEHSIL,UNDER 10,100060,51367,48693,,88270,45229,43041,,11790,6138,5652,
JAHANIAN,KHANEWAL,TEHSIL,UNDER 15,145158,74807,70351,,127435,65586,61849,,17723,9221,8502,
JAHANIAN,KHANEWAL,TEHSIL,05 - 24,165135,84483,80643,9,143426,73399,70022,5,21709,11084,10621,4
JAHANIAN,KHANEWAL,TEHSIL,15 - 49,189814,95162,94625,27,164084,82471,81596,17,25730,12691,13029,10
JAHANIAN,KHANEWAL,TEHSIL,15 - 64,224189,113134,111025,30,193454,97790,95645,19,30735,15344,15380,11
JAHANIAN,KHANEWAL,TEHSIL,18 - 60,193385,96927,96432,26,166839,83829,82992,18,26546,13098,13440,8
JAHANIAN,KHANEWAL,TEHSIL,18 &  ABOVE,215952,108785,107139,28,186627,94161,92448,18,29325,14624,14691,10
JAHANIAN,KHANEWAL,TEHSIL,60 &  ABOVE,24376,12832,11542,2,21320,11152,10168,,3056,1680,1374,2
JAHANIAN,KHANEWAL,TEHSIL,65 &  ABOVE,15411,8030,7380,1,13599,7044,6555,,1812,986,825,1
KABIRWALA,KHANEWAL,TEHSIL,ALL AGES,1118944,582219,536548,177,938637,489729,448870,38,180307,92490,87678,139
KABIRWALA,KHANEWAL,TEHSIL,UNDER 1,25324,13480,11844,,21241,11292,9949,,4083,2188,1895,
KABIRWALA,KHANEWAL,TEHSIL,UNDER 5,169969,89030,80939,,145000,76040,68960,,24969,12990,11979,
KABIRWALA,KHANEWAL,TEHSIL,UNDER 10,320515,167281,153234,,273577,143037,130540,,46938,24244,22694,
KABIRWALA,KHANEWAL,TEHSIL,UNDER 15,455221,238695,216519,7,386807,203277,183524,6,68414,35418,32995,1
KABIRWALA,KHANEWAL,TEHSIL,05 - 24,486576,254338,232164,74,409397,214821,194560,16,77179,39517,37604,58
KABIRWALA,KHANEWAL,TEHSIL,15 - 49,528984,271680,257144,160,438943,226177,212739,27,90041,45503,44405,133
KABIRWALA,KHANEWAL,TEHSIL,15 - 64,620485,320051,300265,169,515024,266343,248650,31,105461,53708,51615,138
KABIRWALA,KHANEWAL,TEHSIL,18 - 60,534292,273863,260275,154,443111,227673,215412,26,91181,46190,44863,128
KABIRWALA,KHANEWAL,TEHSIL,18 &  ABOVE,595899,307247,288497,155,495286,256077,239182,27,100613,51170,49315,128
KABIRWALA,KHANEWAL,TEHSIL,60 &  ABOVE,67859,36608,31250,1,57475,31148,26326,1,10384,5460,4924,
KABIRWALA,KHANEWAL,TEHSIL,65 &  ABOVE,43238,23473,19764,1,36806,20109,16696,1,6432,3364,3068,
KHANEWAL,KHANEWAL,TEHSIL,ALL AGES,987408,511442,475866,100,676490,351092,325340,58,310918,160350,150526,42
KHANEWAL,KHANEWAL,TEHSIL,UNDER 1,21337,11132,10205,,15412,8036,7376,,5925,3096,2829,
KHANEWAL,KHANEWAL,TEHSIL,UNDER 5,133848,69685,64163,,95145,49716,45429,,38703,19969,18734,
KHANEWAL,KHANEWAL,TEHSIL,UNDER 10,258174,134149,124025,,182910,95416,87494,,75264,38733,36531,
KHANEWAL,KHANEWAL,TEHSIL,UNDER 15,373952,194738,179213,1,262878,137448,125429,1,111074,57290,53784,
KHANEWAL,KHANEWAL,TEHSIL,05 - 24,424967,220632,204305,30,293505,153139,140347,19,131462,67493,63958,11
KHANEWAL,KHANEWAL,TEHSIL,15 - 49,492274,252013,240170,91,331427,169973,161402,52,160847,82040,78768,39
KHANEWAL,KHANEWAL,TEHSIL,15 - 64,578341,297841,280403,97,389009,200494,188459,56,189332,97347,91944,41
KHANEWAL,KHANEWAL,TEHSIL,18 - 60,500163,256592,243483,88,335708,172409,163250,49,164455,84183,80233,39
KHANEWAL,KHANEWAL,TEHSIL,18 &  ABOVE,552187,284656,267441,90,371747,191733,179964,50,180440,92923,87477,40
KHANEWAL,KHANEWAL,TEHSIL,60 &  ABOVE,57342,30820,26519,3,39657,21196,18459,2,17685,9624,8060,1
KHANEWAL,KHANEWAL,TEHSIL,65 &  ABOVE,35115,18863,16250,2,24603,13150,11452,1,10512,5713,4798,1
MIAN CHANNU,KHANEWAL,TEHSIL,ALL AGES,872479,444789,427612,78,697375,355860,341484,31,175104,88929,86128,47
MIAN CHANNU,KHANEWAL,TEHSIL,UNDER 1,22907,11866,11041,,18992,9832,9160,,3915,2034,1881,
MIAN CHANNU,KHANEWAL,TEHSIL,UNDER 5,118903,61413,57490,,98065,50688,47377,,20838,10725,10113,
MIAN CHANNU,KHANEWAL,TEHSIL,UNDER 10,228692,117888,110804,,188105,97068,91037,,40587,20820,19767,
MIAN CHANNU,KHANEWAL,TEHSIL,UNDER 15,331579,172004,159573,2,270476,140375,130099,2,61103,31629,29474,
MIAN CHANNU,KHANEWAL,TEHSIL,05 - 24,369259,190458,178785,16,296344,152774,143560,10,72915,37684,35225,6
MIAN CHANNU,KHANEWAL,TEHSIL,15 - 49,424903,212304,212538,61,335407,167843,167543,21,89496,44461,44995,40
MIAN CHANNU,KHANEWAL,TEHSIL,15 - 64,505339,254032,251235,72,398383,200433,197922,28,106956,53599,53313,44
MIAN CHANNU,KHANEWAL,TEHSIL,18 - 60,436391,218086,218237,68,343973,172140,171808,25,92418,45946,46429,43
MIAN CHANNU,KHANEWAL,TEHSIL,18 &  ABOVE,488880,245693,243113,74,385776,194063,191685,28,103104,51630,51428,46
MIAN CHANNU,KHANEWAL,TEHSIL,60 &  ABOVE,56653,29816,26829,8,45147,23706,21437,4,11506,6110,5392,4
MIAN CHANNU,KHANEWAL,TEHSIL,65 &  ABOVE,35561,18753,16804,4,28516,15052,13463,1,7045,3701,3341,3
KHUSHAB,KHUSHAB,DISTRICT,ALL AGES,1500835,768006,732780,49,1082124,552375,529733,16,418711,215631,203047,33
KHUSHAB,KHUSHAB,DISTRICT,UNDER 1,34980,18264,16716,,25394,13158,12236,,9586,5106,4480,
KHUSHAB,KHUSHAB,DISTRICT,UNDER 5,207224,109797,97427,,147416,77322,70094,,59808,32475,27333,
KHUSHAB,KHUSHAB,DISTRICT,UNDER 10,371528,194313,177215,,266913,138536,128377,,104615,55777,48838,
KHUSHAB,KHUSHAB,DISTRICT,UNDER 15,529997,278006,251990,1,381239,198689,182549,1,148758,79317,69441,
KHUSHAB,KHUSHAB,DISTRICT,05 - 24,588472,304602,283855,15,424097,219104,204987,6,164375,85498,78868,9
KHUSHAB,KHUSHAB,DISTRICT,15 - 49,737116,367903,369168,45,528602,263824,264765,13,208514,104079,104403,32
KHUSHAB,KHUSHAB,DISTRICT,15 - 64,892577,448546,443983,48,641740,322289,319436,15,250837,126257,124547,33
KHUSHAB,KHUSHAB,DISTRICT,18 - 60,773147,385110,387991,46,555634,276620,279001,13,217513,108490,108990,33
KHUSHAB,KHUSHAB,DISTRICT,18 &  ABOVE,883693,443916,439731,46,638436,320656,317767,13,245257,123260,121964,33
KHUSHAB,KHUSHAB,DISTRICT,60 &  ABOVE,119696,63704,55991,1,89441,47577,41863,1,30255,16127,14128,
KHUSHAB,KHUSHAB,DISTRICT,65 &  ABOVE,78261,41454,36807,,59145,31397,27748,,19116,10057,9059,
KHUSHAB,KHUSHAB,TEHSIL,ALL AGES,816654,421148,395472,34,461125,237810,223309,6,355529,183338,172163,28
KHUSHAB,KHUSHAB,TEHSIL,UNDER 1,20507,10978,9529,,12106,6486,5620,,8401,4492,3909,
KHUSHAB,KHUSHAB,TEHSIL,UNDER 5,115648,62790,52858,,63371,34221,29150,,52277,28569,23708,
KHUSHAB,KHUSHAB,TEHSIL,UNDER 10,202418,107590,94828,,112553,59523,53030,,89865,48067,41798,
KHUSHAB,KHUSHAB,TEHSIL,UNDER 15,286673,151812,134861,,159798,84126,75672,,126875,67686,59189,
KHUSHAB,KHUSHAB,TEHSIL,05 - 24,317426,164404,153012,10,178889,92535,86351,3,138537,71869,66661,7
KHUSHAB,KHUSHAB,TEHSIL,15 - 49,405219,203598,201588,33,228208,115195,113007,6,177011,88403,88581,27
KHUSHAB,KHUSHAB,TEHSIL,15 - 64,489762,247910,241818,34,276859,140591,136262,6,212903,107319,105556,28
KHUSHAB,KHUSHAB,TEHSIL,18 - 60,424524,213176,211315,33,239798,120904,118889,5,184726,92272,92426,28
KHUSHAB,KHUSHAB,TEHSIL,18 &  ABOVE,482214,244141,238040,33,274460,139511,134944,5,207754,104630,103096,28
KHUSHAB,KHUSHAB,TEHSIL,60 &  ABOVE,62495,33604,28891,,37340,20090,17250,,25155,13514,11641,
KHUSHAB,KHUSHAB,TEHSIL,65 &  ABOVE,40219,21426,18793,,24468,13093,11375,,15751,8333,7418,
NOOR PUR,KHUSHAB,TEHSIL,ALL AGES,264535,133865,130665,5,244435,123677,120753,5,20100,10188,9912,
NOOR PUR,KHUSHAB,TEHSIL,UNDER 1,4552,2343,2209,,4158,2147,2011,,394,196,198,
NOOR PUR,KHUSHAB,TEHSIL,UNDER 5,31058,15989,15069,,28872,14879,13993,,2186,1110,1076,
NOOR PUR,KHUSHAB,TEHSIL,UNDER 10,61632,31730,29902,,57240,29467,27773,,4392,2263,2129,
NOOR PUR,KHUSHAB,TEHSIL,UNDER 15,91105,47233,43872,,84587,43893,40694,,6518,3340,3178,
NOOR PUR,KHUSHAB,TEHSIL,05 - 24,107126,55230,51895,1,99047,51128,47918,1,8079,4102,3977,
NOOR PUR,KHUSHAB,TEHSIL,15 - 49,130382,64188,66190,4,120053,58995,61054,4,10329,5193,5136,
NOOR PUR,KHUSHAB,TEHSIL,15 - 64,158636,78780,79851,5,146205,72515,73685,5,12431,6265,6166,
NOOR PUR,KHUSHAB,TEHSIL,18 - 60,137426,67582,69839,5,126638,62151,64482,5,10788,5431,5357,
NOOR PUR,KHUSHAB,TEHSIL,18 &  ABOVE,157971,78468,79498,5,145597,72232,73360,5,12374,6236,6138,
NOOR PUR,KHUSHAB,TEHSIL,60 &  ABOVE,22145,11716,10429,,20452,10855,9597,,1693,861,832,
NOOR PUR,KHUSHAB,TEHSIL,65 &  ABOVE,14794,7852,6942,,13643,7269,6374,,1151,583,568,
NOWSHERA,KHUSHAB,TEHSIL,ALL AGES,144797,71624,73171,2,126220,62635,63584,1,18577,8989,9587,1
NOWSHERA,KHUSHAB,TEHSIL,UNDER 1,4008,1888,2120,,3696,1740,1956,,312,148,164,
NOWSHERA,KHUSHAB,TEHSIL,UNDER 5,23909,11889,12020,,21776,10830,10946,,2133,1059,1074,
NOWSHERA,KHUSHAB,TEHSIL,UNDER 10,38734,19325,19409,,34604,17286,17318,,4130,2039,2091,
NOWSHERA,KHUSHAB,TEHSIL,UNDER 15,52668,26692,25976,,46620,23634,22986,,6048,3058,2990,
NOWSHERA,KHUSHAB,TEHSIL,05 - 24,51668,26177,25490,1,44601,22626,21974,1,7067,3551,3516,
NOWSHERA,KHUSHAB,TEHSIL,15 - 49,67144,32632,34510,2,58003,28341,29661,1,9141,4291,4849,1
NOWSHERA,KHUSHAB,TEHSIL,15 - 64,82625,40238,42385,2,71315,34896,36418,1,11310,5342,5967,1
NOWSHERA,KHUSHAB,TEHSIL,18 - 60,71511,34480,37030,1,61730,29899,31831,,9781,4581,5199,1
NOWSHERA,KHUSHAB,TEHSIL,18 &  ABOVE,84563,40977,43585,1,73070,35575,37495,,11493,5402,6090,1
NOWSHERA,KHUSHAB,TEHSIL,60 &  ABOVE,14012,6988,7024,,12176,6104,6072,,1836,884,952,
NOWSHERA,KHUSHAB,TEHSIL,65 &  ABOVE,9504,4694,4810,,8285,4105,4180,,1219,589,630,
QUAIDABAD,KHUSHAB,TEHSIL,ALL AGES,274849,141369,133472,8,250344,128253,122087,4,24505,13116,11385,4
QUAIDABAD,KHUSHAB,TEHSIL,UNDER 1,5913,3055,2858,,5434,2785,2649,,479,270,209,
QUAIDABAD,KHUSHAB,TEHSIL,UNDER 5,36609,19129,17480,,33397,17392,16005,,3212,1737,1475,
QUAIDABAD,KHUSHAB,TEHSIL,UNDER 10,68744,35668,33076,,62516,32260,30256,,6228,3408,2820,
QUAIDABAD,KHUSHAB,TEHSIL,UNDER 15,99551,52269,47281,1,90234,47036,43197,1,9317,5233,4084,
QUAIDABAD,KHUSHAB,TEHSIL,05 - 24,112252,58791,53458,3,101560,52815,48744,1,10692,5976,4714,2
QUAIDABAD,KHUSHAB,TEHSIL,15 - 49,134371,67485,66880,6,122338,61293,61043,2,12033,6192,5837,4
QUAIDABAD,KHUSHAB,TEHSIL,15 - 64,161554,81618,79929,7,147361,74287,73071,3,14193,7331,6858,4
QUAIDABAD,KHUSHAB,TEHSIL,18 - 60,139686,69872,69807,7,127468,63666,63799,3,12218,6206,6008,4
QUAIDABAD,KHUSHAB,TEHSIL,18 &  ABOVE,158945,80330,78608,7,145309,73338,71968,3,13636,6992,6640,4
QUAIDABAD,KHUSHAB,TEHSIL,60 &  ABOVE,21044,11396,9647,1,19473,10528,8944,1,1571,868,703,
QUAIDABAD,KHUSHAB,TEHSIL,65 &  ABOVE,13744,7482,6262,,12749,6930,5819,,995,552,443,
LAHORE,LAHORE,DISTRICT,ALL AGES,12978661,6869574,6105711,3376,,,,,12978661,6869574,6105711,3376
LAHORE,LAHORE,DISTRICT,UNDER 1,253672,130775,122897,,,,,,253672,130775,122897,
LAHORE,LAHORE,DISTRICT,UNDER 5,1827636,949192,878444,,,,,,1827636,949192,878444,
LAHORE,LAHORE,DISTRICT,UNDER 10,3231990,1670348,1561642,,,,,,3231990,1670348,1561642,
LAHORE,LAHORE,DISTRICT,UNDER 15,4650433,2418492,2231847,94,,,,,4650433,2418492,2231847,94
LAHORE,LAHORE,DISTRICT,05 - 24,5260826,2763622,2496287,917,,,,,5260826,2763622,2496287,917
LAHORE,LAHORE,DISTRICT,15 - 49,6747489,3565859,3178604,3026,,,,,6747489,3565859,3178604,3026
LAHORE,LAHORE,DISTRICT,15 - 64,7877902,4188041,3686617,3244,,,,,7877902,4188041,3686617,3244
LAHORE,LAHORE,DISTRICT,18 - 60,6895145,3656718,3235342,3085,,,,,6895145,3656718,3235342,3085
LAHORE,LAHORE,DISTRICT,18 &  ABOVE,7565042,4044255,3517650,3137,,,,,7565042,4044255,3517650,3137
LAHORE,LAHORE,DISTRICT,60 &  ABOVE,750722,431599,319050,73,,,,,750722,431599,319050,73
LAHORE,LAHORE,DISTRICT,65 &  ABOVE,450326,263041,187247,38,,,,,450326,263041,187247,38
LAHORE CANTT,LAHORE,TEHSIL,ALL AGES,1860427,993827,866314,286,,,,,1860427,993827,866314,286
LAHORE CANTT,LAHORE,TEHSIL,UNDER 1,32297,16903,15394,,,,,,32297,16903,15394,
LAHORE CANTT,LAHORE,TEHSIL,UNDER 5,239991,127260,112731,,,,,,239991,127260,112731,
LAHORE CANTT,LAHORE,TEHSIL,UNDER 10,436398,228964,207434,,,,,,436398,228964,207434,
LAHORE CANTT,LAHORE,TEHSIL,UNDER 15,635529,334391,301131,7,,,,,635529,334391,301131,7
LAHORE CANTT,LAHORE,TEHSIL,05 - 24,743123,391986,351054,83,,,,,743123,391986,351054,83
LAHORE CANTT,LAHORE,TEHSIL,15 - 49,981844,523957,457637,250,,,,,981844,523957,457637,250
LAHORE CANTT,LAHORE,TEHSIL,15 - 64,1150779,616473,534034,272,,,,,1150779,616473,534034,272
LAHORE CANTT,LAHORE,TEHSIL,18 - 60,1007716,539449,468013,254,,,,,1007716,539449,468013,254
LAHORE CANTT,LAHORE,TEHSIL,18 &  ABOVE,1115842,601512,514065,265,,,,,1115842,601512,514065,265
LAHORE CANTT,LAHORE,TEHSIL,60 &  ABOVE,119865,68420,51433,12,,,,,119865,68420,51433,12
LAHORE CANTT,LAHORE,TEHSIL,65 &  ABOVE,74119,42963,31149,7,,,,,74119,42963,31149,7
LAHORE CITY,LAHORE,TEHSIL,ALL AGES,4123354,2203776,1917723,1855,,,,,4123354,2203776,1917723,1855
LAHORE CITY,LAHORE,TEHSIL,UNDER 1,80483,41783,38700,,,,,,80483,41783,38700,
LAHORE CITY,LAHORE,TEHSIL,UNDER 5,591520,312552,278968,,,,,,591520,312552,278968,
LAHORE CITY,LAHORE,TEHSIL,UNDER 10,1028029,538352,489677,,,,,,1028029,538352,489677,
LAHORE CITY,LAHORE,TEHSIL,UNDER 15,1476035,777455,698524,56,,,,,1476035,777455,698524,56
LAHORE CITY,LAHORE,TEHSIL,05 - 24,1650781,877492,772793,496,,,,,1650781,877492,772793,496
LAHORE CITY,LAHORE,TEHSIL,15 - 49,2142524,1141298,999545,1681,,,,,2142524,1141298,999545,1681
LAHORE CITY,LAHORE,TEHSIL,15 - 64,2506551,1343603,1161164,1784,,,,,2506551,1343603,1161164,1784
LAHORE CITY,LAHORE,TEHSIL,18 - 60,2197895,1173807,1022403,1685,,,,,2197895,1173807,1022403,1685
LAHORE CITY,LAHORE,TEHSIL,18 &  ABOVE,2408283,1296466,1110112,1705,,,,,2408283,1296466,1110112,1705
LAHORE CITY,LAHORE,TEHSIL,60 &  ABOVE,237005,137224,99746,35,,,,,237005,137224,99746,35
LAHORE CITY,LAHORE,TEHSIL,65 &  ABOVE,140768,82718,58035,15,,,,,140768,82718,58035,15
MODEL TOWN,LAHORE,TEHSIL,ALL AGES,3244906,1687860,1556362,684,,,,,3244906,1687860,1556362,684
MODEL TOWN,LAHORE,TEHSIL,UNDER 1,64783,32303,32480,,,,,,64783,32303,32480,
MODEL TOWN,LAHORE,TEHSIL,UNDER 5,476294,236390,239904,,,,,,476294,236390,239904,
MODEL TOWN,LAHORE,TEHSIL,UNDER 10,828335,412730,415605,,,,,,828335,412730,415605,
MODEL TOWN,LAHORE,TEHSIL,UNDER 15,1178931,592205,586712,14,,,,,1178931,592205,586712,14
MODEL TOWN,LAHORE,TEHSIL,05 - 24,1320291,677147,642954,190,,,,,1320291,677147,642954,190
MODEL TOWN,LAHORE,TEHSIL,15 - 49,1685595,883981,801009,605,,,,,1685595,883981,801009,605
MODEL TOWN,LAHORE,TEHSIL,15 - 64,1955111,1031486,922964,661,,,,,1955111,1031486,922964,661
MODEL TOWN,LAHORE,TEHSIL,18 - 60,1711567,903555,807378,634,,,,,1711567,903555,807378,634
MODEL TOWN,LAHORE,TEHSIL,18 &  ABOVE,1874709,996788,877273,648,,,,,1874709,996788,877273,648
MODEL TOWN,LAHORE,TEHSIL,60 &  ABOVE,182230,103683,78530,17,,,,,182230,103683,78530,17
MODEL TOWN,LAHORE,TEHSIL,65 &  ABOVE,110864,64169,46686,9,,,,,110864,64169,46686,9
RAIWIND,LAHORE,TEHSIL,ALL AGES,1080637,581873,498419,345,,,,,1080637,581873,498419,345
RAIWIND,LAHORE,TEHSIL,UNDER 1,21283,11239,10044,,,,,,21283,11239,10044,
RAIWIND,LAHORE,TEHSIL,UNDER 5,150134,79596,70538,,,,,,150134,79596,70538,
RAIWIND,LAHORE,TEHSIL,UNDER 10,275635,145278,130357,,,,,,275635,145278,130357,
RAIWIND,LAHORE,TEHSIL,UNDER 15,401251,213888,187354,9,,,,,401251,213888,187354,9
RAIWIND,LAHORE,TEHSIL,05 - 24,464354,249847,214404,103,,,,,464354,249847,214404,103
RAIWIND,LAHORE,TEHSIL,15 - 49,555429,298452,256657,320,,,,,555429,298452,256657,320
RAIWIND,LAHORE,TEHSIL,15 - 64,644393,347370,296691,332,,,,,644393,347370,296691,332
RAIWIND,LAHORE,TEHSIL,18 - 60,558489,300053,258114,322,,,,,558489,300053,258114,322
RAIWIND,LAHORE,TEHSIL,18 &  ABOVE,611004,330582,280096,326,,,,,611004,330582,280096,326
RAIWIND,LAHORE,TEHSIL,60 &  ABOVE,58816,33929,24882,5,,,,,58816,33929,24882,5
RAIWIND,LAHORE,TEHSIL,65 &  ABOVE,34993,20615,14374,4,,,,,34993,20615,14374,4
SHALIMAR,LAHORE,TEHSIL,ALL AGES,2669337,1402238,1266893,206,,,,,2669337,1402238,1266893,206
SHALIMAR,LAHORE,TEHSIL,UNDER 1,54826,28547,26279,,,,,,54826,28547,26279,
SHALIMAR,LAHORE,TEHSIL,UNDER 5,369697,193394,176303,,,,,,369697,193394,176303,
SHALIMAR,LAHORE,TEHSIL,UNDER 10,663593,345024,318569,,,,,,663593,345024,318569,
SHALIMAR,LAHORE,TEHSIL,UNDER 15,958687,500553,458126,8,,,,,958687,500553,458126,8
SHALIMAR,LAHORE,TEHSIL,05 - 24,1082277,567150,515082,45,,,,,1082277,567150,515082,45
SHALIMAR,LAHORE,TEHSIL,15 - 49,1382097,718171,663756,170,,,,,1382097,718171,663756,170
SHALIMAR,LAHORE,TEHSIL,15 - 64,1621068,849109,771764,195,,,,,1621068,849109,771764,195
SHALIMAR,LAHORE,TEHSIL,18 - 60,1419478,739854,679434,190,,,,,1419478,739854,679434,190
SHALIMAR,LAHORE,TEHSIL,18 &  ABOVE,1555204,818907,736104,193,,,,,1555204,818907,736104,193
SHALIMAR,LAHORE,TEHSIL,60 &  ABOVE,152806,88343,64459,4,,,,,152806,88343,64459,4
SHALIMAR,LAHORE,TEHSIL,65 &  ABOVE,89582,52576,37003,3,,,,,89582,52576,37003,3
LAYYAH,LAYYAH,DISTRICT,ALL AGES,2102361,1082910,1019362,89,1716092,885141,830916,35,386269,197769,188446,54
LAYYAH,LAYYAH,DISTRICT,UNDER 1,65263,33947,31316,,55403,28705,26698,,9860,5242,4618,
LAYYAH,LAYYAH,DISTRICT,UNDER 5,330842,172282,158560,,278114,144834,133280,,52728,27448,25280,
LAYYAH,LAYYAH,DISTRICT,UNDER 10,604722,312080,292642,,506160,261366,244794,,98562,50714,47848,
LAYYAH,LAYYAH,DISTRICT,UNDER 15,859487,444481,415006,,716349,370527,345822,,143138,73954,69184,
LAYYAH,LAYYAH,DISTRICT,05 - 24,915687,471625,444043,19,753973,388899,365068,6,161714,82726,78975,13
LAYYAH,LAYYAH,DISTRICT,15 - 49,996485,505954,490453,78,803516,409123,394362,31,192969,96831,96091,47
LAYYAH,LAYYAH,DISTRICT,15 - 64,1169011,598576,570347,88,940114,482428,457651,35,228897,116148,112696,53
LAYYAH,LAYYAH,DISTRICT,18 - 60,1004939,511625,493230,84,806578,411631,394914,33,198361,99994,98316,51
LAYYAH,LAYYAH,DISTRICT,18 &  ABOVE,1111457,569543,541828,86,891813,457966,433813,34,219644,111577,108015,52
LAYYAH,LAYYAH,DISTRICT,60 &  ABOVE,115627,62940,52684,3,92408,50339,42068,1,23219,12601,10616,2
LAYYAH,LAYYAH,DISTRICT,65 &  ABOVE,73863,39853,34009,1,59629,32186,27443,,14234,7667,6566,1
CHOUBARA,LAYYAH,TEHSIL,ALL AGES,299069,156256,142809,4,242080,126588,115491,1,56989,29668,27318,3
CHOUBARA,LAYYAH,TEHSIL,UNDER 1,11489,6422,5067,,9909,5549,4360,,1580,873,707,
CHOUBARA,LAYYAH,TEHSIL,UNDER 5,54677,29683,24994,,45348,24623,20725,,9329,5060,4269,
CHOUBARA,LAYYAH,TEHSIL,UNDER 10,94091,49978,44113,,77330,41086,36244,,16761,8892,7869,
CHOUBARA,LAYYAH,TEHSIL,UNDER 15,129619,68522,61097,,106025,56076,49949,,23594,12446,11148,
CHOUBARA,LAYYAH,TEHSIL,05 - 24,126833,65867,60964,2,102344,53196,49147,1,24489,12671,11817,1
CHOUBARA,LAYYAH,TEHSIL,15 - 49,134987,69007,65976,4,108171,55360,52810,1,26816,13647,13166,3
CHOUBARA,LAYYAH,TEHSIL,15 - 64,158364,81544,76816,4,127076,65504,61571,1,31288,16040,15245,3
CHOUBARA,LAYYAH,TEHSIL,18 - 60,136480,69932,66546,2,109475,56164,53311,,27005,13768,13235,2
CHOUBARA,LAYYAH,TEHSIL,18 &  ABOVE,152171,78636,73533,2,122177,63190,58987,,29994,15446,14546,2
CHOUBARA,LAYYAH,TEHSIL,60 &  ABOVE,17041,9460,7581,,13759,7624,6135,,3282,1836,1446,
CHOUBARA,LAYYAH,TEHSIL,65 &  ABOVE,11086,6190,4896,,8979,5008,3971,,2107,1182,925,
KAROR LAL ESAN,LAYYAH,TEHSIL,ALL AGES,684717,352111,332567,39,594087,306100,287983,4,90630,46011,44584,35
KAROR LAL ESAN,LAYYAH,TEHSIL,UNDER 1,20256,10668,9588,,18070,9494,8576,,2186,1174,1012,
KAROR LAL ESAN,LAYYAH,TEHSIL,UNDER 5,105547,55067,50480,,93399,48778,44621,,12148,6289,5859,
KAROR LAL ESAN,LAYYAH,TEHSIL,UNDER 10,193537,99831,93706,,170814,88122,82692,,22723,11709,11014,
KAROR LAL ESAN,LAYYAH,TEHSIL,UNDER 15,275630,142485,133145,,242427,125380,117047,,33203,17105,16098,
KAROR LAL ESAN,LAYYAH,TEHSIL,05 - 24,297158,152527,144622,9,259121,133154,125966,1,38037,19373,18656,8
KAROR LAL ESAN,LAYYAH,TEHSIL,15 - 49,326612,165032,161544,36,280910,142392,138514,4,45702,22640,23030,32
KAROR LAL ESAN,LAYYAH,TEHSIL,15 - 64,384573,196354,188180,39,330324,169141,161179,4,54249,27213,27001,35
KAROR LAL ESAN,LAYYAH,TEHSIL,18 - 60,330901,168141,162721,39,284053,144785,139264,4,46848,23356,23457,35
KAROR LAL ESAN,LAYYAH,TEHSIL,18 &  ABOVE,366253,187435,178779,39,314478,161437,153037,4,51775,25998,25742,35
KAROR LAL ESAN,LAYYAH,TEHSIL,60 &  ABOVE,38210,20920,17290,,32874,18051,14823,,5336,2869,2467,
KAROR LAL ESAN,LAYYAH,TEHSIL,65 &  ABOVE,24514,13272,11242,,21336,11579,9757,,3178,1693,1485,
LAYYAH,LAYYAH,TEHSIL,ALL AGES,1118575,574543,543986,46,879925,452453,427442,30,238650,122090,116544,16
LAYYAH,LAYYAH,TEHSIL,UNDER 1,33518,16857,16661,,27424,13662,13762,,6094,3195,2899,
LAYYAH,LAYYAH,TEHSIL,UNDER 5,170618,87532,83086,,139367,71433,67934,,31251,16099,15152,
LAYYAH,LAYYAH,TEHSIL,UNDER 10,317094,162271,154823,,258016,132158,125858,,59078,30113,28965,
LAYYAH,LAYYAH,TEHSIL,UNDER 15,454238,233474,220764,,367897,189071,178826,,86341,44403,41938,
LAYYAH,LAYYAH,TEHSIL,05 - 24,491696,253231,238457,8,392508,202549,189955,4,99188,50682,48502,4
LAYYAH,LAYYAH,TEHSIL,15 - 49,534886,271915,262933,38,414435,211371,203038,26,120451,60544,59895,12
LAYYAH,LAYYAH,TEHSIL,15 - 64,626074,320678,305351,45,482714,247783,234901,30,143360,72895,70450,15
LAYYAH,LAYYAH,TEHSIL,18 - 60,537558,273552,263963,43,413050,210682,202339,29,124508,62870,61624,14
LAYYAH,LAYYAH,TEHSIL,18 &  ABOVE,593033,303472,289516,45,455158,233339,221789,30,137875,70133,67727,15
LAYYAH,LAYYAH,TEHSIL,60 &  ABOVE,60376,32560,27813,3,45775,24664,21110,1,14601,7896,6703,2
LAYYAH,LAYYAH,TEHSIL,65 &  ABOVE,38263,20391,17871,1,29314,15599,13715,,8949,4792,4156,1
LODHRAN,LODHRAN,DISTRICT,ALL AGES,1926357,996914,929326,117,1603155,830759,772347,49,323202,166155,156979,68
LODHRAN,LODHRAN,DISTRICT,UNDER 1,46210,24204,22006,,39054,20468,18586,,7156,3736,3420,
LODHRAN,LODHRAN,DISTRICT,UNDER 5,278877,145300,133577,,236508,123447,113061,,42369,21853,20516,
LODHRAN,LODHRAN,DISTRICT,UNDER 10,540664,280950,259714,,457467,238263,219204,,83197,42687,40510,
LODHRAN,LODHRAN,DISTRICT,UNDER 15,776354,406078,370274,2,653911,342669,311242,,122443,63409,59032,2
LODHRAN,LODHRAN,DISTRICT,05 - 24,851179,444558,406598,23,709123,371196,337920,7,142056,73362,68678,16
LODHRAN,LODHRAN,DISTRICT,15 - 49,921451,470947,450408,96,758495,388204,370251,40,162956,82743,80157,56
LODHRAN,LODHRAN,DISTRICT,15 - 64,1080129,554154,525862,113,890096,456878,433171,47,190033,97276,92691,66
LODHRAN,LODHRAN,DISTRICT,18 - 60,932869,476223,456539,107,768200,392321,375836,43,164669,83902,80703,64
LODHRAN,LODHRAN,DISTRICT,18 &  ABOVE,1032750,528679,503959,112,852417,436642,415728,47,180333,92037,88231,65
LODHRAN,LODHRAN,DISTRICT,60 &  ABOVE,109217,57312,51898,7,91938,48304,43628,6,17279,9008,8270,1
LODHRAN,LODHRAN,DISTRICT,65 &  ABOVE,69874,36682,33190,2,59148,31212,27934,2,10726,5470,5256,
DUNYAPUR,LODHRAN,TEHSIL,ALL AGES,571328,294328,276973,27,519440,267772,251657,11,51888,26556,25316,16
DUNYAPUR,LODHRAN,TEHSIL,UNDER 1,15518,8085,7433,,14278,7431,6847,,1240,654,586,
DUNYAPUR,LODHRAN,TEHSIL,UNDER 5,83416,43667,39749,,76666,40178,36488,,6750,3489,3261,
DUNYAPUR,LODHRAN,TEHSIL,UNDER 10,156553,81597,74956,,143491,74854,68637,,13062,6743,6319,
DUNYAPUR,LODHRAN,TEHSIL,UNDER 15,223971,117274,106697,,204681,107251,97430,,19290,10023,9267,
DUNYAPUR,LODHRAN,TEHSIL,05 - 24,244305,127161,117139,5,221906,115589,106315,2,22399,11572,10824,3
DUNYAPUR,LODHRAN,TEHSIL,15 - 49,275142,139319,135801,22,248834,126068,122758,8,26308,13251,13043,14
DUNYAPUR,LODHRAN,TEHSIL,15 - 64,324742,165257,159458,27,294010,149641,144358,11,30732,15616,15100,16
DUNYAPUR,LODHRAN,TEHSIL,18 - 60,280636,141908,138704,24,254046,128474,125563,9,26590,13434,13141,15
DUNYAPUR,LODHRAN,TEHSIL,18 &  ABOVE,313016,158869,154120,27,283741,144075,139655,11,29275,14794,14465,16
DUNYAPUR,LODHRAN,TEHSIL,60 &  ABOVE,35032,18330,16699,3,32085,16830,15253,2,2947,1500,1446,1
DUNYAPUR,LODHRAN,TEHSIL,65 &  ABOVE,22615,11797,10818,,20749,10880,9869,,1866,917,949,
KAHROR PACCA,LODHRAN,TEHSIL,ALL AGES,546058,283615,262417,26,419104,218252,200847,5,126954,65363,61570,21
KAHROR PACCA,LODHRAN,TEHSIL,UNDER 1,10975,5717,5258,,8392,4377,4015,,2583,1340,1243,
KAHROR PACCA,LODHRAN,TEHSIL,UNDER 5,72623,37801,34822,,56487,29457,27030,,16136,8344,7792,
KAHROR PACCA,LODHRAN,TEHSIL,UNDER 10,146806,76365,70441,,114468,59752,54716,,32338,16613,15725,
KAHROR PACCA,LODHRAN,TEHSIL,UNDER 15,213499,111849,101649,1,166163,87251,78912,,47336,24598,22737,1
KAHROR PACCA,LODHRAN,TEHSIL,05 - 24,239725,125470,114252,3,184858,97156,87701,1,54867,28314,26551,2
KAHROR PACCA,LODHRAN,TEHSIL,15 - 49,264188,135952,128219,17,200346,103417,96925,4,63842,32535,31294,13
KAHROR PACCA,LODHRAN,TEHSIL,15 - 64,311066,160548,150493,25,236068,122059,114004,5,74998,38489,36489,20
KAHROR PACCA,LODHRAN,TEHSIL,18 - 60,269766,138754,130988,24,204414,105308,99102,4,65352,33446,31886,20
KAHROR PACCA,LODHRAN,TEHSIL,18 &  ABOVE,300055,154602,145429,24,228017,117784,110229,4,72038,36818,35200,20
KAHROR PACCA,LODHRAN,TEHSIL,60 &  ABOVE,32953,17253,15700,,25617,13532,12085,,7336,3721,3615,
KAHROR PACCA,LODHRAN,TEHSIL,65 &  ABOVE,21493,11218,10275,,16873,8942,7931,,4620,2276,2344,
LODHRAN,LODHRAN,TEHSIL,ALL AGES,808971,418971,389936,64,664611,344735,319843,33,144360,74236,70093,31
LODHRAN,LODHRAN,TEHSIL,UNDER 1,19717,10402,9315,,16384,8660,7724,,3333,1742,1591,
LODHRAN,LODHRAN,TEHSIL,UNDER 5,122838,63832,59006,,103355,53812,49543,,19483,10020,9463,
LODHRAN,LODHRAN,TEHSIL,UNDER 10,237305,122988,114317,,199508,103657,95851,,37797,19331,18466,
LODHRAN,LODHRAN,TEHSIL,UNDER 15,338884,176955,161928,1,283067,148167,134900,,55817,28788,27028,1
LODHRAN,LODHRAN,TEHSIL,05 - 24,367149,191927,175207,15,302359,158451,143904,4,64790,33476,31303,11
LODHRAN,LODHRAN,TEHSIL,15 - 49,382121,195676,186388,57,309315,158719,150568,28,72806,36957,35820,29
LODHRAN,LODHRAN,TEHSIL,15 - 64,444321,228349,215911,61,360018,185178,174809,31,84303,43171,41102,30
LODHRAN,LODHRAN,TEHSIL,18 - 60,382467,195561,186847,59,309740,158539,151171,30,72727,37022,35676,29
LODHRAN,LODHRAN,TEHSIL,18 &  ABOVE,419679,215208,204410,61,340659,174783,165844,32,79020,40425,38566,29
LODHRAN,LODHRAN,TEHSIL,60 &  ABOVE,41232,21729,19499,4,34236,17942,16290,4,6996,3787,3209,
LODHRAN,LODHRAN,TEHSIL,65 &  ABOVE,25766,13667,12097,2,21526,11390,10134,2,4240,2277,1963,
MANDI BAHAUDDIN,MANDI BAHAUDDIN,DISTRICT,ALL AGES,1829152,916966,912047,139,1483259,743128,740049,82,345893,173838,171998,57
MANDI BAHAUDDIN,MANDI BAHAUDDIN,DISTRICT,UNDER 1,42430,22204,20226,,34691,18180,16511,,7739,4024,3715,
MANDI BAHAUDDIN,MANDI BAHAUDDIN,DISTRICT,UNDER 5,249176,129108,120068,,202685,105060,97625,,46491,24048,22443,
MANDI BAHAUDDIN,MANDI BAHAUDDIN,DISTRICT,UNDER 10,457547,235359,222188,,371647,191171,180476,,85900,44188,41712,
MANDI BAHAUDDIN,MANDI BAHAUDDIN,DISTRICT,UNDER 15,662274,342424,319848,2,537306,277763,259541,2,124968,64661,60307,
MANDI BAHAUDDIN,MANDI BAHAUDDIN,DISTRICT,05 - 24,743180,376497,366638,45,601859,304525,297301,33,141321,71972,69337,12
MANDI BAHAUDDIN,MANDI BAHAUDDIN,DISTRICT,15 - 49,887128,423126,463883,119,714048,339401,374577,70,173080,83725,89306,49
MANDI BAHAUDDIN,MANDI BAHAUDDIN,DISTRICT,15 - 64,1071555,520879,550542,134,864748,419486,445184,78,206807,101393,105358,56
MANDI BAHAUDDIN,MANDI BAHAUDDIN,DISTRICT,18 - 60,925110,444513,480471,126,745941,357531,388338,72,179169,86982,92133,54
MANDI BAHAUDDIN,MANDI BAHAUDDIN,DISTRICT,18 &  ABOVE,1058341,519015,539195,131,858151,420440,437636,75,200190,98575,101559,56
MANDI BAHAUDDIN,MANDI BAHAUDDIN,DISTRICT,60 &  ABOVE,144913,80797,64110,6,121902,68161,53738,3,23011,12636,10372,3
MANDI BAHAUDDIN,MANDI BAHAUDDIN,DISTRICT,65 &  ABOVE,95323,53663,41657,3,81205,45879,35324,2,14118,7784,6333,1
MALAKWAL,MANDI BAHAUDDIN,TEHSIL,ALL AGES,429189,215489,213641,59,377909,190077,187789,43,51280,25412,25852,16
MALAKWAL,MANDI BAHAUDDIN,TEHSIL,UNDER 1,9458,4909,4549,,8364,4355,4009,,1094,554,540,
MALAKWAL,MANDI BAHAUDDIN,TEHSIL,UNDER 5,54135,27863,26272,,48239,24783,23456,,5896,3080,2816,
MALAKWAL,MANDI BAHAUDDIN,TEHSIL,UNDER 10,102032,52058,49974,,90449,46119,44330,,11583,5939,5644,
MALAKWAL,MANDI BAHAUDDIN,TEHSIL,UNDER 15,149084,76576,72507,1,131834,67696,64137,1,17250,8880,8370,
MALAKWAL,MANDI BAHAUDDIN,TEHSIL,05 - 24,172720,87095,85607,18,152242,76807,75420,15,20478,10288,10187,3
MALAKWAL,MANDI BAHAUDDIN,TEHSIL,15 - 49,211316,101732,109533,51,185363,89380,95944,39,25953,12352,13589,12
MALAKWAL,MANDI BAHAUDDIN,TEHSIL,15 - 64,256768,125958,130752,58,225221,110735,114444,42,31547,15223,16308,16
MALAKWAL,MANDI BAHAUDDIN,TEHSIL,18 - 60,221791,107754,113981,56,194514,94777,99697,40,27277,12977,14284,16
MALAKWAL,MANDI BAHAUDDIN,TEHSIL,18 &  ABOVE,254620,126021,128542,57,223636,111062,112533,41,30984,14959,16009,16
MALAKWAL,MANDI BAHAUDDIN,TEHSIL,60 &  ABOVE,35657,19767,15888,2,31641,17635,14005,1,4016,2132,1883,1
MALAKWAL,MANDI BAHAUDDIN,TEHSIL,65 &  ABOVE,23337,12955,10382,,20854,11646,9208,,2483,1309,1174,
MANDI BAHAUDDIN,MANDI BAHAUDDIN,TEHSIL,ALL AGES,764327,382904,381373,50,532167,265639,266515,13,232160,117265,114858,37
MANDI BAHAUDDIN,MANDI BAHAUDDIN,TEHSIL,UNDER 1,18058,9414,8644,,12678,6626,6052,,5380,2788,2592,
MANDI BAHAUDDIN,MANDI BAHAUDDIN,TEHSIL,UNDER 5,108132,56114,52018,,75625,39339,36286,,32507,16775,15732,
MANDI BAHAUDDIN,MANDI BAHAUDDIN,TEHSIL,UNDER 10,194773,100327,94446,,135788,70032,65756,,58985,30295,28690,
MANDI BAHAUDDIN,MANDI BAHAUDDIN,TEHSIL,UNDER 15,281128,145518,135609,1,195897,101476,94420,1,85231,44042,41189,
MANDI BAHAUDDIN,MANDI BAHAUDDIN,TEHSIL,05 - 24,311669,158045,153608,16,216843,109687,107149,7,94826,48358,46459,9
MANDI BAHAUDDIN,MANDI BAHAUDDIN,TEHSIL,15 - 49,370344,176388,193913,43,254333,119717,134606,10,116011,56671,59307,33
MANDI BAHAUDDIN,MANDI BAHAUDDIN,TEHSIL,15 - 64,445217,215816,229354,47,307267,147617,159639,11,137950,68199,69715,36
MANDI BAHAUDDIN,MANDI BAHAUDDIN,TEHSIL,18 - 60,383748,183897,199807,44,264006,125104,138892,10,119742,58793,60915,34
MANDI BAHAUDDIN,MANDI BAHAUDDIN,TEHSIL,18 &  ABOVE,437080,213854,223179,47,303945,147624,156310,11,133135,66230,66869,36
MANDI BAHAUDDIN,MANDI BAHAUDDIN,TEHSIL,60 &  ABOVE,58453,32687,25763,3,43737,24547,19189,1,14716,8140,6574,2
MANDI BAHAUDDIN,MANDI BAHAUDDIN,TEHSIL,65 &  ABOVE,37982,21570,16410,2,29003,16546,12456,1,8979,5024,3954,1
PHALIA,MANDI BAHAUDDIN,TEHSIL,ALL AGES,635636,318573,317033,30,573183,287412,285745,26,62453,31161,31288,4
PHALIA,MANDI BAHAUDDIN,TEHSIL,UNDER 1,14914,7881,7033,,13649,7199,6450,,1265,682,583,
PHALIA,MANDI BAHAUDDIN,TEHSIL,UNDER 5,86909,45131,41778,,78821,40938,37883,,8088,4193,3895,
PHALIA,MANDI BAHAUDDIN,TEHSIL,UNDER 10,160742,82974,77768,,145410,75020,70390,,15332,7954,7378,
PHALIA,MANDI BAHAUDDIN,TEHSIL,UNDER 15,232062,120330,111732,,209575,108591,100984,,22487,11739,10748,
PHALIA,MANDI BAHAUDDIN,TEHSIL,05 - 24,258791,131357,127423,11,232774,118031,114732,11,26017,13326,12691,
PHALIA,MANDI BAHAUDDIN,TEHSIL,15 - 49,305468,145006,160437,25,274352,130304,144027,21,31116,14702,16410,4
PHALIA,MANDI BAHAUDDIN,TEHSIL,15 - 64,369570,179105,190436,29,332260,161134,171101,25,37310,17971,19335,4
PHALIA,MANDI BAHAUDDIN,TEHSIL,18 - 60,319571,152862,166683,26,287421,137650,149749,22,32150,15212,16934,4
PHALIA,MANDI BAHAUDDIN,TEHSIL,18 &  ABOVE,366641,179140,187474,27,330570,161754,168793,23,36071,17386,18681,4
PHALIA,MANDI BAHAUDDIN,TEHSIL,60 &  ABOVE,50803,28343,22459,1,46524,25979,20544,1,4279,2364,1915,
PHALIA,MANDI BAHAUDDIN,TEHSIL,65 &  ABOVE,34004,19138,14865,1,31348,17687,13660,1,2656,1451,1205,
MIANWALI,MIANWALI,DISTRICT,ALL AGES,1795897,916977,878855,65,1432505,731081,701398,26,363392,185896,177457,39
MIANWALI,MIANWALI,DISTRICT,UNDER 1,37212,19283,17929,,30779,15929,14850,,6433,3354,3079,
MIANWALI,MIANWALI,DISTRICT,UNDER 5,245779,127487,118292,,200140,103839,96301,,45639,23648,21991,
MIANWALI,MIANWALI,DISTRICT,UNDER 10,454517,234591,219926,,368984,190523,178461,,85533,44068,41465,
MIANWALI,MIANWALI,DISTRICT,UNDER 15,653637,339255,314380,2,529929,275105,254822,2,123708,64150,59558,
MIANWALI,MIANWALI,DISTRICT,05 - 24,735836,381012,354797,27,593430,307676,285739,15,142406,73336,69058,12
MIANWALI,MIANWALI,DISTRICT,15 - 49,889013,446910,442047,56,703202,353254,349927,21,185811,93656,92120,35
MIANWALI,MIANWALI,DISTRICT,15 - 64,1059899,534488,525349,62,837402,421676,415703,23,222497,112812,109646,39
MIANWALI,MIANWALI,DISTRICT,18 - 60,914626,457678,456892,56,720653,359909,360724,20,193973,97769,96168,36
MIANWALI,MIANWALI,DISTRICT,18 &  ABOVE,1032869,520047,512764,58,813997,409195,404781,21,218872,110852,107983,37
MIANWALI,MIANWALI,DISTRICT,60 &  ABOVE,128611,67607,61002,2,101596,53452,48143,1,27015,14155,12859,1
MIANWALI,MIANWALI,DISTRICT,65 &  ABOVE,82361,43234,39126,1,65174,34300,30873,1,17187,8934,8253,
ISAKHEL,MIANWALI,TEHSIL,ALL AGES,414091,206467,207613,11,319550,159565,159983,2,94541,46902,47630,9
ISAKHEL,MIANWALI,TEHSIL,UNDER 1,7721,3928,3793,,6038,3076,2962,,1683,852,831,
ISAKHEL,MIANWALI,TEHSIL,UNDER 5,55374,28492,26882,,43526,22366,21160,,11848,6126,5722,
ISAKHEL,MIANWALI,TEHSIL,UNDER 10,106826,54703,52123,,83927,42981,40946,,22899,11722,11177,
ISAKHEL,MIANWALI,TEHSIL,UNDER 15,154085,79439,74646,,121053,62476,58577,,33032,16963,16069,
ISAKHEL,MIANWALI,TEHSIL,05 - 24,175357,89845,85511,1,137510,70635,66874,1,37847,19210,18637,
ISAKHEL,MIANWALI,TEHSIL,15 - 49,201634,97445,104178,11,154850,75053,79795,2,46784,22392,24383,9
ISAKHEL,MIANWALI,TEHSIL,15 - 64,240432,116808,123613,11,183901,89468,94431,2,56531,27340,29182,9
ISAKHEL,MIANWALI,TEHSIL,18 - 60,206010,98769,107230,11,157196,75477,81717,2,48814,23292,25513,9
ISAKHEL,MIANWALI,TEHSIL,18 &  ABOVE,233807,113347,120449,11,177908,86316,91590,2,55899,27031,28859,9
ISAKHEL,MIANWALI,TEHSIL,60 &  ABOVE,30298,15861,14437,,22617,11824,10793,,7681,4037,3644,
ISAKHEL,MIANWALI,TEHSIL,65 &  ABOVE,19574,10220,9354,,14596,7621,6975,,4978,2599,2379,
MIANWALI,MIANWALI,TEHSIL,ALL AGES,906756,465038,441692,26,744174,381037,363125,12,162582,84001,78567,14
MIANWALI,MIANWALI,TEHSIL,UNDER 1,18368,9456,8912,,15798,8137,7661,,2570,1319,1251,
MIANWALI,MIANWALI,TEHSIL,UNDER 5,122313,63492,58821,,102200,53125,49075,,20113,10367,9746,
MIANWALI,MIANWALI,TEHSIL,UNDER 10,222371,114901,107470,,185439,95974,89465,,36932,18927,18005,
MIANWALI,MIANWALI,TEHSIL,UNDER 15,320303,166180,154122,1,266669,138585,128083,1,53634,27595,26039,
MIANWALI,MIANWALI,TEHSIL,05 - 24,361713,187422,174281,10,299936,155781,144147,8,61777,31641,30134,2
MIANWALI,MIANWALI,TEHSIL,15 - 49,454273,230780,223472,21,369270,187022,182240,8,85003,43758,41232,13
MIANWALI,MIANWALI,TEHSIL,15 - 64,543355,276333,266998,24,441769,223799,217960,10,101586,52534,49038,14
MIANWALI,MIANWALI,TEHSIL,18 - 60,470380,237842,232517,21,381147,191756,189383,8,89233,46086,43134,13
MIANWALI,MIANWALI,TEHSIL,18 &  ABOVE,532454,270422,262010,22,432424,218622,213793,9,100030,51800,48217,13
MIANWALI,MIANWALI,TEHSIL,60 &  ABOVE,67317,35227,32089,1,55598,29047,26550,1,11719,6180,5539,
MIANWALI,MIANWALI,TEHSIL,65 &  ABOVE,43098,22525,20572,1,35736,18653,17082,1,7362,3872,3490,
PIPLAN,MIANWALI,TEHSIL,ALL AGES,475050,245472,229550,28,368781,190479,178290,12,106269,54993,51260,16
PIPLAN,MIANWALI,TEHSIL,UNDER 1,11123,5899,5224,,8943,4716,4227,,2180,1183,997,
PIPLAN,MIANWALI,TEHSIL,UNDER 5,68092,35503,32589,,54414,28348,26066,,13678,7155,6523,
PIPLAN,MIANWALI,TEHSIL,UNDER 10,125320,64987,60333,,99618,51568,48050,,25702,13419,12283,
PIPLAN,MIANWALI,TEHSIL,UNDER 15,179249,93636,85612,1,142207,74044,68162,1,37042,19592,17450,
PIPLAN,MIANWALI,TEHSIL,05 - 24,198766,103745,95005,16,155984,81260,74718,6,42782,22485,20287,10
PIPLAN,MIANWALI,TEHSIL,15 - 49,233106,118685,114397,24,179082,91179,87892,11,54024,27506,26505,13
PIPLAN,MIANWALI,TEHSIL,15 - 64,276112,141347,134738,27,211732,108409,103312,11,64380,32938,31426,16
PIPLAN,MIANWALI,TEHSIL,18 - 60,238236,121067,117145,24,182310,92676,89624,10,55926,28391,27521,14
PIPLAN,MIANWALI,TEHSIL,18 &  ABOVE,266608,136278,130305,25,203665,104257,99398,10,62943,32021,30907,15
PIPLAN,MIANWALI,TEHSIL,60 &  ABOVE,30996,16519,14476,1,23381,12581,10800,,7615,3938,3676,1
PIPLAN,MIANWALI,TEHSIL,65 &  ABOVE,19689,10489,9200,,14842,8026,6816,,4847,2463,2384,
MULTAN,MULTAN,DISTRICT,ALL AGES,5340762,2720277,2620078,407,2859260,1450811,1408313,136,2481502,1269466,1211765,271
MULTAN,MULTAN,DISTRICT,UNDER 1,110143,55467,54676,,63840,32044,31796,,46303,23423,22880,
MULTAN,MULTAN,DISTRICT,UNDER 5,730275,367792,362483,,414169,207513,206656,,316106,160279,155827,
MULTAN,MULTAN,DISTRICT,UNDER 10,1398159,703614,694545,,803524,403668,399856,,594635,299946,294689,
MULTAN,MULTAN,DISTRICT,UNDER 15,2031752,1024001,1007740,11,1152465,579534,572923,8,879287,444467,434817,3
MULTAN,MULTAN,DISTRICT,05 - 24,2309198,1165168,1143900,130,1267574,638005,629527,42,1041624,527163,514373,88
MULTAN,MULTAN,DISTRICT,15 - 49,2677111,1356761,1320008,342,1381002,699219,681671,112,1296109,657542,638337,230
MULTAN,MULTAN,DISTRICT,15 - 64,3127784,1598534,1528864,386,1608827,819521,789182,124,1518957,779013,739682,262
MULTAN,MULTAN,DISTRICT,18 - 60,2716833,1385743,1330737,353,1392107,707984,684008,115,1324726,677759,646729,238
MULTAN,MULTAN,DISTRICT,18 &  ABOVE,2984597,1530414,1453819,364,1534099,783046,750934,119,1450498,747368,702885,245
MULTAN,MULTAN,DISTRICT,60 &  ABOVE,294803,159034,135752,17,155423,82139,73280,4,139380,76895,62472,13
MULTAN,MULTAN,DISTRICT,65 &  ABOVE,181226,97742,83474,10,97968,51756,46208,4,83258,45986,37266,6
JALALPUR PIRWALA,MULTAN,TEHSIL,ALL AGES,608174,304393,303760,21,518714,259531,259173,10,89460,44862,44587,11
JALALPUR PIRWALA,MULTAN,TEHSIL,UNDER 1,11679,5816,5863,,10139,5012,5127,,1540,804,736,
JALALPUR PIRWALA,MULTAN,TEHSIL,UNDER 5,89307,44363,44944,,77236,38315,38921,,12071,6048,6023,
JALALPUR PIRWALA,MULTAN,TEHSIL,UNDER 10,180896,90483,90413,,156985,78434,78551,,23911,12049,11862,
JALALPUR PIRWALA,MULTAN,TEHSIL,UNDER 15,256921,128721,128200,,221751,110917,110834,,35170,17804,17366,
JALALPUR PIRWALA,MULTAN,TEHSIL,05 - 24,279519,139895,139620,4,239301,119705,119593,3,40218,20190,20027,1
JALALPUR PIRWALA,MULTAN,TEHSIL,15 - 49,280606,138979,141610,17,236821,117515,119299,7,43785,21464,22311,10
JALALPUR PIRWALA,MULTAN,TEHSIL,15 - 64,328248,163617,164611,20,276997,138155,138833,9,51251,25462,25778,11
JALALPUR PIRWALA,MULTAN,TEHSIL,18 - 60,282881,140710,142153,18,238570,118727,119836,7,44311,21983,22317,11
JALALPUR PIRWALA,MULTAN,TEHSIL,18 &  ABOVE,315091,157486,157586,19,266370,133166,133196,8,48721,24320,24390,11
JALALPUR PIRWALA,MULTAN,TEHSIL,60 &  ABOVE,34991,18217,16773,1,30131,15647,14483,1,4860,2570,2290,
JALALPUR PIRWALA,MULTAN,TEHSIL,65 &  ABOVE,23005,12055,10949,1,19966,10459,9506,1,3039,1596,1443,
MULTAN CITY,MULTAN,TEHSIL,ALL AGES,2548828,1306895,1241646,287,385302,198230,187028,44,2163526,1108665,1054618,243
MULTAN CITY,MULTAN,TEHSIL,UNDER 1,46889,23643,23246,,6928,3453,3475,,39961,20190,19771,
MULTAN CITY,MULTAN,TEHSIL,UNDER 5,323960,164137,159823,,50502,25275,25227,,273458,138862,134596,
MULTAN CITY,MULTAN,TEHSIL,UNDER 10,610718,307958,302760,,98397,49356,49041,,512321,258602,253719,
MULTAN CITY,MULTAN,TEHSIL,UNDER 15,902588,456058,446526,4,144235,72494,71740,1,758353,383564,374786,3
MULTAN CITY,MULTAN,TEHSIL,05 - 24,1071124,542188,528844,92,166658,83651,82999,8,904466,458537,445845,84
MULTAN CITY,MULTAN,TEHSIL,15 - 49,1334850,679724,654885,241,198766,102375,96354,37,1136084,577349,558531,204
MULTAN CITY,MULTAN,TEHSIL,15 - 64,1562536,804284,757975,277,230017,119569,110405,43,1332519,684715,647570,234
MULTAN CITY,MULTAN,TEHSIL,18 - 60,1363139,700045,662843,251,200595,104256,96298,41,1162544,595789,566545,210
MULTAN CITY,MULTAN,TEHSIL,18 &  ABOVE,1490304,770912,719134,258,217511,113739,103731,41,1272793,657173,615403,217
MULTAN CITY,MULTAN,TEHSIL,60 &  ABOVE,141158,78395,62750,13,18755,10490,8265,,122403,67905,54485,13
MULTAN CITY,MULTAN,TEHSIL,65 &  ABOVE,83704,46553,37145,6,11050,6167,4883,,72654,40386,32262,6
MULTAN SADDAR,MULTAN,TEHSIL,ALL AGES,1501453,762847,738526,80,1424032,723582,700380,70,77421,39265,38146,10
MULTAN SADDAR,MULTAN,TEHSIL,UNDER 1,34999,17451,17548,,33592,16788,16804,,1407,663,744,
MULTAN SADDAR,MULTAN,TEHSIL,UNDER 5,213674,106932,106742,,204713,102488,102225,,8961,4444,4517,
MULTAN SADDAR,MULTAN,TEHSIL,UNDER 10,409760,205683,204077,,391883,196811,195072,,17877,8872,9005,
MULTAN SADDAR,MULTAN,TEHSIL,UNDER 15,590025,296965,293055,5,563402,283605,279792,5,26623,13360,13263,
MULTAN SADDAR,MULTAN,TEHSIL,05 - 24,654859,330607,324227,25,624091,315260,308807,24,30768,15347,15420,1
MULTAN SADDAR,MULTAN,TEHSIL,15 - 49,736952,373804,363079,69,695851,353047,342744,60,41101,20757,20335,9
MULTAN SADDAR,MULTAN,TEHSIL,15 - 64,859627,438539,421015,73,811786,414180,397543,63,47841,24359,23472,10
MULTAN SADDAR,MULTAN,TEHSIL,18 - 60,744731,379235,365427,69,702565,357736,344770,59,42166,21499,20657,10
MULTAN SADDAR,MULTAN,TEHSIL,18 &  ABOVE,820379,419125,401183,71,773971,395397,378513,61,46408,23728,22670,10
MULTAN SADDAR,MULTAN,TEHSIL,60 &  ABOVE,82907,43695,39210,2,78290,41280,37008,2,4617,2415,2202,
MULTAN SADDAR,MULTAN,TEHSIL,65 &  ABOVE,51801,27343,24456,2,48844,25797,23045,2,2957,1546,1411,
SHUJABAD,MULTAN,TEHSIL,ALL AGES,682307,346142,336146,19,531212,269468,261732,12,151095,76674,74414,7
SHUJABAD,MULTAN,TEHSIL,UNDER 1,16576,8557,8019,,13181,6791,6390,,3395,1766,1629,
SHUJABAD,MULTAN,TEHSIL,UNDER 5,103334,52360,50974,,81718,41435,40283,,21616,10925,10691,
SHUJABAD,MULTAN,TEHSIL,UNDER 10,196785,99490,97295,,156259,79067,77192,,40526,20423,20103,
SHUJABAD,MULTAN,TEHSIL,UNDER 15,282218,142257,139959,2,223077,112518,110557,2,59141,29739,29402,
SHUJABAD,MULTAN,TEHSIL,05 - 24,303696,152478,151209,9,237524,119389,118128,7,66172,33089,33081,2
SHUJABAD,MULTAN,TEHSIL,15 - 49,324703,164254,160434,15,249564,126282,123274,8,75139,37972,37160,7
SHUJABAD,MULTAN,TEHSIL,15 - 64,377373,192094,185263,16,290027,147617,142401,9,87346,44477,42862,7
SHUJABAD,MULTAN,TEHSIL,18 - 60,326082,165753,160314,15,250377,127265,123104,8,75705,38488,37210,7
SHUJABAD,MULTAN,TEHSIL,18 &  ABOVE,358823,182891,175916,16,276247,140744,135494,9,82576,42147,40422,7
SHUJABAD,MULTAN,TEHSIL,60 &  ABOVE,35747,18727,17019,1,28247,14722,13524,1,7500,4005,3495,
SHUJABAD,MULTAN,TEHSIL,65 &  ABOVE,22716,11791,10924,1,18108,9333,8774,1,4608,2458,2150,
MUZAFFARGARH,MUZAFFARGARH,DISTRICT,ALL AGES,5012124,2545343,2466672,109,4066845,2066288,2000493,64,945279,479055,466179,45
MUZAFFARGARH,MUZAFFARGARH,DISTRICT,UNDER 1,126945,63596,63349,,103769,52074,51695,,23176,11522,11654,
MUZAFFARGARH,MUZAFFARGARH,DISTRICT,UNDER 5,873811,441017,432794,,719654,362678,356976,,154157,78339,75818,
MUZAFFARGARH,MUZAFFARGARH,DISTRICT,UNDER 10,1617648,816143,801505,,1339808,675668,664140,,277840,140475,137365,
MUZAFFARGARH,MUZAFFARGARH,DISTRICT,UNDER 15,2267401,1145430,1121963,8,1873941,946696,927240,5,393460,198734,194723,3
MUZAFFARGARH,MUZAFFARGARH,DISTRICT,05 - 24,2295846,1160117,1135682,47,1882548,952682,929837,29,413298,207435,205845,18
MUZAFFARGARH,MUZAFFARGARH,DISTRICT,15 - 49,2247863,1136021,1111763,79,1797527,909710,887768,49,450336,226311,223995,30
MUZAFFARGARH,MUZAFFARGARH,DISTRICT,15 - 64,2589923,1317121,1272706,96,2067350,1052118,1015177,55,522573,265003,257529,41
MUZAFFARGARH,MUZAFFARGARH,DISTRICT,18 - 60,2213452,1122585,1090793,74,1764264,895680,868544,40,449188,226905,222249,34
MUZAFFARGARH,MUZAFFARGARH,DISTRICT,18 &  ABOVE,2432285,1239628,1192576,81,1940344,990093,950207,44,491941,249535,242369,37
MUZAFFARGARH,MUZAFFARGARH,DISTRICT,60 &  ABOVE,240047,128428,111611,8,192839,103411,89423,5,47208,25017,22188,3
MUZAFFARGARH,MUZAFFARGARH,DISTRICT,65 &  ABOVE,154800,82792,72003,5,125554,67474,58076,4,29246,15318,13927,1
ALIPUR,MUZAFFARGARH,TEHSIL,ALL AGES,760524,389268,371243,13,582631,298287,284336,8,177893,90981,86907,5
ALIPUR,MUZAFFARGARH,TEHSIL,UNDER 1,25618,13275,12343,,19552,10237,9315,,6066,3038,3028,
ALIPUR,MUZAFFARGARH,TEHSIL,UNDER 5,156566,80999,75567,,123776,64148,59628,,32790,16851,15939,
ALIPUR,MUZAFFARGARH,TEHSIL,UNDER 10,268292,137706,130586,,211927,108889,103038,,56365,28817,27548,
ALIPUR,MUZAFFARGARH,TEHSIL,UNDER 15,363051,186323,176727,1,284700,146027,138673,,78351,40296,38054,1
ALIPUR,MUZAFFARGARH,TEHSIL,05 - 24,338538,172337,166198,3,260278,132163,128113,2,78260,40174,38085,1
ALIPUR,MUZAFFARGARH,TEHSIL,15 - 49,326175,165436,160731,8,244715,124190,120519,6,81460,41246,40212,2
ALIPUR,MUZAFFARGARH,TEHSIL,15 - 64,374775,191057,183708,10,280593,143065,137522,6,94182,47992,46186,4
ALIPUR,MUZAFFARGARH,TEHSIL,18 - 60,320408,162763,157636,9,240372,122408,117959,5,80036,40355,39677,4
ALIPUR,MUZAFFARGARH,TEHSIL,18 &  ABOVE,351968,179253,172704,11,264250,134989,129254,7,87718,44264,43450,4
ALIPUR,MUZAFFARGARH,TEHSIL,60 &  ABOVE,34767,18187,16578,2,26244,13819,12423,2,8523,4368,4155,
ALIPUR,MUZAFFARGARH,TEHSIL,65 &  ABOVE,22698,11888,10808,2,17338,9195,8141,2,5360,2693,2667,
CHOWK SARWAR SHAHEED,MUZAFFARGARH,TEHSIL,ALL AGES,414200,207527,206668,5,351069,176177,174888,4,63131,31350,31780,1
CHOWK SARWAR SHAHEED,MUZAFFARGARH,TEHSIL,UNDER 1,8571,4337,4234,,7349,3735,3614,,1222,602,620,
CHOWK SARWAR SHAHEED,MUZAFFARGARH,TEHSIL,UNDER 5,59029,29497,29532,,51262,25681,25581,,7767,3816,3951,
CHOWK SARWAR SHAHEED,MUZAFFARGARH,TEHSIL,UNDER 10,119984,59439,60545,,104028,51585,52443,,15956,7854,8102,
CHOWK SARWAR SHAHEED,MUZAFFARGARH,TEHSIL,UNDER 15,174672,86330,88341,1,150952,74787,76164,1,23720,11543,12177,
CHOWK SARWAR SHAHEED,MUZAFFARGARH,TEHSIL,05 - 24,193518,95488,98028,2,165211,81755,83454,2,28307,13733,14574,
CHOWK SARWAR SHAHEED,MUZAFFARGARH,TEHSIL,15 - 49,193979,96642,97335,2,162172,80994,81177,1,31807,15648,16158,1
CHOWK SARWAR SHAHEED,MUZAFFARGARH,TEHSIL,15 - 64,225080,113221,111855,4,187789,94601,93185,3,37291,18620,18670,1
CHOWK SARWAR SHAHEED,MUZAFFARGARH,TEHSIL,18 - 60,192209,96651,95555,3,160060,80615,79443,2,32149,16036,16112,1
CHOWK SARWAR SHAHEED,MUZAFFARGARH,TEHSIL,18 &  ABOVE,212693,107869,104821,3,177382,90088,87292,2,35311,17781,17529,1
CHOWK SARWAR SHAHEED,MUZAFFARGARH,TEHSIL,60 &  ABOVE,22197,12131,10065,1,18754,10224,8529,1,3443,1907,1536,
CHOWK SARWAR SHAHEED,MUZAFFARGARH,TEHSIL,65 &  ABOVE,14448,7976,6472,,12328,6789,5539,,2120,1187,933,
JATOI,MUZAFFARGARH,TEHSIL,ALL AGES,861713,436523,425150,40,644502,327383,317098,21,217211,109140,108052,19
JATOI,MUZAFFARGARH,TEHSIL,UNDER 1,23073,11308,11765,,17279,8466,8813,,5794,2842,2952,
JATOI,MUZAFFARGARH,TEHSIL,UNDER 5,163381,81375,82006,,122823,61279,61544,,40558,20096,20462,
JATOI,MUZAFFARGARH,TEHSIL,UNDER 10,298949,149925,149024,,226493,113948,112545,,72456,35977,36479,
JATOI,MUZAFFARGARH,TEHSIL,UNDER 15,411595,207531,204061,3,311721,157702,154018,1,99874,49829,50043,2
JATOI,MUZAFFARGARH,TEHSIL,05 - 24,398292,202193,196080,19,300869,153390,147470,9,97423,48803,48610,10
JATOI,MUZAFFARGARH,TEHSIL,15 - 49,371652,187965,183656,31,274929,139276,135635,18,96723,48689,48021,13
JATOI,MUZAFFARGARH,TEHSIL,15 - 64,425069,215849,209184,36,314237,159817,154401,19,110832,56032,54783,17
JATOI,MUZAFFARGARH,TEHSIL,18 - 60,363413,184154,179231,28,268458,136295,132148,15,94955,47859,47083,13
JATOI,MUZAFFARGARH,TEHSIL,18 &  ABOVE,398445,202481,195935,29,294349,149973,144360,16,104096,52508,51575,13
JATOI,MUZAFFARGARH,TEHSIL,60 &  ABOVE,38524,20174,18349,1,28420,15026,13393,1,10104,5148,4956,
JATOI,MUZAFFARGARH,TEHSIL,65 &  ABOVE,25049,13143,11905,1,18544,9864,8679,1,6505,3279,3226,
KOT ADDU,MUZAFFARGARH,TEHSIL,ALL AGES,1071282,538365,532895,22,851396,428892,422498,6,219886,109473,110397,16
KOT ADDU,MUZAFFARGARH,TEHSIL,UNDER 1,20836,10361,10475,,16585,8208,8377,,4251,2153,2098,
KOT ADDU,MUZAFFARGARH,TEHSIL,UNDER 5,157935,78108,79827,,128663,63549,65114,,29272,14559,14713,
KOT ADDU,MUZAFFARGARH,TEHSIL,UNDER 10,312600,154815,157785,,255790,126766,129024,,56810,28049,28761,
KOT ADDU,MUZAFFARGARH,TEHSIL,UNDER 15,453209,224853,228356,,369754,183687,186067,,83455,41166,42289,
KOT ADDU,MUZAFFARGARH,TEHSIL,05 - 24,499283,248736,250539,8,402424,201406,201016,2,96859,47330,49523,6
KOT ADDU,MUZAFFARGARH,TEHSIL,15 - 49,506163,254182,251965,16,395269,199377,195887,5,110894,54805,56078,11
KOT ADDU,MUZAFFARGARH,TEHSIL,15 - 64,583498,295191,288286,21,454493,230703,223784,6,129005,64488,64502,15
KOT ADDU,MUZAFFARGARH,TEHSIL,18 - 60,498705,251899,246789,17,387323,196266,191052,5,111382,55633,55737,12
KOT ADDU,MUZAFFARGARH,TEHSIL,18 &  ABOVE,547757,278046,269691,20,425546,216745,208796,5,122211,61301,60895,15
KOT ADDU,MUZAFFARGARH,TEHSIL,60 &  ABOVE,53400,28502,24895,3,41583,22301,19282,,11817,6201,5613,3
KOT ADDU,MUZAFFARGARH,TEHSIL,65 &  ABOVE,34575,18321,16253,1,27149,14502,12647,,7426,3819,3606,1
MUZAFFARGARH,MUZAFFARGARH,TEHSIL,ALL AGES,1904405,973660,930716,29,1637247,835549,801673,25,267158,138111,129043,4
MUZAFFARGARH,MUZAFFARGARH,TEHSIL,UNDER 1,48847,24315,24532,,43004,21428,21576,,5843,2887,2956,
MUZAFFARGARH,MUZAFFARGARH,TEHSIL,UNDER 5,336900,171038,165862,,293130,148021,145109,,43770,23017,20753,
MUZAFFARGARH,MUZAFFARGARH,TEHSIL,UNDER 10,617823,314258,303565,,541570,274480,267090,,76253,39778,36475,
MUZAFFARGARH,MUZAFFARGARH,TEHSIL,UNDER 15,864874,440393,424478,3,756814,384493,372318,3,108060,55900,52160,
MUZAFFARGARH,MUZAFFARGARH,TEHSIL,05 - 24,866215,441363,424837,15,753766,383968,369784,14,112449,57395,55053,1
MUZAFFARGARH,MUZAFFARGARH,TEHSIL,15 - 49,849894,431796,418076,22,720442,365873,354550,19,129452,65923,63526,3
MUZAFFARGARH,MUZAFFARGARH,TEHSIL,15 - 64,981501,501803,479673,25,830238,423932,406285,21,151263,77871,73388,4
MUZAFFARGARH,MUZAFFARGARH,TEHSIL,18 - 60,838717,427118,411582,17,708051,360096,347942,13,130666,67022,63640,4
MUZAFFARGARH,MUZAFFARGARH,TEHSIL,18 &  ABOVE,921422,471979,449425,18,778817,398298,380505,14,142605,73681,68920,4
MUZAFFARGARH,MUZAFFARGARH,TEHSIL,60 &  ABOVE,91159,49434,41724,1,77838,42041,35796,1,13321,7393,5928,
MUZAFFARGARH,MUZAFFARGARH,TEHSIL,65 &  ABOVE,58030,31464,26565,1,50195,27124,23070,1,7835,4340,3495,
NANKANA SAHIB,NANKANA SAHIB,DISTRICT,ALL AGES,1634871,831931,802859,81,1311483,669583,641867,33,323388,162348,160992,48
NANKANA SAHIB,NANKANA SAHIB,DISTRICT,UNDER 1,32502,16310,16192,,26567,13374,13193,,5935,2936,2999,
NANKANA SAHIB,NANKANA SAHIB,DISTRICT,UNDER 5,225626,113675,111951,,184736,93198,91538,,40890,20477,20413,
NANKANA SAHIB,NANKANA SAHIB,DISTRICT,UNDER 10,428600,215687,212913,,350988,177042,173946,,77612,38645,38967,
NANKANA SAHIB,NANKANA SAHIB,DISTRICT,UNDER 15,622023,313411,308609,3,505852,255327,250523,2,116171,58084,58086,1
NANKANA SAHIB,NANKANA SAHIB,DISTRICT,05 - 24,699279,352167,347099,13,562452,284072,278373,7,136827,68095,68726,6
NANKANA SAHIB,NANKANA SAHIB,DISTRICT,15 - 49,800681,402019,398602,60,635420,320671,314725,24,165261,81348,83877,36
NANKANA SAHIB,NANKANA SAHIB,DISTRICT,15 - 64,945979,480444,465461,74,750614,382825,367760,29,195365,97619,97701,45
NANKANA SAHIB,NANKANA SAHIB,DISTRICT,18 - 60,817227,413871,403286,70,648279,329999,318255,25,168948,83872,85031,45
NANKANA SAHIB,NANKANA SAHIB,DISTRICT,18 &  ABOVE,912417,467719,444623,75,725904,374009,351867,28,186513,93710,92756,47
NANKANA SAHIB,NANKANA SAHIB,DISTRICT,60 &  ABOVE,105734,59437,46290,7,86254,48587,37663,4,19480,10850,8627,3
NANKANA SAHIB,NANKANA SAHIB,DISTRICT,65 &  ABOVE,66869,38076,28789,4,55017,31431,23584,2,11852,6645,5205,2
NANKANA SAHIB,NANKANA SAHIB,TEHSIL,ALL AGES,1065063,545638,519382,43,935022,480218,454777,27,130041,65420,64605,16
NANKANA SAHIB,NANKANA SAHIB,TEHSIL,UNDER 1,20676,10369,10307,,18475,9296,9179,,2201,1073,1128,
NANKANA SAHIB,NANKANA SAHIB,TEHSIL,UNDER 5,147824,74267,73557,,133105,67081,66024,,14719,7186,7533,
NANKANA SAHIB,NANKANA SAHIB,TEHSIL,UNDER 10,285378,143793,141585,,255829,129301,126528,,29549,14492,15057,
NANKANA SAHIB,NANKANA SAHIB,TEHSIL,UNDER 15,415192,210125,205064,3,369075,187140,181933,2,46117,22985,23131,1
NANKANA SAHIB,NANKANA SAHIB,TEHSIL,05 - 24,463440,235278,228154,8,406578,206795,199778,5,56862,28483,28376,3
NANKANA SAHIB,NANKANA SAHIB,TEHSIL,15 - 49,515807,261841,253937,29,448820,228553,220247,20,66987,33288,33690,9
NANKANA SAHIB,NANKANA SAHIB,TEHSIL,15 - 64,607805,311654,296113,38,528693,271815,256854,24,79112,39839,39259,14
NANKANA SAHIB,NANKANA SAHIB,TEHSIL,18 - 60,523643,267944,255662,37,455884,234073,221788,23,67759,33871,33874,14
NANKANA SAHIB,NANKANA SAHIB,TEHSIL,18 &  ABOVE,583485,301705,281741,39,508599,263945,244630,24,74886,37760,37111,15
NANKANA SAHIB,NANKANA SAHIB,TEHSIL,60 &  ABOVE,66573,37330,29239,4,58716,33076,25638,2,7857,4254,3601,2
NANKANA SAHIB,NANKANA SAHIB,TEHSIL,65 &  ABOVE,42066,23859,18205,2,37254,21263,15990,1,4812,2596,2215,1
SANGLA HILL,NANKANA SAHIB,TEHSIL,ALL AGES,269993,134999,134979,15,166284,83295,82987,2,103709,51704,51992,13
SANGLA HILL,NANKANA SAHIB,TEHSIL,UNDER 1,6173,3109,3064,,3972,2043,1929,,2201,1066,1135,
SANGLA HILL,NANKANA SAHIB,TEHSIL,UNDER 5,36686,18643,18043,,22034,11209,10825,,14652,7434,7218,
SANGLA HILL,NANKANA SAHIB,TEHSIL,UNDER 10,67803,33937,33866,,41631,20861,20770,,26172,13076,13096,
SANGLA HILL,NANKANA SAHIB,TEHSIL,UNDER 15,97640,48714,48926,,59872,29866,30006,,37768,18848,18920,
SANGLA HILL,NANKANA SAHIB,TEHSIL,05 - 24,110992,54487,56505,,68903,33878,35025,,42089,20609,21480,
SANGLA HILL,NANKANA SAHIB,TEHSIL,15 - 49,134368,65494,68863,11,82258,40276,41981,1,52110,25218,26882,10
SANGLA HILL,NANKANA SAHIB,TEHSIL,15 - 64,160250,79442,80795,13,98250,48820,49429,1,62000,30622,31366,12
SANGLA HILL,NANKANA SAHIB,TEHSIL,18 - 60,139122,68650,70459,13,85141,42099,43041,1,53981,26551,27418,12
SANGLA HILL,NANKANA SAHIB,TEHSIL,18 &  ABOVE,156381,78367,77999,15,96610,48547,48061,2,59771,29820,29938,13
SANGLA HILL,NANKANA SAHIB,TEHSIL,60 &  ABOVE,18941,10619,8320,2,12525,7004,5520,1,6416,3615,2800,1
SANGLA HILL,NANKANA SAHIB,TEHSIL,65 &  ABOVE,12103,6843,5258,2,8162,4609,3552,1,3941,2234,1706,1
SHAH KOT,NANKANA SAHIB,TEHSIL,ALL AGES,299815,151294,148498,23,210177,106070,104103,4,89638,45224,44395,19
SHAH KOT,NANKANA SAHIB,TEHSIL,UNDER 1,5653,2832,2821,,4120,2035,2085,,1533,797,736,
SHAH KOT,NANKANA SAHIB,TEHSIL,UNDER 5,41116,20765,20351,,29597,14908,14689,,11519,5857,5662,
SHAH KOT,NANKANA SAHIB,TEHSIL,UNDER 10,75419,37957,37462,,53528,26880,26648,,21891,11077,10814,
SHAH KOT,NANKANA SAHIB,TEHSIL,UNDER 15,109191,54572,54619,,76905,38321,38584,,32286,16251,16035,
SHAH KOT,NANKANA SAHIB,TEHSIL,05 - 24,124847,62402,62440,5,86971,43399,43570,2,37876,19003,18870,3
SHAH KOT,NANKANA SAHIB,TEHSIL,15 - 49,150506,74684,75802,20,104342,51842,52497,3,46164,22842,23305,17
SHAH KOT,NANKANA SAHIB,TEHSIL,15 - 64,177924,89348,88553,23,123671,62190,61477,4,54253,27158,27076,19
SHAH KOT,NANKANA SAHIB,TEHSIL,18 - 60,154462,77277,77165,20,107254,53827,53426,1,47208,23450,23739,19
SHAH KOT,NANKANA SAHIB,TEHSIL,18 &  ABOVE,172551,87647,84883,21,120695,61517,59176,2,51856,26130,25707,19
SHAH KOT,NANKANA SAHIB,TEHSIL,60 &  ABOVE,20220,11488,8731,1,15013,8507,6505,1,5207,2981,2226,
SHAH KOT,NANKANA SAHIB,TEHSIL,65 &  ABOVE,12700,7374,5326,,9601,5559,4042,,3099,1815,1284,
NAROWAL,NAROWAL,DISTRICT,ALL AGES,1950769,996357,954327,85,1601749,818879,782824,46,349020,177478,171503,39
NAROWAL,NAROWAL,DISTRICT,UNDER 1,43429,22494,20935,,36440,18934,17506,,6989,3560,3429,
NAROWAL,NAROWAL,DISTRICT,UNDER 5,264740,136165,128575,,221256,113713,107543,,43484,22452,21032,
NAROWAL,NAROWAL,DISTRICT,UNDER 10,494799,253603,241196,,411942,211088,200854,,82857,42515,40342,
NAROWAL,NAROWAL,DISTRICT,UNDER 15,726378,372933,353443,2,602066,308824,293240,2,124312,64109,60203,
NAROWAL,NAROWAL,DISTRICT,05 - 24,843724,431178,412522,24,693636,354489,339131,16,150088,76689,73391,8
NAROWAL,NAROWAL,DISTRICT,15 - 49,962570,484428,478070,72,784582,396305,388240,37,177988,88123,89830,35
NAROWAL,NAROWAL,DISTRICT,15 - 64,1135801,575861,559858,82,924559,469898,454617,44,211242,105963,105241,38
NAROWAL,NAROWAL,DISTRICT,18 - 60,975833,493320,482436,77,793626,402632,390953,41,182207,90688,91483,36
NAROWAL,NAROWAL,DISTRICT,18 &  ABOVE,1099146,559781,539287,78,897212,458197,438974,41,201934,101584,100313,37
NAROWAL,NAROWAL,DISTRICT,60 &  ABOVE,135147,72725,62421,1,113297,60691,52606,,21850,12034,9815,1
NAROWAL,NAROWAL,DISTRICT,65 &  ABOVE,88590,47563,41026,1,75124,40157,34967,,13466,7406,6059,1
NAROWAL,NAROWAL,TEHSIL,ALL AGES,680217,347649,332547,21,510578,261381,249186,11,169639,86268,83361,10
NAROWAL,NAROWAL,TEHSIL,UNDER 1,16100,8363,7737,,12481,6486,5995,,3619,1877,1742,
NAROWAL,NAROWAL,TEHSIL,UNDER 5,91432,47119,44313,,70347,36107,34240,,21085,11012,10073,
NAROWAL,NAROWAL,TEHSIL,UNDER 10,172211,88393,83818,,132168,67755,64413,,40043,20638,19405,
NAROWAL,NAROWAL,TEHSIL,UNDER 15,253778,130732,123046,,193809,99742,94067,,59969,30990,28979,
NAROWAL,NAROWAL,TEHSIL,05 - 24,297879,152547,145325,7,225093,115507,109580,6,72786,37040,35745,1
NAROWAL,NAROWAL,TEHSIL,15 - 49,338782,169577,169185,20,251794,126564,125220,10,86988,43013,43965,10
NAROWAL,NAROWAL,TEHSIL,15 - 64,397753,201111,196621,21,294616,149451,145154,11,103137,51660,51467,10
NAROWAL,NAROWAL,TEHSIL,18 - 60,342538,172286,170232,20,253280,127918,125352,10,89258,44368,44880,10
NAROWAL,NAROWAL,TEHSIL,18 &  ABOVE,382565,194278,188267,20,283790,144663,139117,10,98775,49615,49150,10
NAROWAL,NAROWAL,TEHSIL,60 &  ABOVE,43795,24058,19737,,33269,18274,14995,,10526,5784,4742,
NAROWAL,NAROWAL,TEHSIL,65 &  ABOVE,28686,15806,12880,,22153,12188,9965,,6533,3618,2915,
SHAKARGARH,NAROWAL,TEHSIL,ALL AGES,769339,393500,375809,30,642597,329020,313559,18,126742,64480,62250,12
SHAKARGARH,NAROWAL,TEHSIL,UNDER 1,16302,8522,7780,,14060,7379,6681,,2242,1143,1099,
SHAKARGARH,NAROWAL,TEHSIL,UNDER 5,105960,54623,51337,,90167,46590,43577,,15793,8033,7760,
SHAKARGARH,NAROWAL,TEHSIL,UNDER 10,195467,100279,95188,,165703,85167,80536,,29764,15112,14652,
SHAKARGARH,NAROWAL,TEHSIL,UNDER 15,285732,146732,138999,1,240839,123687,117151,1,44893,23045,21848,
SHAKARGARH,NAROWAL,TEHSIL,05 - 24,328028,167790,160228,10,274059,140123,133931,5,53969,27667,26297,5
SHAKARGARH,NAROWAL,TEHSIL,15 - 49,376661,190267,186369,25,312364,158364,153985,15,64297,31903,32384,10
SHAKARGARH,NAROWAL,TEHSIL,15 - 64,446402,226968,219406,28,369722,188422,181283,17,76680,38546,38123,11
SHAKARGARH,NAROWAL,TEHSIL,18 - 60,382997,194202,188769,26,317110,161349,155744,17,65887,32853,33025,9
SHAKARGARH,NAROWAL,TEHSIL,18 &  ABOVE,434510,221821,212662,27,361069,184734,176318,17,73441,37087,36344,10
SHAKARGARH,NAROWAL,TEHSIL,60 &  ABOVE,56486,30248,26237,1,48076,25542,22534,,8410,4706,3703,1
SHAKARGARH,NAROWAL,TEHSIL,65 &  ABOVE,37205,19800,17404,1,32036,16911,15125,,5169,2889,2279,1
ZAFARWAL,NAROWAL,TEHSIL,ALL AGES,501213,255208,245971,34,448574,228478,220079,17,52639,26730,25892,17
ZAFARWAL,NAROWAL,TEHSIL,UNDER 1,11027,5609,5418,,9899,5069,4830,,1128,540,588,
ZAFARWAL,NAROWAL,TEHSIL,UNDER 5,67348,34423,32925,,60742,31016,29726,,6606,3407,3199,
ZAFARWAL,NAROWAL,TEHSIL,UNDER 10,127121,64931,62190,,114071,58166,55905,,13050,6765,6285,
ZAFARWAL,NAROWAL,TEHSIL,UNDER 15,186868,95469,91398,1,167418,85395,82022,1,19450,10074,9376,
ZAFARWAL,NAROWAL,TEHSIL,05 - 24,217817,110841,106969,7,194484,98859,95620,5,23333,11982,11349,2
ZAFARWAL,NAROWAL,TEHSIL,15 - 49,247127,124584,122516,27,220424,111377,109035,12,26703,13207,13481,15
ZAFARWAL,NAROWAL,TEHSIL,15 - 64,291646,147782,143831,33,260221,132025,128180,16,31425,15757,15651,17
ZAFARWAL,NAROWAL,TEHSIL,18 - 60,250298,126832,123435,31,223236,113365,109857,14,27062,13467,13578,17
ZAFARWAL,NAROWAL,TEHSIL,18 &  ABOVE,282071,143682,138358,31,252353,128800,123539,14,29718,14882,14819,17
ZAFARWAL,NAROWAL,TEHSIL,60 &  ABOVE,34866,18419,16447,,31952,16875,15077,,2914,1544,1370,
ZAFARWAL,NAROWAL,TEHSIL,65 &  ABOVE,22699,11957,10742,,20935,11058,9877,,1764,899,865,
OKARA,OKARA,DISTRICT,ALL AGES,3503451,1783966,1719150,335,2327975,1187264,1140630,81,1175476,596702,578520,254
OKARA,OKARA,DISTRICT,UNDER 1,83210,42016,41194,,57199,29059,28140,,26011,12957,13054,
OKARA,OKARA,DISTRICT,UNDER 5,510496,257354,253142,,353822,178905,174917,,156674,78449,78225,
OKARA,OKARA,DISTRICT,UNDER 10,958545,482680,475865,,660492,333320,327172,,298053,149360,148693,
OKARA,OKARA,DISTRICT,UNDER 15,1366965,688742,678218,5,930593,469626,460964,3,436372,219116,217254,2
OKARA,OKARA,DISTRICT,05 - 24,1488690,749486,739126,78,991742,500451,491272,19,496948,249035,247854,59
OKARA,OKARA,DISTRICT,15 - 49,1683811,850138,833394,279,1091828,552551,539214,63,591983,297587,294180,216
OKARA,OKARA,DISTRICT,15 - 64,1992297,1015135,976842,320,1296580,661769,634736,75,695717,353366,342106,245
OKARA,OKARA,DISTRICT,18 - 60,1722582,875630,846652,300,1118455,569540,548847,68,604127,306090,297805,232
OKARA,OKARA,DISTRICT,18 &  ABOVE,1927822,989027,938481,314,1260033,647577,612384,72,667789,341450,326097,242
OKARA,OKARA,DISTRICT,60 &  ABOVE,225925,124376,101534,15,155491,85388,70099,4,70434,38988,31435,11
OKARA,OKARA,DISTRICT,65 &  ABOVE,144189,80089,64090,10,100802,55869,44930,3,43387,24220,19160,7
DEPALPUR,OKARA,TEHSIL,ALL AGES,1592201,810875,781186,140,1130731,577765,552929,37,461470,233110,228257,103
DEPALPUR,OKARA,TEHSIL,UNDER 1,36097,18049,18048,,25804,12989,12815,,10293,5060,5233,
DEPALPUR,OKARA,TEHSIL,UNDER 5,232885,117147,115738,,169916,85553,84363,,62969,31594,31375,
DEPALPUR,OKARA,TEHSIL,UNDER 10,443385,223005,220380,,322491,162279,160212,,120894,60726,60168,
DEPALPUR,OKARA,TEHSIL,UNDER 15,632619,318457,314160,2,456056,229780,226274,2,176563,88677,87886,
DEPALPUR,OKARA,TEHSIL,05 - 24,686201,345857,340320,24,487074,246367,240700,7,199127,99490,99620,17
DEPALPUR,OKARA,TEHSIL,15 - 49,755025,381979,372936,110,528460,269006,259428,26,226565,112973,113508,84
DEPALPUR,OKARA,TEHSIL,15 - 64,893221,455821,437267,133,626237,321207,304997,33,266984,134614,132270,100
DEPALPUR,OKARA,TEHSIL,18 - 60,771167,392558,378481,128,540520,276609,263880,31,230647,115949,114601,97
DEPALPUR,OKARA,TEHSIL,18 &  ABOVE,864468,443658,420675,135,608053,313656,294363,34,256415,130002,126312,101
DEPALPUR,OKARA,TEHSIL,60 &  ABOVE,102597,56049,46540,8,74256,40601,33652,3,28341,15448,12888,5
DEPALPUR,OKARA,TEHSIL,65 &  ABOVE,66361,36597,29759,5,48438,26778,21658,2,17923,9819,8101,3
OKARA,OKARA,TEHSIL,ALL AGES,1382002,703712,678127,163,767766,390803,376931,32,614236,312909,301196,131
OKARA,OKARA,TEHSIL,UNDER 1,33128,16798,16330,,20045,10264,9781,,13083,6534,6549,
OKARA,OKARA,TEHSIL,UNDER 5,195708,98351,97357,,117251,59235,58016,,78457,39116,39341,
OKARA,OKARA,TEHSIL,UNDER 10,368415,185018,183397,,218134,110105,108029,,150281,74913,75368,
OKARA,OKARA,TEHSIL,UNDER 15,528506,265636,262867,3,306982,154850,152131,1,221524,110786,110736,2
OKARA,OKARA,TEHSIL,05 - 24,583503,293416,290040,47,326701,164819,161873,9,256802,128597,128167,38
OKARA,OKARA,TEHSIL,15 - 49,675300,340991,334162,147,358721,180607,178085,29,316579,160384,156077,118
OKARA,OKARA,TEHSIL,15 - 64,797740,406749,390832,159,427020,217091,209898,31,370720,189658,180934,128
OKARA,OKARA,TEHSIL,18 - 60,691181,351510,339524,147,367928,186405,181496,27,323253,165105,158028,120
OKARA,OKARA,TEHSIL,18 &  ABOVE,770840,396113,374579,148,415103,212707,202369,27,355737,183406,172210,121
OKARA,OKARA,TEHSIL,60 &  ABOVE,88177,49092,39084,1,52013,28841,23172,,36164,20251,15912,1
OKARA,OKARA,TEHSIL,65 &  ABOVE,55756,31327,24428,1,33764,18862,14902,,21992,12465,9526,1
RENALA KHURD,OKARA,TEHSIL,ALL AGES,529248,269379,259837,32,429478,218696,210770,12,99770,50683,49067,20
RENALA KHURD,OKARA,TEHSIL,UNDER 1,13985,7169,6816,,11350,5806,5544,,2635,1363,1272,
RENALA KHURD,OKARA,TEHSIL,UNDER 5,81903,41856,40047,,66655,34117,32538,,15248,7739,7509,
RENALA KHURD,OKARA,TEHSIL,UNDER 10,146745,74657,72088,,119867,60936,58931,,26878,13721,13157,
RENALA KHURD,OKARA,TEHSIL,UNDER 15,205840,104649,101191,,167555,84996,82559,,38285,19653,18632,
RENALA KHURD,OKARA,TEHSIL,05 - 24,218986,110213,108766,7,177967,89265,88699,3,41019,20948,20067,4
RENALA KHURD,OKARA,TEHSIL,15 - 49,253486,127168,126296,22,204647,102938,101701,8,48839,24230,24595,14
RENALA KHURD,OKARA,TEHSIL,15 - 64,301336,152565,148743,28,243323,123471,119841,11,58013,29094,28902,17
RENALA KHURD,OKARA,TEHSIL,18 - 60,260234,131562,128647,25,210007,106526,103471,10,50227,25036,25176,15
RENALA KHURD,OKARA,TEHSIL,18 &  ABOVE,292514,149256,143227,31,236877,121214,115652,11,55637,28042,27575,20
RENALA KHURD,OKARA,TEHSIL,60 &  ABOVE,35151,19235,15910,6,29222,15946,13275,1,5929,3289,2635,5
RENALA KHURD,OKARA,TEHSIL,65 &  ABOVE,22072,12165,9903,4,18600,10229,8370,1,3472,1936,1533,3
PAKPATTAN,PAKPATTAN,DISTRICT,ALL AGES,2135511,1085000,1050351,160,1662991,845572,817371,48,472520,239428,232980,112
PAKPATTAN,PAKPATTAN,DISTRICT,UNDER 1,60602,30656,29946,,47947,24236,23711,,12655,6420,6235,
PAKPATTAN,PAKPATTAN,DISTRICT,UNDER 5,339749,171837,167912,,269945,136439,133506,,69804,35398,34406,
PAKPATTAN,PAKPATTAN,DISTRICT,UNDER 10,613557,309577,303980,,487320,246129,241191,,126237,63448,62789,
PAKPATTAN,PAKPATTAN,DISTRICT,UNDER 15,865146,436746,428398,2,682732,344667,338064,1,182414,92079,90334,1
PAKPATTAN,PAKPATTAN,DISTRICT,05 - 24,898187,452897,445247,43,700113,353428,346672,13,198074,99469,98575,30
PAKPATTAN,PAKPATTAN,DISTRICT,15 - 49,997134,502286,494710,138,766067,386414,379615,38,231067,115872,115095,100
PAKPATTAN,PAKPATTAN,DISTRICT,15 - 64,1184386,601439,582789,158,911182,463093,448042,47,273204,138346,134747,111
PAKPATTAN,PAKPATTAN,DISTRICT,18 - 60,1018512,516002,502364,146,782579,396966,385571,42,235933,119036,116793,104
PAKPATTAN,PAKPATTAN,DISTRICT,18 &  ABOVE,1142695,583169,559379,147,881795,450763,430989,43,260900,132406,128390,104
PAKPATTAN,PAKPATTAN,DISTRICT,60 &  ABOVE,135017,73090,61924,3,107726,58428,49295,3,27291,14662,12629,
PAKPATTAN,PAKPATTAN,DISTRICT,65 &  ABOVE,85979,46815,39164,,69077,37812,31265,,16902,9003,7899,
ARIF WALA,PAKPATTAN,TEHSIL,ALL AGES,999278,506782,492406,90,789720,399609,390083,28,209558,107173,102323,62
ARIF WALA,PAKPATTAN,TEHSIL,UNDER 1,25393,12881,12512,,20292,10284,10008,,5101,2597,2504,
ARIF WALA,PAKPATTAN,TEHSIL,UNDER 5,147535,74084,73451,,119003,59600,59403,,28532,14484,14048,
ARIF WALA,PAKPATTAN,TEHSIL,UNDER 10,274315,137478,136837,,220479,110418,110061,,53836,27060,26776,
ARIF WALA,PAKPATTAN,TEHSIL,UNDER 15,392706,197483,195223,,312974,156942,156032,,79732,40541,39191,
ARIF WALA,PAKPATTAN,TEHSIL,05 - 24,422030,212676,209328,26,331936,166814,165115,7,90094,45862,44213,19
ARIF WALA,PAKPATTAN,TEHSIL,15 - 49,474339,238994,235264,81,370590,186203,184363,24,103749,52791,50901,57
ARIF WALA,PAKPATTAN,TEHSIL,15 - 64,565234,286894,278250,90,442647,224054,218565,28,122587,62840,59685,62
ARIF WALA,PAKPATTAN,TEHSIL,18 - 60,486592,246321,240187,84,380940,192344,188571,25,105652,53977,51616,59
ARIF WALA,PAKPATTAN,TEHSIL,18 &  ABOVE,546752,278657,268011,84,430213,218944,211244,25,116539,59713,56767,59
ARIF WALA,PAKPATTAN,TEHSIL,60 &  ABOVE,65275,35116,30158,1,53318,28794,24523,1,11957,6322,5635,
ARIF WALA,PAKPATTAN,TEHSIL,65 &  ABOVE,41338,22405,18933,,34099,18613,15486,,7239,3792,3447,
PAKPATTAN,PAKPATTAN,TEHSIL,ALL AGES,1136233,578218,557945,70,873271,445963,427288,20,262962,132255,130657,50
PAKPATTAN,PAKPATTAN,TEHSIL,UNDER 1,35209,17775,17434,,27655,13952,13703,,7554,3823,3731,
PAKPATTAN,PAKPATTAN,TEHSIL,UNDER 5,192214,97753,94461,,150942,76839,74103,,41272,20914,20358,
PAKPATTAN,PAKPATTAN,TEHSIL,UNDER 10,339242,172099,167143,,266841,135711,131130,,72401,36388,36013,
PAKPATTAN,PAKPATTAN,TEHSIL,UNDER 15,472440,239263,233175,2,369758,187725,182032,1,102682,51538,51143,1
PAKPATTAN,PAKPATTAN,TEHSIL,05 - 24,476157,240221,235919,17,368177,186614,181557,6,107980,53607,54362,11
PAKPATTAN,PAKPATTAN,TEHSIL,15 - 49,522795,263292,259446,57,395477,200211,195252,14,127318,63081,64194,43
PAKPATTAN,PAKPATTAN,TEHSIL,15 - 64,619152,314545,304539,68,468535,239039,229477,19,150617,75506,75062,49
PAKPATTAN,PAKPATTAN,TEHSIL,18 - 60,531920,269681,262177,62,401639,204622,197000,17,130281,65059,65177,45
PAKPATTAN,PAKPATTAN,TEHSIL,18 &  ABOVE,595943,304512,291368,63,451582,231819,219745,18,144361,72693,71623,45
PAKPATTAN,PAKPATTAN,TEHSIL,60 &  ABOVE,69742,37974,31766,2,54408,29634,24772,2,15334,8340,6994,
PAKPATTAN,PAKPATTAN,TEHSIL,65 &  ABOVE,44641,24410,20231,,34978,19199,15779,,9663,5211,4452,
RAHIM YAR KHAN,RAHIM YAR KHAN,DISTRICT,ALL AGES,5561720,2895390,2665779,551,4221634,2202377,2019061,196,1340086,693013,646718,355
RAHIM YAR KHAN,RAHIM YAR KHAN,DISTRICT,UNDER 1,130949,69354,61595,,100725,53342,47383,,30224,16012,14212,
RAHIM YAR KHAN,RAHIM YAR KHAN,DISTRICT,UNDER 5,884206,461982,422224,,695373,363166,332207,,188833,98816,90017,
RAHIM YAR KHAN,RAHIM YAR KHAN,DISTRICT,UNDER 10,1684241,880672,803569,,1326488,694238,632250,,357753,186434,171319,
RAHIM YAR KHAN,RAHIM YAR KHAN,DISTRICT,UNDER 15,2359967,1242553,1117405,9,1842525,971092,871430,3,517442,271461,245975,6
RAHIM YAR KHAN,RAHIM YAR KHAN,DISTRICT,05 - 24,2485728,1306286,1179290,152,1901974,1002019,899889,66,583754,304267,279401,86
RAHIM YAR KHAN,RAHIM YAR KHAN,DISTRICT,15 - 49,2578530,1322985,1255055,490,1915680,986333,929173,174,662850,336652,325882,316
RAHIM YAR KHAN,RAHIM YAR KHAN,DISTRICT,15 - 64,3009501,1550121,1458853,527,2232425,1152955,1079283,187,777076,397166,379570,340
RAHIM YAR KHAN,RAHIM YAR KHAN,DISTRICT,18 - 60,2596894,1330017,1266380,497,1924378,988444,935770,164,672516,341573,330610,333
RAHIM YAR KHAN,RAHIM YAR KHAN,DISTRICT,18 &  ABOVE,2871487,1476291,1394678,518,2131280,1098387,1032720,173,740207,377904,361958,345
RAHIM YAR KHAN,RAHIM YAR KHAN,DISTRICT,60 &  ABOVE,302147,160224,141895,28,227689,120411,107268,10,74458,39813,34627,18
RAHIM YAR KHAN,RAHIM YAR KHAN,DISTRICT,65 &  ABOVE,192252,102716,89521,15,146684,78330,68348,6,45568,24386,21173,9
KHANPUR,RAHIM YAR KHAN,TEHSIL,ALL AGES,1168885,609177,559578,130,844878,440383,404471,24,324007,168794,155107,106
KHANPUR,RAHIM YAR KHAN,TEHSIL,UNDER 1,33079,18061,15018,,25009,13660,11349,,8070,4401,3669,
KHANPUR,RAHIM YAR KHAN,TEHSIL,UNDER 5,197199,105143,92056,,145839,77643,68196,,51360,27500,23860,
KHANPUR,RAHIM YAR KHAN,TEHSIL,UNDER 10,359756,190597,169159,,266175,140966,125209,,93581,49631,43950,
KHANPUR,RAHIM YAR KHAN,TEHSIL,UNDER 15,497869,264371,233494,4,366501,194637,171863,1,131368,69734,61631,3
KHANPUR,RAHIM YAR KHAN,TEHSIL,05 - 24,509470,267714,241719,37,370205,194656,175541,8,139265,73058,66178,29
KHANPUR,RAHIM YAR KHAN,TEHSIL,15 - 49,533552,272643,260792,117,379793,194185,185586,22,153759,78458,75206,95
KHANPUR,RAHIM YAR KHAN,TEHSIL,15 - 64,626564,321507,304932,125,445715,228624,217068,23,180849,92883,87864,102
KHANPUR,RAHIM YAR KHAN,TEHSIL,18 - 60,540141,275841,264182,118,383900,196153,187728,19,156241,79688,76454,99
KHANPUR,RAHIM YAR KHAN,TEHSIL,18 &  ABOVE,602410,308463,293827,120,429159,219756,209384,19,173251,88707,84443,101
KHANPUR,RAHIM YAR KHAN,TEHSIL,60 &  ABOVE,67912,35528,32378,6,49367,25718,23649,,18545,9810,8729,6
KHANPUR,RAHIM YAR KHAN,TEHSIL,65 &  ABOVE,44452,23299,21152,1,32662,17122,15540,,11790,6177,5612,1
LIAQUAT PUR,RAHIM YAR KHAN,TEHSIL,ALL AGES,1234974,643268,591510,196,1132382,590110,542147,125,102592,53158,49363,71
LIAQUAT PUR,RAHIM YAR KHAN,TEHSIL,UNDER 1,29013,15149,13864,,26929,14051,12878,,2084,1098,986,
LIAQUAT PUR,RAHIM YAR KHAN,TEHSIL,UNDER 5,209469,109417,100052,,194465,101509,92956,,15004,7908,7096,
LIAQUAT PUR,RAHIM YAR KHAN,TEHSIL,UNDER 10,395383,206976,188407,,366648,192001,174647,,28735,14975,13760,
LIAQUAT PUR,RAHIM YAR KHAN,TEHSIL,UNDER 15,547455,288745,258707,3,506001,266981,239018,2,41454,21764,19689,1
LIAQUAT PUR,RAHIM YAR KHAN,TEHSIL,05 - 24,555050,292373,262617,60,509631,268817,240770,44,45419,23556,21847,16
LIAQUAT PUR,RAHIM YAR KHAN,TEHSIL,15 - 49,550366,282514,267671,181,500805,257350,243339,116,49561,25164,24332,65
LIAQUAT PUR,RAHIM YAR KHAN,TEHSIL,15 - 64,643230,331075,311964,191,585500,301519,283858,123,57730,29556,28106,68
LIAQUAT PUR,RAHIM YAR KHAN,TEHSIL,18 - 60,552275,282597,269499,179,502601,257252,245237,112,49674,25345,24262,67
LIAQUAT PUR,RAHIM YAR KHAN,TEHSIL,18 &  ABOVE,614449,315333,298932,184,559807,287314,272379,114,54642,28019,26553,70
LIAQUAT PUR,RAHIM YAR KHAN,TEHSIL,60 &  ABOVE,68419,35805,32609,5,62931,32864,30065,2,5488,2941,2544,3
LIAQUAT PUR,RAHIM YAR KHAN,TEHSIL,65 &  ABOVE,44289,23448,20839,2,40881,21610,19271,,3408,1838,1568,2
RAHIM YAR KHAN,RAHIM YAR KHAN,TEHSIL,ALL AGES,1776665,923962,852544,159,1186749,618626,568094,29,589916,305336,284450,130
RAHIM YAR KHAN,RAHIM YAR KHAN,TEHSIL,UNDER 1,43580,23205,20375,,29671,15886,13785,,13909,7319,6590,
RAHIM YAR KHAN,RAHIM YAR KHAN,TEHSIL,UNDER 5,274041,143376,130665,,192507,101026,91481,,81534,42350,39184,
RAHIM YAR KHAN,RAHIM YAR KHAN,TEHSIL,UNDER 10,521153,272445,248708,,367520,192584,174936,,153633,79861,73772,
RAHIM YAR KHAN,RAHIM YAR KHAN,TEHSIL,UNDER 15,738104,388743,349360,1,513311,270730,242581,,224793,118013,106779,1
RAHIM YAR KHAN,RAHIM YAR KHAN,TEHSIL,05 - 24,794744,416839,377868,37,537022,281771,255247,4,257722,135068,122621,33
RAHIM YAR KHAN,RAHIM YAR KHAN,TEHSIL,15 - 49,839514,429320,410055,139,544495,279398,265075,22,295019,149922,144980,117
RAHIM YAR KHAN,RAHIM YAR KHAN,TEHSIL,15 - 64,979744,503350,476244,150,633858,326516,307316,26,345886,176834,168928,124
RAHIM YAR KHAN,RAHIM YAR KHAN,TEHSIL,18 - 60,845566,431532,413889,145,546388,279849,266516,23,299178,151683,147373,122
RAHIM YAR KHAN,RAHIM YAR KHAN,TEHSIL,18 &  ABOVE,931167,477886,453127,154,602802,310285,292490,27,328365,167601,160637,127
RAHIM YAR KHAN,RAHIM YAR KHAN,TEHSIL,60 &  ABOVE,94641,50933,43699,9,62411,33461,28946,4,32230,17472,14753,5
RAHIM YAR KHAN,RAHIM YAR KHAN,TEHSIL,65 &  ABOVE,58817,31869,26940,8,39580,21380,18197,3,19237,10489,8743,5
SADIQABAD,RAHIM YAR KHAN,TEHSIL,ALL AGES,1381196,718983,662147,66,1057625,553258,504349,18,323571,165725,157798,48
SADIQABAD,RAHIM YAR KHAN,TEHSIL,UNDER 1,25277,12939,12338,,19116,9745,9371,,6161,3194,2967,
SADIQABAD,RAHIM YAR KHAN,TEHSIL,UNDER 5,203497,104046,99451,,162562,82988,79574,,40935,21058,19877,
SADIQABAD,RAHIM YAR KHAN,TEHSIL,UNDER 10,407949,210654,197295,,326145,168687,157458,,81804,41967,39837,
SADIQABAD,RAHIM YAR KHAN,TEHSIL,UNDER 15,576539,300694,275844,1,456712,238744,217968,,119827,61950,57876,1
SADIQABAD,RAHIM YAR KHAN,TEHSIL,05 - 24,626464,329360,297086,18,485116,256775,228331,10,141348,72585,68755,8
SADIQABAD,RAHIM YAR KHAN,TEHSIL,15 - 49,655098,338508,316537,53,490587,255400,235173,14,164511,83108,81364,39
SADIQABAD,RAHIM YAR KHAN,TEHSIL,15 - 64,759963,394189,365713,61,567352,296296,271041,15,192611,97893,94672,46
SADIQABAD,RAHIM YAR KHAN,TEHSIL,18 - 60,658912,340047,318810,55,491489,255190,236289,10,167423,84857,82521,45
SADIQABAD,RAHIM YAR KHAN,TEHSIL,18 &  ABOVE,723461,374609,348792,60,539512,281032,258467,13,183949,93577,90325,47
SADIQABAD,RAHIM YAR KHAN,TEHSIL,60 &  ABOVE,71175,37958,33209,8,52980,28368,24608,4,18195,9590,8601,4
SADIQABAD,RAHIM YAR KHAN,TEHSIL,65 &  ABOVE,44694,24100,20590,4,33561,18218,15340,3,11133,5882,5250,1
RAJANPUR,RAJANPUR,DISTRICT,ALL AGES,2323980,1181789,1142073,118,1694281,865366,828896,19,629699,316423,313177,99
RAJANPUR,RAJANPUR,DISTRICT,UNDER 1,54793,27850,26943,,40742,20644,20098,,14051,7206,6845,
RAJANPUR,RAJANPUR,DISTRICT,UNDER 5,432259,218124,214135,,329056,166282,162774,,103203,51842,51361,
RAJANPUR,RAJANPUR,DISTRICT,UNDER 10,816895,412984,403911,,624037,316534,307503,,192858,96450,96408,
RAJANPUR,RAJANPUR,DISTRICT,UNDER 15,1120165,567502,552657,6,847719,431389,416327,3,272446,136113,136330,3
RAJANPUR,RAJANPUR,DISTRICT,05 - 24,1090832,553299,537497,36,803798,410980,392807,11,287034,142319,144690,25
RAJANPUR,RAJANPUR,DISTRICT,15 - 49,983689,497080,486505,104,691190,350814,340362,14,292499,146266,146143,90
RAJANPUR,RAJANPUR,DISTRICT,15 - 64,1133821,576911,556799,111,796066,406696,389354,16,337755,170215,167445,95
RAJANPUR,RAJANPUR,DISTRICT,18 - 60,967146,489887,477158,101,677989,344252,333727,10,289157,145635,143431,91
RAJANPUR,RAJANPUR,DISTRICT,18 &  ABOVE,1065405,542416,522886,103,748073,382021,366042,10,317332,160395,156844,93
RAJANPUR,RAJANPUR,DISTRICT,60 &  ABOVE,108053,57701,50349,3,77145,41543,35601,1,30908,16158,14748,2
RAJANPUR,RAJANPUR,DISTRICT,65 &  ABOVE,69994,37376,32617,1,50496,27281,23215,,19498,10095,9402,1
RAJANPUR,RAJANPUR,DE-EXCLUDED_AREA,ALL AGES,41741,22156,19585,,41741,22156,19585,,,,,
RAJANPUR,RAJANPUR,DE-EXCLUDED_AREA,UNDER 1,968,496,472,,968,496,472,,,,,
RAJANPUR,RAJANPUR,DE-EXCLUDED_AREA,UNDER 5,9956,5058,4898,,9956,5058,4898,,,,,
RAJANPUR,RAJANPUR,DE-EXCLUDED_AREA,UNDER 10,17867,9224,8643,,17867,9224,8643,,,,,
RAJANPUR,RAJANPUR,DE-EXCLUDED_AREA,UNDER 15,22946,12030,10916,,22946,12030,10916,,,,,
RAJANPUR,RAJANPUR,DE-EXCLUDED_AREA,05 - 24,18259,10023,8236,,18259,10023,8236,,,,,
RAJANPUR,RAJANPUR,DE-EXCLUDED_AREA,15 - 49,15230,8082,7148,,15230,8082,7148,,,,,
RAJANPUR,RAJANPUR,DE-EXCLUDED_AREA,15 - 64,17687,9430,8257,,17687,9430,8257,,,,,
RAJANPUR,RAJANPUR,DE-EXCLUDED_AREA,18 - 60,15529,8047,7482,,15529,8047,7482,,,,,
RAJANPUR,RAJANPUR,DE-EXCLUDED_AREA,18 &  ABOVE,17070,8991,8079,,17070,8991,8079,,,,,
RAJANPUR,RAJANPUR,DE-EXCLUDED_AREA,60 &  ABOVE,1765,1057,708,,1765,1057,708,,,,,
RAJANPUR,RAJANPUR,DE-EXCLUDED_AREA,65 &  ABOVE,1108,696,412,,1108,696,412,,,,,
JAMPUR,RAJANPUR,TEHSIL,ALL AGES,1011499,509507,501912,80,706867,356480,350384,3,304632,153027,151528,77
JAMPUR,RAJANPUR,TEHSIL,UNDER 1,23697,12099,11598,,16348,8267,8081,,7349,3832,3517,
JAMPUR,RAJANPUR,TEHSIL,UNDER 5,184458,92048,92410,,131977,65447,66530,,52481,26601,25880,
JAMPUR,RAJANPUR,TEHSIL,UNDER 10,345625,173095,172530,,249967,124886,125081,,95658,48209,47449,
JAMPUR,RAJANPUR,TEHSIL,UNDER 15,476927,239326,237598,3,343743,172455,171288,,133184,66871,66310,3
JAMPUR,RAJANPUR,TEHSIL,05 - 24,472994,237390,235582,22,335452,169286,166165,1,137542,68104,69417,21
JAMPUR,RAJANPUR,TEHSIL,15 - 49,435948,218098,217777,73,295598,148285,147310,3,140350,69813,70467,70
JAMPUR,RAJANPUR,TEHSIL,15 - 64,502915,253629,249210,76,340861,172313,168545,3,162054,81316,80665,73
JAMPUR,RAJANPUR,TEHSIL,18 - 60,429158,215927,213159,72,289992,146095,143895,2,139166,69832,69264,70
JAMPUR,RAJANPUR,TEHSIL,18 &  ABOVE,473316,239135,234108,73,320718,162299,158417,2,152598,76836,75691,71
JAMPUR,RAJANPUR,TEHSIL,60 &  ABOVE,48375,25432,22942,1,33618,17724,15894,,14757,7708,7048,1
JAMPUR,RAJANPUR,TEHSIL,65 &  ABOVE,31657,16552,15104,1,22263,11712,10551,,9394,4840,4553,1
RAJANPUR,RAJANPUR,TEHSIL,ALL AGES,851729,430020,421677,32,542533,274636,267887,10,309196,155384,153790,22
RAJANPUR,RAJANPUR,TEHSIL,UNDER 1,18911,9507,9404,,12612,6324,6288,,6299,3183,3116,
RAJANPUR,RAJANPUR,TEHSIL,UNDER 5,141932,70492,71440,,94299,46761,47538,,47633,23731,23902,
RAJANPUR,RAJANPUR,TEHSIL,UNDER 10,278807,138814,139993,,186700,93049,93651,,92107,45765,46342,
RAJANPUR,RAJANPUR,TEHSIL,UNDER 15,391197,194970,196225,2,258827,129098,129727,2,132370,65872,66498,
RAJANPUR,RAJANPUR,TEHSIL,05 - 24,403123,201996,201116,11,260272,131059,129206,7,142851,70937,71910,4
RAJANPUR,RAJANPUR,TEHSIL,15 - 49,375907,190205,185675,27,231117,117560,113550,7,144790,72645,72125,20
RAJANPUR,RAJANPUR,TEHSIL,15 - 64,433679,220758,212891,30,266509,136283,130218,8,167170,84475,82673,22
RAJANPUR,RAJANPUR,TEHSIL,18 - 60,368546,187321,181201,24,225821,115307,110511,3,142725,72014,70690,21
RAJANPUR,RAJANPUR,TEHSIL,18 &  ABOVE,406409,207508,198876,25,249607,128074,121530,3,156802,79434,77346,22
RAJANPUR,RAJANPUR,TEHSIL,60 &  ABOVE,41626,22131,19494,1,26202,14047,12155,,15424,8084,7339,1
RAJANPUR,RAJANPUR,TEHSIL,65 &  ABOVE,26853,14292,12561,,17197,9255,7942,,9656,5037,4619,
ROJHAN,RAJANPUR,TEHSIL,ALL AGES,419011,220106,198899,6,403140,212094,191040,6,15871,8012,7859,
ROJHAN,RAJANPUR,TEHSIL,UNDER 1,11217,5748,5469,,10814,5557,5257,,403,191,212,
ROJHAN,RAJANPUR,TEHSIL,UNDER 5,95913,50526,45387,,92824,49016,43808,,3089,1510,1579,
ROJHAN,RAJANPUR,TEHSIL,UNDER 10,174596,91851,82745,,169503,89375,80128,,5093,2476,2617,
ROJHAN,RAJANPUR,TEHSIL,UNDER 15,229095,121176,107918,1,222203,117806,104396,1,6892,3370,3522,
ROJHAN,RAJANPUR,TEHSIL,05 - 24,196456,103890,92563,3,189815,100612,89200,3,6641,3278,3363,
ROJHAN,RAJANPUR,TEHSIL,15 - 49,156604,80695,75905,4,149245,76887,72354,4,7359,3808,3551,
ROJHAN,RAJANPUR,TEHSIL,15 - 64,179540,93094,86441,5,171009,88670,82334,5,8531,4424,4107,
ROJHAN,RAJANPUR,TEHSIL,18 - 60,153913,78592,75316,5,146647,74803,71839,5,7266,3789,3477,
ROJHAN,RAJANPUR,TEHSIL,18 &  ABOVE,168610,86782,81823,5,160678,82657,78016,5,7932,4125,3807,
ROJHAN,RAJANPUR,TEHSIL,60 &  ABOVE,16287,9081,7205,1,15560,8715,6844,1,727,366,361,
ROJHAN,RAJANPUR,TEHSIL,65 &  ABOVE,10376,5836,4540,,9928,5618,4310,,448,218,230,
RAWALPINDI,RAWALPINDI,DISTRICT,ALL AGES,6058540,3080830,2976366,1344,1907111,940438,966634,39,4151429,2140392,2009732,1305
RAWALPINDI,RAWALPINDI,DISTRICT,UNDER 1,99994,49826,50168,,31931,15860,16071,,68063,33966,34097,
RAWALPINDI,RAWALPINDI,DISTRICT,UNDER 5,720719,360954,359765,,219302,108954,110348,,501417,252000,249417,
RAWALPINDI,RAWALPINDI,DISTRICT,UNDER 10,1361599,681771,679828,,420937,208760,212177,,940662,473011,467651,
RAWALPINDI,RAWALPINDI,DISTRICT,UNDER 15,2018679,1011168,1007498,13,623233,308625,314608,,1395446,702543,692890,13
RAWALPINDI,RAWALPINDI,DISTRICT,05 - 24,2402521,1205837,1196404,280,737240,361592,375639,9,1665281,844245,820765,271
RAWALPINDI,RAWALPINDI,DISTRICT,15 - 49,3155573,1594656,1559679,1238,964074,468354,495690,30,2191499,1126302,1063989,1208
RAWALPINDI,RAWALPINDI,DISTRICT,15 - 64,3758078,1915938,1840828,1312,1168594,572163,596396,35,2589484,1343775,1244432,1277
RAWALPINDI,RAWALPINDI,DISTRICT,18 - 60,3277665,1668399,1607984,1282,1014446,495030,519384,32,2263219,1173369,1088600,1250
RAWALPINDI,RAWALPINDI,DISTRICT,18 &  ABOVE,3683757,1890616,1791838,1303,1174248,578190,596022,36,2509509,1312426,1195816,1267
RAWALPINDI,RAWALPINDI,DISTRICT,60 &  ABOVE,444786,242386,202370,30,173222,89948,83270,4,271564,152438,119100,26
RAWALPINDI,RAWALPINDI,DISTRICT,65 &  ABOVE,281783,153724,128040,19,115284,59650,55630,4,166499,94074,72410,15
GUJAR KHAN,RAWALPINDI,TEHSIL,ALL AGES,781578,382935,398536,107,651057,318294,332748,15,130521,64641,65788,92
GUJAR KHAN,RAWALPINDI,TEHSIL,UNDER 1,13774,6722,7052,,11178,5459,5719,,2596,1263,1333,
GUJAR KHAN,RAWALPINDI,TEHSIL,UNDER 5,90299,44402,45897,,73730,36280,37450,,16569,8122,8447,
GUJAR KHAN,RAWALPINDI,TEHSIL,UNDER 10,170443,83995,86448,,139743,68844,70899,,30700,15151,15549,
GUJAR KHAN,RAWALPINDI,TEHSIL,UNDER 15,252808,124751,128056,1,207302,102157,105145,,45506,22594,22911,1
GUJAR KHAN,RAWALPINDI,TEHSIL,05 - 24,302002,147847,154111,44,248306,121246,127054,6,53696,26601,27057,38
GUJAR KHAN,RAWALPINDI,TEHSIL,15 - 49,395975,190799,205071,105,329322,158328,170980,14,66653,32471,34091,91
GUJAR KHAN,RAWALPINDI,TEHSIL,15 - 64,480183,233156,246922,105,401077,194265,206798,14,79106,38891,40124,91
GUJAR KHAN,RAWALPINDI,TEHSIL,18 - 60,417022,201628,215294,100,348611,168138,180461,12,68411,33490,34833,88
GUJAR KHAN,RAWALPINDI,TEHSIL,18 &  ABOVE,483601,236065,247435,101,406745,198065,208667,13,76856,38000,38768,88
GUJAR KHAN,RAWALPINDI,TEHSIL,60 &  ABOVE,72454,37291,35162,1,63173,32370,30802,1,9281,4921,4360,
GUJAR KHAN,RAWALPINDI,TEHSIL,65 &  ABOVE,48587,25028,23558,1,42678,21872,20805,1,5909,3156,2753,
KAHUTA,RAWALPINDI,TEHSIL,ALL AGES,237843,114959,122882,2,162494,77884,84609,1,75349,37075,38273,1
KAHUTA,RAWALPINDI,TEHSIL,UNDER 1,3762,1840,1922,,2546,1246,1300,,1216,594,622,
KAHUTA,RAWALPINDI,TEHSIL,UNDER 5,25829,12749,13080,,17511,8661,8850,,8318,4088,4230,
KAHUTA,RAWALPINDI,TEHSIL,UNDER 10,50310,24942,25368,,33750,16711,17039,,16560,8231,8329,
KAHUTA,RAWALPINDI,TEHSIL,UNDER 15,74938,37038,37900,,50107,24668,25439,,24831,12370,12461,
KAHUTA,RAWALPINDI,TEHSIL,05 - 24,90878,44297,46581,,60802,29424,31378,,30076,14873,15203,
KAHUTA,RAWALPINDI,TEHSIL,15 - 49,120549,56650,63897,2,81547,38028,43518,1,39002,18622,20379,1
KAHUTA,RAWALPINDI,TEHSIL,15 - 64,147658,70245,77411,2,100749,47404,53344,1,46909,22841,24067,1
KAHUTA,RAWALPINDI,TEHSIL,18 - 60,127865,60506,67357,2,87190,40807,46382,1,40675,19699,20975,1
KAHUTA,RAWALPINDI,TEHSIL,18 &  ABOVE,149185,71329,77854,2,103248,48869,54378,1,45937,22460,23476,1
KAHUTA,RAWALPINDI,TEHSIL,60 &  ABOVE,22959,11643,11316,,17269,8665,8604,,5690,2978,2712,
KAHUTA,RAWALPINDI,TEHSIL,65 &  ABOVE,15247,7676,7571,,11638,5812,5826,,3609,1864,1745,
KALLAR SAYADDAN,RAWALPINDI,TEHSIL,ALL AGES,242709,116434,126259,16,181768,87150,94610,8,60941,29284,31649,8
KALLAR SAYADDAN,RAWALPINDI,TEHSIL,UNDER 1,3959,1942,2017,,2875,1419,1456,,1084,523,561,
KALLAR SAYADDAN,RAWALPINDI,TEHSIL,UNDER 5,26372,13026,13346,,19329,9588,9741,,7043,3438,3605,
KALLAR SAYADDAN,RAWALPINDI,TEHSIL,UNDER 10,50990,25336,25654,,37689,18775,18914,,13301,6561,6740,
KALLAR SAYADDAN,RAWALPINDI,TEHSIL,UNDER 15,76387,37953,38434,,56798,28319,28479,,19589,9634,9955,
KALLAR SAYADDAN,RAWALPINDI,TEHSIL,05 - 24,92902,45340,47559,3,69444,33897,35546,1,23458,11443,12013,2
KALLAR SAYADDAN,RAWALPINDI,TEHSIL,15 - 49,121871,56497,65364,10,90965,42066,48894,5,30906,14431,16470,5
KALLAR SAYADDAN,RAWALPINDI,TEHSIL,15 - 64,149447,70047,79385,15,111926,52361,59557,8,37521,17686,19828,7
KALLAR SAYADDAN,RAWALPINDI,TEHSIL,18 - 60,129530,60182,69334,14,96852,44904,51941,7,32678,15278,17393,7
KALLAR SAYADDAN,RAWALPINDI,TEHSIL,18 &  ABOVE,152507,71770,80722,15,114559,53787,60765,7,37948,17983,19957,8
KALLAR SAYADDAN,RAWALPINDI,TEHSIL,60 &  ABOVE,24612,12400,12210,2,18936,9498,9438,,5676,2902,2772,2
KALLAR SAYADDAN,RAWALPINDI,TEHSIL,65 &  ABOVE,16875,8434,8440,1,13044,6470,6574,,3831,1964,1866,1
KOTLI SATTIAN,RAWALPINDI,TEHSIL,ALL AGES,120421,60975,59446,,96878,49169,47709,,23543,11806,11737,
KOTLI SATTIAN,RAWALPINDI,TEHSIL,UNDER 1,2375,1218,1157,,2005,1040,965,,370,178,192,
KOTLI SATTIAN,RAWALPINDI,TEHSIL,UNDER 5,14778,7473,7305,,12192,6219,5973,,2586,1254,1332,
KOTLI SATTIAN,RAWALPINDI,TEHSIL,UNDER 10,27121,13574,13547,,22009,11062,10947,,5112,2512,2600,
KOTLI SATTIAN,RAWALPINDI,TEHSIL,UNDER 15,39523,19622,19901,,31843,15835,16008,,7680,3787,3893,
KOTLI SATTIAN,RAWALPINDI,TEHSIL,05 - 24,45073,22230,22843,,36026,17741,18285,,9047,4489,4558,
KOTLI SATTIAN,RAWALPINDI,TEHSIL,15 - 49,61273,31284,29989,,49268,25212,24056,,12005,6072,5933,
KOTLI SATTIAN,RAWALPINDI,TEHSIL,15 - 64,74235,37922,36313,,59736,30561,29175,,14499,7361,7138,
KOTLI SATTIAN,RAWALPINDI,TEHSIL,18 - 60,64337,32958,31379,,51804,26578,25226,,12533,6380,6153,
KOTLI SATTIAN,RAWALPINDI,TEHSIL,18 &  ABOVE,73937,37935,36002,,59499,30606,28893,,14438,7329,7109,
KOTLI SATTIAN,RAWALPINDI,TEHSIL,60 &  ABOVE,10332,5380,4952,,8280,4342,3938,,2052,1038,1014,
KOTLI SATTIAN,RAWALPINDI,TEHSIL,65 &  ABOVE,6663,3431,3232,,5299,2773,2526,,1364,658,706,
MURREE,RAWALPINDI,TEHSIL,ALL AGES,249410,125100,124309,1,227340,113391,113948,1,22070,11709,10361,
MURREE,RAWALPINDI,TEHSIL,UNDER 1,4191,2158,2033,,3831,1958,1873,,360,200,160,
MURREE,RAWALPINDI,TEHSIL,UNDER 5,27522,13679,13843,,25168,12517,12651,,2354,1162,1192,
MURREE,RAWALPINDI,TEHSIL,UNDER 10,54942,27000,27942,,49933,24490,25443,,5009,2510,2499,
MURREE,RAWALPINDI,TEHSIL,UNDER 15,82621,40744,41877,,74924,36830,38094,,7697,3914,3783,
MURREE,RAWALPINDI,TEHSIL,05 - 24,97255,47717,49538,,88164,43022,45142,,9091,4695,4396,
MURREE,RAWALPINDI,TEHSIL,15 - 49,127633,63645,63987,1,115851,57371,58479,1,11782,6274,5508,
MURREE,RAWALPINDI,TEHSIL,15 - 64,153842,77609,76232,1,140137,70182,69954,1,13705,7427,6278,
MURREE,RAWALPINDI,TEHSIL,18 - 60,133680,67428,66251,1,121602,60856,60745,1,12078,6572,5506,
MURREE,RAWALPINDI,TEHSIL,18 &  ABOVE,152155,77117,75037,1,139091,69999,69091,1,13064,7118,5946,
MURREE,RAWALPINDI,TEHSIL,60 &  ABOVE,20004,10527,9477,,18897,9912,8985,,1107,615,492,
MURREE,RAWALPINDI,TEHSIL,65 &  ABOVE,12947,6747,6200,,12279,6379,5900,,668,368,300,
RAWALPINDI,RAWALPINDI,TEHSIL,ALL AGES,3689775,1907123,1781476,1176,386054,192101,193942,11,3303721,1715022,1587534,1165
RAWALPINDI,RAWALPINDI,TEHSIL,UNDER 1,60245,30164,30081,,6291,3097,3194,,53954,27067,26887,
RAWALPINDI,RAWALPINDI,TEHSIL,UNDER 5,450755,227097,223658,,46577,23239,23338,,404178,203858,200320,
RAWALPINDI,RAWALPINDI,TEHSIL,UNDER 10,843535,424817,418718,,89612,44620,44992,,753923,380197,373726,
RAWALPINDI,RAWALPINDI,TEHSIL,UNDER 15,1244384,627231,617141,12,131216,65085,66131,,1113168,562146,551010,12
RAWALPINDI,RAWALPINDI,TEHSIL,05 - 24,1476389,749597,726572,220,152390,75023,77366,1,1323999,674574,649206,219
RAWALPINDI,RAWALPINDI,TEHSIL,15 - 49,1944903,1004480,939342,1081,193982,95636,98340,6,1750921,908844,841002,1075
RAWALPINDI,RAWALPINDI,TEHSIL,15 - 64,2295436,1195177,1099110,1149,232954,115559,117387,8,2062482,1079618,981723,1141
RAWALPINDI,RAWALPINDI,TEHSIL,18 - 60,2007376,1044602,961648,1126,202098,100015,102075,8,1805278,944587,859573,1118
RAWALPINDI,RAWALPINDI,TEHSIL,18 &  ABOVE,2228350,1169320,1057887,1143,232301,115949,116341,11,1996049,1053371,941546,1132
RAWALPINDI,RAWALPINDI,TEHSIL,60 &  ABOVE,243825,136848,106952,25,32830,17293,15534,3,210995,119555,91418,22
RAWALPINDI,RAWALPINDI,TEHSIL,65 &  ABOVE,149955,84715,65225,15,21884,11457,10424,3,128071,73258,54801,12
TAXILA,RAWALPINDI,TEHSIL,ALL AGES,736804,373304,363458,42,201520,102449,99068,3,535284,270855,264390,39
TAXILA,RAWALPINDI,TEHSIL,UNDER 1,11688,5782,5906,,3205,1641,1564,,8483,4141,4342,
TAXILA,RAWALPINDI,TEHSIL,UNDER 5,85164,42528,42636,,24795,12450,12345,,60369,30078,30291,
TAXILA,RAWALPINDI,TEHSIL,UNDER 10,164258,82107,82151,,48201,24258,23943,,116057,57849,58208,
TAXILA,RAWALPINDI,TEHSIL,UNDER 15,248018,123829,124189,,71043,35731,35312,,176975,88098,88877,
TAXILA,RAWALPINDI,TEHSIL,05 - 24,298022,148809,149200,13,82108,41239,40868,1,215914,107570,108332,12
TAXILA,RAWALPINDI,TEHSIL,15 - 49,383369,191301,192029,39,103139,51713,51423,3,280230,139588,140606,36
TAXILA,RAWALPINDI,TEHSIL,15 - 64,457277,231782,225455,40,122015,61831,60181,3,335262,169951,165274,37
TAXILA,RAWALPINDI,TEHSIL,18 - 60,397855,201095,196721,39,106289,53732,52554,3,291566,147363,144167,36
TAXILA,RAWALPINDI,TEHSIL,18 &  ABOVE,444022,227080,216901,41,118805,60915,57887,3,325217,166165,159014,38
TAXILA,RAWALPINDI,TEHSIL,60 &  ABOVE,50600,28297,22301,2,13837,7868,5969,,36763,20429,16332,2
TAXILA,RAWALPINDI,TEHSIL,65 &  ABOVE,31509,17693,13814,2,8462,4887,3575,,23047,12806,10239,2
SAHIWAL,SAHIWAL,DISTRICT,ALL AGES,2878122,1458981,1418988,153,2124128,1077060,1046981,87,753994,381921,372007,66
SAHIWAL,SAHIWAL,DISTRICT,UNDER 1,76287,39199,37088,,57884,29935,27949,,18403,9264,9139,
SAHIWAL,SAHIWAL,DISTRICT,UNDER 5,423460,213805,209655,,319596,161542,158054,,103864,52263,51601,
SAHIWAL,SAHIWAL,DISTRICT,UNDER 10,772183,389221,382962,,583848,294971,288877,,188335,94250,94085,
SAHIWAL,SAHIWAL,DISTRICT,UNDER 15,1095044,552226,542809,9,821692,414752,406934,6,273352,137474,135875,3
SAHIWAL,SAHIWAL,DISTRICT,05 - 24,1177306,592907,584357,42,871657,438969,432661,27,305649,153938,151696,15
SAHIWAL,SAHIWAL,DISTRICT,15 - 49,1388059,695369,692573,117,1008770,505454,503253,63,379289,189915,189320,54
SAHIWAL,SAHIWAL,DISTRICT,15 - 64,1660566,839776,820653,137,1208412,610975,597362,75,452154,228801,223291,62
SAHIWAL,SAHIWAL,DISTRICT,18 - 60,1435549,723415,712006,128,1043256,525897,517293,66,392293,197518,194713,62
SAHIWAL,SAHIWAL,DISTRICT,18 &  ABOVE,1615324,821275,793913,136,1179885,600064,579748,73,435439,221211,214165,63
SAHIWAL,SAHIWAL,DISTRICT,60 &  ABOVE,195906,106546,89349,11,148532,80600,67923,9,47374,25946,21426,2
SAHIWAL,SAHIWAL,DISTRICT,65 &  ABOVE,122512,66979,55526,7,94024,51333,42685,6,28488,15646,12841,1
CHICHAWATNI,SAHIWAL,TEHSIL,ALL AGES,1155978,582558,573354,66,1043787,525774,517963,50,112191,56784,55391,16
CHICHAWATNI,SAHIWAL,TEHSIL,UNDER 1,27308,13960,13348,,25332,12954,12378,,1976,1006,970,
CHICHAWATNI,SAHIWAL,TEHSIL,UNDER 5,163197,81801,81396,,150466,75477,74989,,12731,6324,6407,
CHICHAWATNI,SAHIWAL,TEHSIL,UNDER 10,302538,151654,150884,,277592,139331,138261,,24946,12323,12623,
CHICHAWATNI,SAHIWAL,TEHSIL,UNDER 15,431974,216936,215033,5,393617,197600,196013,4,38357,19336,19020,1
CHICHAWATNI,SAHIWAL,TEHSIL,05 - 24,470911,236324,234570,17,424108,212549,211547,12,46803,23775,23023,5
CHICHAWATNI,SAHIWAL,TEHSIL,15 - 49,559258,278115,281094,49,501039,249087,251917,35,58219,29028,29177,14
CHICHAWATNI,SAHIWAL,TEHSIL,15 - 64,672217,337609,334550,58,602763,302550,300170,43,69454,35059,34380,15
CHICHAWATNI,SAHIWAL,TEHSIL,18 - 60,580900,290792,290053,55,520983,260739,260204,40,59917,30053,29849,15
CHICHAWATNI,SAHIWAL,TEHSIL,18 &  ABOVE,656814,331710,325045,59,590288,298033,292211,44,66526,33677,32834,15
CHICHAWATNI,SAHIWAL,TEHSIL,60 &  ABOVE,82409,44407,37996,6,75123,40431,34686,6,7286,3976,3310,
CHICHAWATNI,SAHIWAL,TEHSIL,65 &  ABOVE,51787,28013,23771,3,47407,25624,21780,3,4380,2389,1991,
SAHIWAL,SAHIWAL,TEHSIL,ALL AGES,1722144,876423,845634,87,1080341,551286,529018,37,641803,325137,316616,50
SAHIWAL,SAHIWAL,TEHSIL,UNDER 1,48979,25239,23740,,32552,16981,15571,,16427,8258,8169,
SAHIWAL,SAHIWAL,TEHSIL,UNDER 5,260263,132004,128259,,169130,86065,83065,,91133,45939,45194,
SAHIWAL,SAHIWAL,TEHSIL,UNDER 10,469645,237567,232078,,306256,155640,150616,,163389,81927,81462,
SAHIWAL,SAHIWAL,TEHSIL,UNDER 15,663070,335290,327776,4,428075,217152,210921,2,234995,118138,116855,2
SAHIWAL,SAHIWAL,TEHSIL,05 - 24,706395,356583,349787,25,447549,226420,221114,15,258846,130163,128673,10
SAHIWAL,SAHIWAL,TEHSIL,15 - 49,828801,417254,411479,68,507731,256367,251336,28,321070,160887,160143,40
SAHIWAL,SAHIWAL,TEHSIL,15 - 64,988349,502167,486103,79,605649,308425,297192,32,382700,193742,188911,47
SAHIWAL,SAHIWAL,TEHSIL,18 - 60,854649,432623,421953,73,522273,265158,257089,26,332376,167465,164864,47
SAHIWAL,SAHIWAL,TEHSIL,18 &  ABOVE,958510,489565,468868,77,589597,302031,287537,29,368913,187534,181331,48
SAHIWAL,SAHIWAL,TEHSIL,60 &  ABOVE,113497,62139,51353,5,73409,40169,33237,3,40088,21970,18116,2
SAHIWAL,SAHIWAL,TEHSIL,65 &  ABOVE,70725,38966,31755,4,46617,25709,20905,3,24108,13257,10850,1
SARGODHA,SARGODHA,DISTRICT,ALL AGES,4327263,2190707,2136175,381,2722559,1378026,1344409,124,1604704,812681,791766,257
SARGODHA,SARGODHA,DISTRICT,UNDER 1,98484,49910,48574,,65880,33721,32159,,32604,16189,16415,
SARGODHA,SARGODHA,DISTRICT,UNDER 5,592348,297927,294421,,385381,194567,190814,,206967,103360,103607,
SARGODHA,SARGODHA,DISTRICT,UNDER 10,1089643,547438,542205,,706438,355595,350843,,383205,191843,191362,
SARGODHA,SARGODHA,DISTRICT,UNDER 15,1577387,792941,784440,6,1012129,508698,503426,5,565258,284243,281014,1
SARGODHA,SARGODHA,DISTRICT,05 - 24,1787958,897891,889943,124,1121169,561955,559168,46,666789,335936,330775,78
SARGODHA,SARGODHA,DISTRICT,15 - 49,2136588,1066000,1070251,337,1316276,656378,659788,110,820312,409622,410463,227
SARGODHA,SARGODHA,DISTRICT,15 - 64,2550022,1286693,1262962,367,1576368,794900,781350,118,973654,491793,481612,249
SARGODHA,SARGODHA,DISTRICT,18 - 60,2202854,1106610,1095899,345,1358975,682623,676242,110,843879,423987,419657,235
SARGODHA,SARGODHA,DISTRICT,18 &  ABOVE,2485801,1263840,1221604,357,1545408,785950,759346,112,940393,477890,462258,245
SARGODHA,SARGODHA,DISTRICT,60 &  ABOVE,310545,171843,138684,18,203871,112573,91292,6,106674,59270,47392,12
SARGODHA,SARGODHA,DISTRICT,65 &  ABOVE,199854,111073,88773,8,134062,74428,59633,1,65792,36645,29140,7
BHALWAL,SARGODHA,TEHSIL,ALL AGES,387194,191880,195290,24,243520,120656,122854,10,143674,71224,72436,14
BHALWAL,SARGODHA,TEHSIL,UNDER 1,7115,3450,3665,,4282,2089,2193,,2833,1361,1472,
BHALWAL,SARGODHA,TEHSIL,UNDER 5,45170,22052,23118,,28687,14000,14687,,16483,8052,8431,
BHALWAL,SARGODHA,TEHSIL,UNDER 10,89321,43932,45389,,56730,27765,28965,,32591,16167,16424,
BHALWAL,SARGODHA,TEHSIL,UNDER 15,133684,65716,67967,1,84514,41350,43163,1,49170,24366,24804,
BHALWAL,SARGODHA,TEHSIL,05 - 24,161694,79802,81886,6,101701,50013,51685,3,59993,29789,30201,3
BHALWAL,SARGODHA,TEHSIL,15 - 49,194914,94775,100122,17,120729,58753,61970,6,74185,36022,38152,11
BHALWAL,SARGODHA,TEHSIL,15 - 64,234244,115624,118597,23,145729,72038,73682,9,88515,43586,44915,14
BHALWAL,SARGODHA,TEHSIL,18 - 60,202128,99137,102970,21,125423,61648,63767,8,76705,37489,39203,13
BHALWAL,SARGODHA,TEHSIL,18 &  ABOVE,229348,114121,115204,23,143824,71786,72029,9,85524,42335,43175,14
BHALWAL,SARGODHA,TEHSIL,60 &  ABOVE,29666,16272,13390,4,19989,10979,9008,2,9677,5293,4382,2
BHALWAL,SARGODHA,TEHSIL,65 &  ABOVE,19266,10540,8726,,13277,7268,6009,,5989,3272,2717,
BHERA,SARGODHA,TEHSIL,ALL AGES,384395,193695,190687,13,272701,137510,135184,7,111694,56185,55503,6
BHERA,SARGODHA,TEHSIL,UNDER 1,6615,3372,3243,,4596,2428,2168,,2019,944,1075,
BHERA,SARGODHA,TEHSIL,UNDER 5,48287,24108,24179,,35354,17793,17561,,12933,6315,6618,
BHERA,SARGODHA,TEHSIL,UNDER 10,91852,46283,45569,,66594,33706,32888,,25258,12577,12681,
BHERA,SARGODHA,TEHSIL,UNDER 15,134917,67810,67106,1,97248,48919,48328,1,37669,18891,18778,
BHERA,SARGODHA,TEHSIL,05 - 24,159000,79541,79454,5,111809,55825,55980,4,47191,23716,23474,1
BHERA,SARGODHA,TEHSIL,15 - 49,190749,94030,96708,11,132782,65425,67351,6,57967,28605,29357,5
BHERA,SARGODHA,TEHSIL,15 - 64,229515,114572,114931,12,160585,80109,80470,6,68930,34463,34461,6
BHERA,SARGODHA,TEHSIL,18 - 60,197177,98141,99025,11,137886,68579,69301,6,59291,29562,29724,5
BHERA,SARGODHA,TEHSIL,18 &  ABOVE,225182,113882,111289,11,158495,80211,78278,6,66687,33671,33011,5
BHERA,SARGODHA,TEHSIL,60 &  ABOVE,30884,17243,13641,,22798,12795,10003,,8086,4448,3638,
BHERA,SARGODHA,TEHSIL,65 &  ABOVE,19963,11313,8650,,14868,8482,6386,,5095,2831,2264,
KOT MOMIN,SARGODHA,TEHSIL,ALL AGES,544165,278358,265772,35,480754,246048,234681,25,63411,32310,31091,10
KOT MOMIN,SARGODHA,TEHSIL,UNDER 1,15306,7939,7367,,13944,7245,6699,,1362,694,668,
KOT MOMIN,SARGODHA,TEHSIL,UNDER 5,81277,41501,39776,,72675,37118,35557,,8602,4383,4219,
KOT MOMIN,SARGODHA,TEHSIL,UNDER 10,148965,75807,73158,,132765,67578,65187,,16200,8229,7971,
KOT MOMIN,SARGODHA,TEHSIL,UNDER 15,212909,108189,104719,1,189127,96161,92965,1,23782,12028,11754,
KOT MOMIN,SARGODHA,TEHSIL,05 - 24,228789,115950,112830,9,201533,102195,99331,7,27256,13755,13499,2
KOT MOMIN,SARGODHA,TEHSIL,15 - 49,255350,128592,126728,30,224207,112945,111241,21,31143,15647,15487,9
KOT MOMIN,SARGODHA,TEHSIL,15 - 64,304271,155107,149131,33,267405,136334,131047,24,36866,18773,18084,9
KOT MOMIN,SARGODHA,TEHSIL,18 - 60,260921,132682,128209,30,229229,116586,112621,22,31692,16096,15588,8
KOT MOMIN,SARGODHA,TEHSIL,18 &  ABOVE,297533,153006,144496,31,262027,134828,127177,22,35506,18178,17319,9
KOT MOMIN,SARGODHA,TEHSIL,60 &  ABOVE,40284,22228,18052,4,36053,19932,16118,3,4231,2296,1934,1
KOT MOMIN,SARGODHA,TEHSIL,65 &  ABOVE,26985,15062,11922,1,24222,13553,10669,,2763,1509,1253,1
SAHIWAL,SARGODHA,TEHSIL,ALL AGES,407486,205839,201594,53,313408,158351,155013,44,94078,47488,46581,9
SAHIWAL,SARGODHA,TEHSIL,UNDER 1,12295,6328,5967,,9596,4987,4609,,2699,1341,1358,
SAHIWAL,SARGODHA,TEHSIL,UNDER 5,60844,30910,29934,,47550,24323,23227,,13294,6587,6707,
SAHIWAL,SARGODHA,TEHSIL,UNDER 10,107118,54139,52979,,83050,42069,40981,,24068,12070,11998,
SAHIWAL,SARGODHA,TEHSIL,UNDER 15,151496,76440,75055,1,116681,58866,57814,1,34815,17574,17241,
SAHIWAL,SARGODHA,TEHSIL,05 - 24,163727,82208,81498,21,124928,62631,62277,20,38799,19577,19221,1
SAHIWAL,SARGODHA,TEHSIL,15 - 49,197685,98248,99387,50,151391,75275,76074,42,46294,22973,23313,8
SAHIWAL,SARGODHA,TEHSIL,15 - 64,237446,119311,118084,51,181932,91397,90493,42,55514,27914,27591,9
SAHIWAL,SARGODHA,TEHSIL,18 - 60,205563,102827,102687,49,157699,78894,78765,40,47864,23933,23922,9
SAHIWAL,SARGODHA,TEHSIL,18 &  ABOVE,231684,117074,114560,50,178321,90139,88141,41,53363,26935,26419,9
SAHIWAL,SARGODHA,TEHSIL,60 &  ABOVE,28556,15569,12986,1,22431,12234,10196,1,6125,3335,2790,
SAHIWAL,SARGODHA,TEHSIL,65 &  ABOVE,18544,10088,8455,1,14795,8088,6706,1,3749,2000,1749,
SARGODHA,SARGODHA,TEHSIL,ALL AGES,1793400,910780,882383,237,742693,377503,365161,29,1050707,533277,517222,208
SARGODHA,SARGODHA,TEHSIL,UNDER 1,41725,21149,20576,,20567,10601,9966,,21158,10548,10610,
SARGODHA,SARGODHA,TEHSIL,UNDER 5,254629,128753,125876,,115778,59196,56582,,138851,69557,69294,
SARGODHA,SARGODHA,TEHSIL,UNDER 10,455063,229036,226027,,202476,102547,99929,,252587,126489,126098,
SARGODHA,SARGODHA,TEHSIL,UNDER 15,656324,331056,325266,2,284837,144010,140826,1,371487,187046,184440,1
SARGODHA,SARGODHA,TEHSIL,05 - 24,738907,371918,366912,77,303064,151895,151161,8,435843,220023,215751,69
SARGODHA,SARGODHA,TEHSIL,15 - 49,894740,448451,446075,214,356083,178589,177467,27,538657,269862,268608,187
SARGODHA,SARGODHA,TEHSIL,15 - 64,1061325,537456,523638,231,423705,214568,209109,28,637620,322888,314529,203
SARGODHA,SARGODHA,TEHSIL,18 - 60,919186,463177,455790,219,365773,184530,181218,25,553413,278647,274572,194
SARGODHA,SARGODHA,TEHSIL,18 &  ABOVE,1028906,524366,504315,225,413888,211157,202706,25,615018,313209,301609,200
SARGODHA,SARGODHA,TEHSIL,60 &  ABOVE,120835,67095,53733,7,52538,28978,23560,,68297,38117,30173,7
SARGODHA,SARGODHA,TEHSIL,65 &  ABOVE,75751,42268,33479,4,34151,18925,15226,,41600,23343,18253,4
SHAHPUR,SARGODHA,TEHSIL,ALL AGES,424745,216140,208597,8,332908,168736,164167,5,91837,47404,44430,3
SHAHPUR,SARGODHA,TEHSIL,UNDER 1,8400,4241,4159,,6647,3342,3305,,1753,899,854,
SHAHPUR,SARGODHA,TEHSIL,UNDER 5,52885,26482,26403,,41742,20783,20959,,11143,5699,5444,
SHAHPUR,SARGODHA,TEHSIL,UNDER 10,100020,50143,49877,,79005,39449,39556,,21015,10694,10321,
SHAHPUR,SARGODHA,TEHSIL,UNDER 15,146315,73508,72807,,115232,57603,57629,,31083,15905,15178,
SHAHPUR,SARGODHA,TEHSIL,05 - 24,171144,86328,84815,1,134626,67686,66939,1,36518,18642,17876,
SHAHPUR,SARGODHA,TEHSIL,15 - 49,211912,106737,105169,6,165530,83074,82452,4,46382,23663,22717,2
SHAHPUR,SARGODHA,TEHSIL,15 - 64,256071,130171,125892,8,200155,101418,98732,5,55916,28753,27160,3
SHAHPUR,SARGODHA,TEHSIL,18 - 60,221472,112059,109405,8,172857,87158,85694,5,48615,24901,23711,3
SHAHPUR,SARGODHA,TEHSIL,18 &  ABOVE,252752,129542,123202,8,197333,100781,96547,5,55419,28761,26655,3
SHAHPUR,SARGODHA,TEHSIL,60 &  ABOVE,34055,18976,15079,,26663,14792,11871,,7392,4184,3208,
SHAHPUR,SARGODHA,TEHSIL,65 &  ABOVE,22359,12461,9898,,17521,9715,7806,,4838,2746,2092,
SILLANWALI,SARGODHA,TEHSIL,ALL AGES,385878,194015,191852,11,336575,169222,167349,4,49303,24793,24503,7
SILLANWALI,SARGODHA,TEHSIL,UNDER 1,7028,3431,3597,,6248,3029,3219,,780,402,378,
SILLANWALI,SARGODHA,TEHSIL,UNDER 5,49256,24121,25135,,43595,21354,22241,,5661,2767,2894,
SILLANWALI,SARGODHA,TEHSIL,UNDER 10,97304,48098,49206,,85818,42481,43337,,11486,5617,5869,
SILLANWALI,SARGODHA,TEHSIL,UNDER 15,141742,70222,71520,,124490,61789,62701,,17252,8433,8819,
SILLANWALI,SARGODHA,TEHSIL,05 - 24,164697,82144,82548,5,143508,71710,71795,3,21189,10434,10753,2
SILLANWALI,SARGODHA,TEHSIL,15 - 49,191238,95167,96062,9,165554,82317,83233,4,25684,12850,12829,5
SILLANWALI,SARGODHA,TEHSIL,15 - 64,227150,114452,112689,9,196857,99036,97817,4,30293,15416,14872,5
SILLANWALI,SARGODHA,TEHSIL,18 - 60,196407,98587,97813,7,170108,85228,84876,4,26299,13359,12937,3
SILLANWALI,SARGODHA,TEHSIL,18 &  ABOVE,220396,111849,108538,9,191520,97048,94468,4,28876,14801,14070,5
SILLANWALI,SARGODHA,TEHSIL,60 &  ABOVE,26265,14460,11803,2,23399,12863,10536,,2866,1597,1267,2
SILLANWALI,SARGODHA,TEHSIL,65 &  ABOVE,16986,9341,7643,2,15228,8397,6831,,1758,944,812,2
SHEIKHUPURA,SHEIKHUPURA,DISTRICT,ALL AGES,4049377,2079359,1969412,606,2498625,1286433,1211837,355,1550752,792926,757575,251
SHEIKHUPURA,SHEIKHUPURA,DISTRICT,UNDER 1,94139,47243,46896,,59886,30217,29669,,34253,17026,17227,
SHEIKHUPURA,SHEIKHUPURA,DISTRICT,UNDER 5,603772,305007,298765,,377892,190710,187182,,225880,114297,111583,
SHEIKHUPURA,SHEIKHUPURA,DISTRICT,UNDER 10,1087191,548078,539113,,683023,344203,338820,,404168,203875,200293,
SHEIKHUPURA,SHEIKHUPURA,DISTRICT,UNDER 15,1558354,786110,772208,36,975037,490789,484225,23,583317,295321,287983,13
SHEIKHUPURA,SHEIKHUPURA,DISTRICT,05 - 24,1732576,874640,857659,277,1078543,544505,533842,196,654033,330135,323817,81
SHEIKHUPURA,SHEIKHUPURA,DISTRICT,15 - 49,2018767,1028119,990113,535,1233643,632322,601006,315,785124,395797,389107,220
SHEIKHUPURA,SHEIKHUPURA,DISTRICT,15 - 64,2355333,1213509,1141261,563,1437979,745303,692347,329,917354,468206,448914,234
SHEIKHUPURA,SHEIKHUPURA,DISTRICT,18 - 60,2040427,1050735,989232,460,1243873,645268,598351,254,796554,405467,390881,206
SHEIKHUPURA,SHEIKHUPURA,DISTRICT,18 &  ABOVE,2238363,1165876,1072018,469,1367231,717177,649796,258,871132,448699,422222,211
SHEIKHUPURA,SHEIKHUPURA,DISTRICT,60 &  ABOVE,223387,129030,94343,14,138937,80444,58488,5,84450,48586,35855,9
SHEIKHUPURA,SHEIKHUPURA,DISTRICT,65 &  ABOVE,135690,79740,55943,7,85609,50341,35265,3,50081,29399,20678,4
FEROZEWALA,SHEIKHUPURA,TEHSIL,ALL AGES,997246,519127,477796,323,657978,340675,317069,234,339268,178452,160727,89
FEROZEWALA,SHEIKHUPURA,TEHSIL,UNDER 1,24934,12738,12196,,17119,8714,8405,,7815,4024,3791,
FEROZEWALA,SHEIKHUPURA,TEHSIL,UNDER 5,175206,90473,84733,,114441,58520,55921,,60765,31953,28812,
FEROZEWALA,SHEIKHUPURA,TEHSIL,UNDER 10,296865,152953,143912,,196082,100391,95691,,100783,52562,48221,
FEROZEWALA,SHEIKHUPURA,TEHSIL,UNDER 15,412614,211982,200611,21,273522,139488,134017,17,139092,72494,66594,4
FEROZEWALA,SHEIKHUPURA,TEHSIL,05 - 24,423658,217295,206191,172,283772,144770,138857,145,139886,72525,67334,27
FEROZEWALA,SHEIKHUPURA,TEHSIL,15 - 49,484542,249810,234441,291,318778,163571,154997,210,165764,86239,79444,81
FEROZEWALA,SHEIKHUPURA,TEHSIL,15 - 64,558181,290948,266933,300,366856,190438,176202,216,191325,100510,90731,84
FEROZEWALA,SHEIKHUPURA,TEHSIL,18 - 60,484318,252234,231860,224,317683,164831,152697,155,166635,87403,79163,69
FEROZEWALA,SHEIKHUPURA,TEHSIL,18 &  ABOVE,523602,275887,247488,227,343634,180450,163027,157,179968,95437,84461,70
FEROZEWALA,SHEIKHUPURA,TEHSIL,60 &  ABOVE,45509,27207,18297,5,30063,17963,12098,2,15446,9244,6199,3
FEROZEWALA,SHEIKHUPURA,TEHSIL,65 &  ABOVE,26451,16197,10252,2,17600,10749,6850,1,8851,5448,3402,1
MURIDKE,SHEIKHUPURA,TEHSIL,ALL AGES,721166,367730,353385,51,399764,205034,194721,9,321402,162696,158664,42
MURIDKE,SHEIKHUPURA,TEHSIL,UNDER 1,18606,9398,9208,,10590,5378,5212,,8016,4020,3996,
MURIDKE,SHEIKHUPURA,TEHSIL,UNDER 5,113754,57909,55845,,65529,33361,32168,,48225,24548,23677,
MURIDKE,SHEIKHUPURA,TEHSIL,UNDER 10,202452,102264,100188,,116583,58910,57673,,85869,43354,42515,
MURIDKE,SHEIKHUPURA,TEHSIL,UNDER 15,289844,146383,143454,7,165234,83404,81829,1,124610,62979,61625,6
MURIDKE,SHEIKHUPURA,TEHSIL,05 - 24,317229,159103,158101,25,177409,89409,87994,6,139820,69694,70107,19
MURIDKE,SHEIKHUPURA,TEHSIL,15 - 49,350484,176067,174377,40,189816,96499,93310,7,160668,79568,81067,33
MURIDKE,SHEIKHUPURA,TEHSIL,15 - 64,406887,206970,199875,42,220298,113221,107070,7,186589,93749,92805,35
MURIDKE,SHEIKHUPURA,TEHSIL,18 - 60,349896,177877,171982,37,188787,97052,91730,5,161109,80825,80252,32
MURIDKE,SHEIKHUPURA,TEHSIL,18 &  ABOVE,384538,198011,186488,39,208569,108607,99956,6,175969,89404,86532,33
MURIDKE,SHEIKHUPURA,TEHSIL,60 &  ABOVE,39062,22457,16602,3,22247,12848,9398,1,16815,9609,7204,2
MURIDKE,SHEIKHUPURA,TEHSIL,65 &  ABOVE,24435,14377,10056,2,14232,8409,5822,1,10203,5968,4234,1
SAFDARABAD,SHEIKHUPURA,TEHSIL,ALL AGES,320836,161310,159477,49,231660,116412,115210,38,89176,44898,44267,11
SAFDARABAD,SHEIKHUPURA,TEHSIL,UNDER 1,9070,4500,4570,,6786,3351,3435,,2284,1149,1135,
SAFDARABAD,SHEIKHUPURA,TEHSIL,UNDER 5,52300,26169,26131,,37932,18986,18946,,14368,7183,7185,
SAFDARABAD,SHEIKHUPURA,TEHSIL,UNDER 10,90846,45568,45278,,65640,32900,32740,,25206,12668,12538,
SAFDARABAD,SHEIKHUPURA,TEHSIL,UNDER 15,127480,63916,63560,4,91779,45896,45880,3,35701,18020,17680,1
SAFDARABAD,SHEIKHUPURA,TEHSIL,05 - 24,134749,66981,67736,32,96820,47910,48880,30,37929,19071,18856,2
SAFDARABAD,SHEIKHUPURA,TEHSIL,15 - 49,152201,74720,77441,40,109279,53676,55572,31,42922,21044,21869,9
SAFDARABAD,SHEIKHUPURA,TEHSIL,15 - 64,180367,89991,90332,44,130015,64908,65072,35,50352,25083,25260,9
SAFDARABAD,SHEIKHUPURA,TEHSIL,18 - 60,154987,77132,77822,33,111649,55668,55956,25,43338,21464,21866,8
SAFDARABAD,SHEIKHUPURA,TEHSIL,18 &  ABOVE,173569,87662,85873,34,125710,63629,62056,25,47859,24033,23817,9
SAFDARABAD,SHEIKHUPURA,TEHSIL,60 &  ABOVE,20438,11522,8915,1,15394,8685,6709,,5044,2837,2206,1
SAFDARABAD,SHEIKHUPURA,TEHSIL,65 &  ABOVE,12989,7403,5585,1,9866,5608,4258,,3123,1795,1327,1
SHARAK PUR,SHEIKHUPURA,TEHSIL,ALL AGES,229292,115754,113523,15,181273,92082,89180,11,48019,23672,24343,4
SHARAK PUR,SHEIKHUPURA,TEHSIL,UNDER 1,5522,2735,2787,,4537,2265,2272,,985,470,515,
SHARAK PUR,SHEIKHUPURA,TEHSIL,UNDER 5,32616,16293,16323,,26476,13276,13200,,6140,3017,3123,
SHARAK PUR,SHEIKHUPURA,TEHSIL,UNDER 10,61027,30472,30555,,49567,24833,24734,,11460,5639,5821,
SHARAK PUR,SHEIKHUPURA,TEHSIL,UNDER 15,87359,43674,43683,2,70628,35464,35162,2,16731,8210,8521,
SHARAK PUR,SHEIKHUPURA,TEHSIL,05 - 24,97082,48319,48760,3,77394,38718,38673,3,19688,9601,10087,
SHARAK PUR,SHEIKHUPURA,TEHSIL,15 - 49,112047,55412,56625,10,87518,43720,43790,8,24529,11692,12835,2
SHARAK PUR,SHEIKHUPURA,TEHSIL,15 - 64,132487,66616,65860,11,103197,52347,50842,8,29290,14269,15018,3
SHARAK PUR,SHEIKHUPURA,TEHSIL,18 - 60,114852,57526,57315,11,89321,45144,44169,8,25531,12382,13146,3
SHARAK PUR,SHEIKHUPURA,TEHSIL,18 &  ABOVE,128237,65210,63014,13,99798,51131,48658,9,28439,14079,14356,4
SHARAK PUR,SHEIKHUPURA,TEHSIL,60 &  ABOVE,14887,8533,6352,2,11649,6644,5004,1,3238,1889,1348,1
SHARAK PUR,SHEIKHUPURA,TEHSIL,65 &  ABOVE,9446,5464,3980,2,7448,4271,3176,1,1998,1193,804,1
SHEIKHUPURA,SHEIKHUPURA,TEHSIL,ALL AGES,1780837,915438,865231,168,1027950,532230,495657,63,752887,383208,369574,105
SHEIKHUPURA,SHEIKHUPURA,TEHSIL,UNDER 1,36007,17872,18135,,20854,10509,10345,,15153,7363,7790,
SHEIKHUPURA,SHEIKHUPURA,TEHSIL,UNDER 5,229896,114163,115733,,133514,66567,66947,,96382,47596,48786,
SHEIKHUPURA,SHEIKHUPURA,TEHSIL,UNDER 10,436001,216821,219180,,255151,127169,127982,,180850,89652,91198,
SHEIKHUPURA,SHEIKHUPURA,TEHSIL,UNDER 15,641057,320155,320900,2,373874,186537,187337,,267183,133618,133563,2
SHEIKHUPURA,SHEIKHUPURA,TEHSIL,05 - 24,759858,382942,376871,45,443148,223698,219438,12,316710,159244,157433,33
SHEIKHUPURA,SHEIKHUPURA,TEHSIL,15 - 49,919493,472110,447229,154,528252,274856,253337,59,391241,197254,193892,95
SHEIKHUPURA,SHEIKHUPURA,TEHSIL,15 - 64,1077411,558984,518261,166,617613,324389,293161,63,459798,234595,225100,103
SHEIKHUPURA,SHEIKHUPURA,TEHSIL,18 - 60,936374,485966,450253,155,536433,282573,253799,61,399941,203393,196454,94
SHEIKHUPURA,SHEIKHUPURA,TEHSIL,18 &  ABOVE,1028417,539106,489155,156,589520,313360,276099,61,438897,225746,213056,95
SHEIKHUPURA,SHEIKHUPURA,TEHSIL,60 &  ABOVE,103491,59311,44177,3,59584,34304,25279,1,43907,25007,18898,2
SHEIKHUPURA,SHEIKHUPURA,TEHSIL,65 &  ABOVE,62369,36299,26070,,36463,21304,15159,,25906,14995,10911,
SIALKOT,SIALKOT,DISTRICT,ALL AGES,4472462,2265012,2206591,859,3017087,1519345,1497543,199,1455375,745667,709048,660
SIALKOT,SIALKOT,DISTRICT,UNDER 1,95350,49376,45974,,66673,34400,32273,,28677,14976,13701,
SIALKOT,SIALKOT,DISTRICT,UNDER 5,606524,314078,292446,,417596,215873,201723,,188928,98205,90723,
SIALKOT,SIALKOT,DISTRICT,UNDER 10,1116259,574768,541491,,767921,394480,373441,,348338,180288,168050,
SIALKOT,SIALKOT,DISTRICT,UNDER 15,1632098,843903,787798,397,1119387,577462,541922,3,512711,266441,245876,394
SIALKOT,SIALKOT,DISTRICT,05 - 24,1896348,969058,926773,517,1294419,658094,636269,56,601929,310964,290504,461
SIALKOT,SIALKOT,DISTRICT,15 - 49,2236469,1096520,1139543,406,1493025,725121,767732,172,743444,371399,371811,234
SIALKOT,SIALKOT,DISTRICT,15 - 64,2649852,1314755,1334644,453,1766572,869254,897128,190,883280,445501,437516,263
SIALKOT,SIALKOT,DISTRICT,18 - 60,2287938,1125227,1162283,428,1520386,740986,779224,176,767552,384241,383059,252
SIALKOT,SIALKOT,DISTRICT,18 &  ABOVE,2559384,1276385,1282559,440,1705271,843258,861830,183,854113,433127,420729,257
SIALKOT,SIALKOT,DISTRICT,60 &  ABOVE,301486,166958,134513,15,204586,112592,91987,7,96900,54366,42526,8
SIALKOT,SIALKOT,DISTRICT,65 &  ABOVE,190512,106354,84149,9,131128,72629,58493,6,59384,33725,25656,3
DASKA,SIALKOT,TEHSIL,ALL AGES,980495,496850,483522,123,721177,365065,356043,69,259318,131785,127479,54
DASKA,SIALKOT,TEHSIL,UNDER 1,21164,10755,10409,,16015,8144,7871,,5149,2611,2538,
DASKA,SIALKOT,TEHSIL,UNDER 5,134698,69132,65566,,100730,51682,49048,,33968,17450,16518,
DASKA,SIALKOT,TEHSIL,UNDER 10,247035,126272,120763,,184679,94187,90492,,62356,32085,30271,
DASKA,SIALKOT,TEHSIL,UNDER 15,360876,185595,175280,1,269002,138127,130874,1,91874,47468,44406,
DASKA,SIALKOT,TEHSIL,05 - 24,417688,213458,204192,38,309077,157387,151671,19,108611,56071,52521,19
DASKA,SIALKOT,TEHSIL,15 - 49,489854,241545,248197,112,357080,175843,181176,61,132774,65702,67021,51
DASKA,SIALKOT,TEHSIL,15 - 64,579617,288977,290523,117,422208,210243,211901,64,157409,78734,78622,53
DASKA,SIALKOT,TEHSIL,18 - 60,499807,247249,252448,110,363397,179703,183633,61,136410,67546,68815,49
DASKA,SIALKOT,TEHSIL,18 &  ABOVE,557678,279394,278169,115,406438,203533,202840,65,151240,75861,75329,50
DASKA,SIALKOT,TEHSIL,60 &  ABOVE,63781,35288,28488,5,47229,26035,21190,4,16552,9253,7298,1
DASKA,SIALKOT,TEHSIL,65 &  ABOVE,40002,22278,17719,5,29967,16695,13268,4,10035,5583,4451,1
PASRUR,SIALKOT,TEHSIL,ALL AGES,970043,490047,479895,101,838242,422856,415352,34,131801,67191,64543,67
PASRUR,SIALKOT,TEHSIL,UNDER 1,23605,12522,11083,,20764,11059,9705,,2841,1463,1378,
PASRUR,SIALKOT,TEHSIL,UNDER 5,137840,72150,65690,,119645,62599,57046,,18195,9551,8644,
PASRUR,SIALKOT,TEHSIL,UNDER 10,252880,131038,121842,,219768,113753,106015,,33112,17285,15827,
PASRUR,SIALKOT,TEHSIL,UNDER 15,369823,192405,177416,2,320519,166542,153976,1,49304,25863,23440,1
PASRUR,SIALKOT,TEHSIL,05 - 24,424539,216781,207734,24,367549,187242,180292,15,56990,29539,27442,9
PASRUR,SIALKOT,TEHSIL,15 - 49,471781,229036,242661,84,406212,196813,209373,26,65569,32223,33288,58
PASRUR,SIALKOT,TEHSIL,15 - 64,557090,274260,282732,98,479607,235643,243932,32,77483,38617,38800,66
PASRUR,SIALKOT,TEHSIL,18 - 60,476923,232337,244497,89,410368,199553,210790,25,66555,32784,33707,64
PASRUR,SIALKOT,TEHSIL,18 &  ABOVE,536366,264743,271530,93,462534,227974,234533,27,73832,36769,36997,66
PASRUR,SIALKOT,TEHSIL,60 &  ABOVE,65415,35540,29871,4,57398,31161,26235,2,8017,4379,3636,2
PASRUR,SIALKOT,TEHSIL,65 &  ABOVE,43130,23382,19747,1,38116,20671,17444,1,5014,2711,2303,
SAMBRIAL,SIALKOT,TEHSIL,ALL AGES,460280,231496,228723,61,318373,159343,159010,20,141907,72153,69713,41
SAMBRIAL,SIALKOT,TEHSIL,UNDER 1,8919,4568,4351,,6288,3219,3069,,2631,1349,1282,
SAMBRIAL,SIALKOT,TEHSIL,UNDER 5,57831,29748,28083,,39625,20264,19361,,18206,9484,8722,
SAMBRIAL,SIALKOT,TEHSIL,UNDER 10,110048,56248,53800,,76052,38785,37267,,33996,17463,16533,
SAMBRIAL,SIALKOT,TEHSIL,UNDER 15,162554,83540,79012,2,112161,57498,54663,,50393,26042,24349,2
SAMBRIAL,SIALKOT,TEHSIL,05 - 24,195787,99077,96702,8,135487,68418,67066,3,60300,30659,29636,5
SAMBRIAL,SIALKOT,TEHSIL,15 - 49,232860,112921,119887,52,160147,77053,83076,18,72713,35868,36811,34
SAMBRIAL,SIALKOT,TEHSIL,15 - 64,277089,136235,140795,59,190973,93284,97669,20,86116,42951,43126,39
SAMBRIAL,SIALKOT,TEHSIL,18 - 60,239260,116429,122773,58,164641,79432,85189,20,74619,36997,37584,38
SAMBRIAL,SIALKOT,TEHSIL,18 &  ABOVE,268724,133168,135498,58,186161,91564,94577,20,82563,41604,40921,38
SAMBRIAL,SIALKOT,TEHSIL,60 &  ABOVE,32572,18359,14213,,23639,13216,10423,,8933,5143,3790,
SAMBRIAL,SIALKOT,TEHSIL,65 &  ABOVE,20637,11721,8916,,15239,8561,6678,,5398,3160,2238,
SIALKOT,SIALKOT,TEHSIL,ALL AGES,2061644,1046619,1014451,574,1139295,572081,567138,76,922349,474538,447313,498
SIALKOT,SIALKOT,TEHSIL,UNDER 1,41662,21531,20131,,23606,11978,11628,,18056,9553,8503,
SIALKOT,SIALKOT,TEHSIL,UNDER 5,276155,143048,133107,,157596,81328,76268,,118559,61720,56839,
SIALKOT,SIALKOT,TEHSIL,UNDER 10,506296,261210,245086,,287422,147755,139667,,218874,113455,105419,
SIALKOT,SIALKOT,TEHSIL,UNDER 15,738845,382363,356090,392,417705,215295,202409,1,321140,167068,153681,391
SIALKOT,SIALKOT,TEHSIL,05 - 24,858334,439742,418145,447,482306,245047,237240,19,376028,194695,180905,428
SIALKOT,SIALKOT,TEHSIL,15 - 49,1041974,513018,528798,158,569586,275412,294107,67,472388,237606,234691,91
SIALKOT,SIALKOT,TEHSIL,15 - 64,1236056,615283,620594,179,673784,330084,343626,74,562272,285199,276968,105
SIALKOT,SIALKOT,TEHSIL,18 - 60,1071948,529212,542565,171,581980,282298,299612,70,489968,246914,242953,101
SIALKOT,SIALKOT,TEHSIL,18 &  ABOVE,1196616,599080,597362,174,650138,320187,329880,71,546478,278893,267482,103
SIALKOT,SIALKOT,TEHSIL,60 &  ABOVE,139718,77771,61941,6,76320,42180,34139,1,63398,35591,27802,5
SIALKOT,SIALKOT,TEHSIL,65 &  ABOVE,86743,48973,37767,3,47806,26702,21103,1,38937,22271,16664,2
TOBA TEK SINGH,TOBA TEK SINGH,DISTRICT,ALL AGES,2524044,1295646,1228162,236,1960519,1006994,953434,91,563525,288652,274728,145
TOBA TEK SINGH,TOBA TEK SINGH,DISTRICT,UNDER 1,54526,28492,26034,,43154,22523,20631,,11372,5969,5403,
TOBA TEK SINGH,TOBA TEK SINGH,DISTRICT,UNDER 5,323405,167549,155856,,256557,132808,123749,,66848,34741,32107,
TOBA TEK SINGH,TOBA TEK SINGH,DISTRICT,UNDER 10,621491,319491,302000,,492591,253064,239527,,128900,66427,62473,
TOBA TEK SINGH,TOBA TEK SINGH,DISTRICT,UNDER 15,906891,468916,437973,2,713311,368329,344980,2,193580,100587,92993,
TOBA TEK SINGH,TOBA TEK SINGH,DISTRICT,05 - 24,1049793,540425,509324,44,817203,420704,396481,18,232590,119721,112843,26
TOBA TEK SINGH,TOBA TEK SINGH,DISTRICT,15 - 49,1255313,632222,622894,197,964236,486404,477757,75,291077,145818,145137,122
TOBA TEK SINGH,TOBA TEK SINGH,DISTRICT,15 - 64,1499870,761424,738217,229,1153088,586205,566795,88,346782,175219,171422,141
TOBA TEK SINGH,TOBA TEK SINGH,DISTRICT,18 - 60,1298267,654897,643152,218,997097,503909,493107,81,301170,150988,150045,137
TOBA TEK SINGH,TOBA TEK SINGH,DISTRICT,18 &  ABOVE,1465741,747526,717989,226,1130226,577590,552552,84,335515,169936,165437,142
TOBA TEK SINGH,TOBA TEK SINGH,DISTRICT,60 &  ABOVE,182912,100515,82387,10,145146,79808,65334,4,37766,20707,17053,6
TOBA TEK SINGH,TOBA TEK SINGH,DISTRICT,65 &  ABOVE,117283,65306,51972,5,94120,52460,41659,1,23163,12846,10313,4
GOJRA,TOBA TEK SINGH,TEHSIL,ALL AGES,755579,387978,367557,44,541230,277914,263306,10,214349,110064,104251,34
GOJRA,TOBA TEK SINGH,TEHSIL,UNDER 1,17109,9016,8093,,12260,6443,5817,,4849,2573,2276,
GOJRA,TOBA TEK SINGH,TEHSIL,UNDER 5,95668,49644,46024,,69315,35842,33473,,26353,13802,12551,
GOJRA,TOBA TEK SINGH,TEHSIL,UNDER 10,181182,93197,87985,,131774,67612,64162,,49408,25585,23823,
GOJRA,TOBA TEK SINGH,TEHSIL,UNDER 15,265494,136982,128511,1,191091,98239,92851,1,74403,38743,35660,
GOJRA,TOBA TEK SINGH,TEHSIL,05 - 24,310814,159223,151576,15,221768,113538,108225,5,89046,45685,43351,10
GOJRA,TOBA TEK SINGH,TEHSIL,15 - 49,378970,191036,187898,36,268778,135804,132967,7,110192,55232,54931,29
GOJRA,TOBA TEK SINGH,TEHSIL,15 - 64,453749,230567,223139,43,322572,164223,158340,9,131177,66344,64799,34
GOJRA,TOBA TEK SINGH,TEHSIL,18 - 60,392875,198605,194233,37,279232,141521,137705,6,113643,57084,56528,31
GOJRA,TOBA TEK SINGH,TEHSIL,18 &  ABOVE,444710,227569,217103,38,318076,163175,154895,6,126634,64394,62208,32
GOJRA,TOBA TEK SINGH,TEHSIL,60 &  ABOVE,56732,31469,25260,3,42348,23435,18912,1,14384,8034,6348,2
GOJRA,TOBA TEK SINGH,TEHSIL,65 &  ABOVE,36336,20429,15907,,27567,15452,12115,,8769,4977,3792,
KAMALIA,TOBA TEK SINGH,TEHSIL,ALL AGES,422477,216549,205877,51,255860,131267,124583,10,166617,85282,81294,41
KAMALIA,TOBA TEK SINGH,TEHSIL,UNDER 1,8711,4412,4299,,5431,2727,2704,,3280,1685,1595,
KAMALIA,TOBA TEK SINGH,TEHSIL,UNDER 5,53224,27225,25999,,33290,16905,16385,,19934,10320,9614,
KAMALIA,TOBA TEK SINGH,TEHSIL,UNDER 10,104798,53422,51376,,65803,33406,32397,,38995,20016,18979,
KAMALIA,TOBA TEK SINGH,TEHSIL,UNDER 15,152920,78578,74342,,95097,48729,46368,,57823,29849,27974,
KAMALIA,TOBA TEK SINGH,TEHSIL,05 - 24,178018,91680,86333,5,109019,56287,52731,1,68999,35393,33602,4
KAMALIA,TOBA TEK SINGH,TEHSIL,15 - 49,210019,106020,103958,41,124124,62840,61274,10,85895,43180,42684,31
KAMALIA,TOBA TEK SINGH,TEHSIL,15 - 64,250561,127526,122987,48,148515,75750,72755,10,102046,51776,50232,38
KAMALIA,TOBA TEK SINGH,TEHSIL,18 - 60,216898,109629,107222,47,127912,64750,63152,10,88986,44879,44070,37
KAMALIA,TOBA TEK SINGH,TEHSIL,18 &  ABOVE,243723,124271,119402,50,144858,74052,70796,10,98865,50219,48606,40
KAMALIA,TOBA TEK SINGH,TEHSIL,60 &  ABOVE,29434,15910,13521,3,18581,10080,8501,,10853,5830,5020,3
KAMALIA,TOBA TEK SINGH,TEHSIL,65 &  ABOVE,18996,10445,8548,3,12248,6788,5460,,6748,3657,3088,3
PIRMAHAL,TOBA TEK SINGH,TEHSIL,ALL AGES,496636,255241,241334,61,437179,224569,212589,21,59457,30672,28745,40
PIRMAHAL,TOBA TEK SINGH,TEHSIL,UNDER 1,10936,5728,5208,,9870,5178,4692,,1066,550,516,
PIRMAHAL,TOBA TEK SINGH,TEHSIL,UNDER 5,64692,33237,31455,,57673,29652,28021,,7019,3585,3434,
PIRMAHAL,TOBA TEK SINGH,TEHSIL,UNDER 10,127632,65296,62336,,113863,58216,55647,,13769,7080,6689,
PIRMAHAL,TOBA TEK SINGH,TEHSIL,UNDER 15,186022,96224,89797,1,165128,85252,79875,1,20894,10972,9922,
PIRMAHAL,TOBA TEK SINGH,TEHSIL,05 - 24,212503,109749,102745,9,188123,96881,91239,3,24380,12868,11506,6
PIRMAHAL,TOBA TEK SINGH,TEHSIL,15 - 49,244973,123642,121286,45,214188,108096,106079,13,30785,15546,15207,32
PIRMAHAL,TOBA TEK SINGH,TEHSIL,15 - 64,289437,147251,142128,58,253245,128876,124350,19,36192,18375,17778,39
PIRMAHAL,TOBA TEK SINGH,TEHSIL,18 - 60,250880,126877,123946,57,219296,111085,108193,18,31584,15792,15753,39
PIRMAHAL,TOBA TEK SINGH,TEHSIL,18 &  ABOVE,280804,143458,137286,60,245755,125736,119999,20,35049,17722,17287,40
PIRMAHAL,TOBA TEK SINGH,TEHSIL,60 &  ABOVE,33009,18112,14894,3,29199,16015,13182,2,3810,2097,1712,1
PIRMAHAL,TOBA TEK SINGH,TEHSIL,65 &  ABOVE,21177,11766,9409,2,18806,10441,8364,1,2371,1325,1045,1
TOBA TEK SINGH,TOBA TEK SINGH,TEHSIL,ALL AGES,849352,435878,413394,80,726250,373244,352956,50,123102,62634,60438,30
TOBA TEK SINGH,TOBA TEK SINGH,TEHSIL,UNDER 1,17770,9336,8434,,15593,8175,7418,,2177,1161,1016,
TOBA TEK SINGH,TOBA TEK SINGH,TEHSIL,UNDER 5,109821,57443,52378,,96279,50409,45870,,13542,7034,6508,
TOBA TEK SINGH,TOBA TEK SINGH,TEHSIL,UNDER 10,207879,107576,100303,,181151,93830,87321,,26728,13746,12982,
TOBA TEK SINGH,TOBA TEK SINGH,TEHSIL,UNDER 15,302455,157132,145323,,261995,136109,125886,,40460,21023,19437,
TOBA TEK SINGH,TOBA TEK SINGH,TEHSIL,05 - 24,348458,179773,168670,15,298293,153998,144286,9,50165,25775,24384,6
TOBA TEK SINGH,TOBA TEK SINGH,TEHSIL,15 - 49,421351,211524,209752,75,357146,179664,177437,45,64205,31860,32315,30
TOBA TEK SINGH,TOBA TEK SINGH,TEHSIL,15 - 64,506123,256080,249963,80,428756,217356,211350,50,77367,38724,38613,30
TOBA TEK SINGH,TOBA TEK SINGH,TEHSIL,18 - 60,437614,219786,217751,77,370657,186553,184057,47,66957,33233,33694,30
TOBA TEK SINGH,TOBA TEK SINGH,TEHSIL,18 &  ABOVE,496504,252228,244198,78,421537,214627,206862,48,74967,37601,37336,30
TOBA TEK SINGH,TOBA TEK SINGH,TEHSIL,60 &  ABOVE,63737,35024,28712,1,55018,30278,24739,1,8719,4746,3973,
TOBA TEK SINGH,TOBA TEK SINGH,TEHSIL,65 &  ABOVE,40774,22666,18108,,35499,19779,15720,,5275,2887,2388,
VEHARI,VEHARI,DISTRICT,ALL AGES,3428191,1733665,1694087,439,2645727,1339615,1305872,240,782464,394050,388215,199
VEHARI,VEHARI,DISTRICT,UNDER 1,82831,41393,41438,,64608,32351,32257,,18223,9042,9181,
VEHARI,VEHARI,DISTRICT,UNDER 5,509050,256032,253018,,396361,199673,196688,,112689,56359,56330,
VEHARI,VEHARI,DISTRICT,UNDER 10,940756,472603,468153,,734070,369043,365027,,206686,103560,103126,
VEHARI,VEHARI,DISTRICT,UNDER 15,1337959,672674,665258,27,1040186,523372,516792,22,297773,149302,148466,5
VEHARI,VEHARI,DISTRICT,05 - 24,1442169,724452,717553,164,1113768,560043,553606,119,328401,164409,163947,45
VEHARI,VEHARI,DISTRICT,15 - 49,1649707,825579,823763,365,1262807,633285,629322,200,386900,192294,194441,165
VEHARI,VEHARI,DISTRICT,15 - 64,1957284,988529,968349,406,1499826,758659,740952,215,457458,229870,227397,191
VEHARI,VEHARI,DISTRICT,18 - 60,1695438,853906,841176,356,1299253,655693,643383,177,396185,198213,197793,179
VEHARI,VEHARI,DISTRICT,18 &  ABOVE,1888478,958716,929396,366,1451233,738037,713014,182,437245,220679,216382,184
VEHARI,VEHARI,DISTRICT,60 &  ABOVE,212866,115027,97827,12,167272,90187,77079,6,45594,24840,20748,6
VEHARI,VEHARI,DISTRICT,65 &  ABOVE,132948,72462,60480,6,105715,57584,48128,3,27233,14878,12352,3
BUREWALA,VEHARI,TEHSIL,ALL AGES,1203944,605493,598314,137,842323,424768,417523,32,361621,180725,180791,105
BUREWALA,VEHARI,TEHSIL,UNDER 1,27667,13606,14061,,19503,9622,9881,,8164,3984,4180,
BUREWALA,VEHARI,TEHSIL,UNDER 5,167016,82615,84401,,118129,58478,59651,,48887,24137,24750,
BUREWALA,VEHARI,TEHSIL,UNDER 10,314221,155687,158534,,222276,110093,112183,,91945,45594,46351,
BUREWALA,VEHARI,TEHSIL,UNDER 15,455020,226551,228469,,319987,159632,160355,,135033,66919,68114,
BUREWALA,VEHARI,TEHSIL,05 - 24,507468,253715,253714,39,354302,177766,176524,12,153166,75949,77190,27
BUREWALA,VEHARI,TEHSIL,15 - 49,589610,293324,296166,120,408237,203811,204400,26,181373,89513,91766,94
BUREWALA,VEHARI,TEHSIL,15 - 64,702650,353331,349186,133,488270,246265,241974,31,214380,107066,107212,102
BUREWALA,VEHARI,TEHSIL,18 - 60,607774,304638,303020,116,422263,212341,209898,24,185511,92297,93122,92
BUREWALA,VEHARI,TEHSIL,18 &  ABOVE,676918,342640,334155,123,472589,240005,232557,27,204329,102635,101598,96
BUREWALA,VEHARI,TEHSIL,60 &  ABOVE,76192,41588,34596,8,55306,30176,25126,4,20886,11412,9470,4
BUREWALA,VEHARI,TEHSIL,65 &  ABOVE,46274,25611,20659,4,34066,18871,15194,1,12208,6740,5465,3
MAILSI,VEHARI,TEHSIL,ALL AGES,1118673,566611,551943,119,908099,459456,448561,82,210574,107155,103382,37
MAILSI,VEHARI,TEHSIL,UNDER 1,23415,11721,11694,,19032,9490,9542,,4383,2231,2152,
MAILSI,VEHARI,TEHSIL,UNDER 5,156865,78534,78331,,127003,63496,63507,,29862,15038,14824,
MAILSI,VEHARI,TEHSIL,UNDER 10,302853,152212,150641,,246344,123665,122679,,56509,28547,27962,
MAILSI,VEHARI,TEHSIL,UNDER 15,435245,218986,216249,10,353804,177705,176089,10,81441,41281,40160,
MAILSI,VEHARI,TEHSIL,05 - 24,480203,242009,238150,44,390144,196215,193890,39,90059,45794,44260,5
MAILSI,VEHARI,TEHSIL,15 - 49,539192,271032,268063,97,436525,219284,217174,67,102667,51748,50889,30
MAILSI,VEHARI,TEHSIL,15 - 64,637906,323285,314513,108,516764,261661,255032,71,121142,61624,59481,37
MAILSI,VEHARI,TEHSIL,18 - 60,552721,279528,273097,96,447849,226504,221286,59,104872,53024,51811,37
MAILSI,VEHARI,TEHSIL,18 &  ABOVE,616688,313711,302880,97,500432,254575,245797,60,116256,59136,57083,37
MAILSI,VEHARI,TEHSIL,60 &  ABOVE,70947,37741,33205,1,58212,30917,27294,1,12735,6824,5911,
MAILSI,VEHARI,TEHSIL,65 &  ABOVE,45522,24340,21181,1,37531,20090,17440,1,7991,4250,3741,
VEHARI,VEHARI,TEHSIL,ALL AGES,1105574,561561,543830,183,895305,455391,439788,126,210269,106170,104042,57
VEHARI,VEHARI,TEHSIL,UNDER 1,31749,16066,15683,,26073,13239,12834,,5676,2827,2849,
VEHARI,VEHARI,TEHSIL,UNDER 5,185169,94883,90286,,151229,77699,73530,,33940,17184,16756,
VEHARI,VEHARI,TEHSIL,UNDER 10,323682,164704,158978,,265450,135285,130165,,58232,29419,28813,
VEHARI,VEHARI,TEHSIL,UNDER 15,447694,227137,220540,17,366395,186035,180348,12,81299,41102,40192,5
VEHARI,VEHARI,TEHSIL,05 - 24,454498,228728,225689,81,369322,186062,183192,68,85176,42666,42497,13
VEHARI,VEHARI,TEHSIL,15 - 49,520905,261223,259534,148,418045,210190,207748,107,102860,51033,51786,41
VEHARI,VEHARI,TEHSIL,15 - 64,616728,311913,304650,165,494792,250733,243946,113,121936,61180,60704,52
VEHARI,VEHARI,TEHSIL,18 - 60,534943,269740,265059,144,429141,216848,212199,94,105802,52892,52860,50
VEHARI,VEHARI,TEHSIL,18 &  ABOVE,594872,302365,292361,146,478212,243457,234660,95,116660,58908,57701,51
VEHARI,VEHARI,TEHSIL,60 &  ABOVE,65727,35698,30026,3,53754,29094,24659,1,11973,6604,5367,2
VEHARI,VEHARI,TEHSIL,65 &  ABOVE,41152,22511,18640,1,34118,18623,15494,1,7034,3888,3146,
