name_admin_unit,part_of_district,admin_unit,religion,all_sexes_overall,female_overall,male_overall,tgend_overall,all_sexes_rural,female_rural,male_rural,tgend_rural,all_sexes_urban,female_urban,male_urban,tgend_urban
ABBOTTABAD,ABBOTTABAD,DISTRICT,QADIANI/AHMADI,21,11,10,0,15,8,7,0,6,3,3,0
ABBOTTABAD,ABBOTTABAD,DISTRICT,CHRISTIAN,5818,3197,2620,1,3174,1809,1365,0,2644,1388,1255,1
ABBOTTABAD,ABBOTTABAD,DISTRICT,HINDU JATI,97,49,48,0,48,16,32,0,49,33,16,0
ABBOTTABAD,ABBOTTABAD,DISTRICT,MUSLIM,1391394,692187,699104,103,1083261,540293,542945,23,308133,151894,156159,80
ABBOTTABAD,ABBOTTABAD,DISTRICT,OTHERS,191,104,87,0,150,87,63,0,41,17,24,0
ABBOTTABAD,ABBOTTABAD,DISTRICT,PARSI,6,3,3,0,4,2,2,0,2,1,1,0
ABBOTTABAD,ABBOTTABAD,DISTRICT,SCHEDULED CASTE,17,7,10,0,16,7,9,0,1,0,1,0
ABBOTTABAD,ABBOTTABAD,DISTRICT,SIKH,43,19,24,0,20,9,11,0,23,10,13,0
ABBOTTABAD,ABBOTTABAD,TEHSIL,QADIANI/AHMADI,16,9,7,0,10,6,4,0,6,3,3,0
ABBOTTABAD,ABBOTTABAD,TEHSIL,CHRISTIAN,4476,2427,2048,1,2106,1182,924,0,2370,1245,1124,1
ABBOTTABAD,ABBOTTABAD,TEHSIL,HINDU JATI,81,41,40,0,32,8,24,0,49,33,16,0
ABBOTTABAD,ABBOTTABAD,TEHSIL,MUSLIM,977268,483611,493601,56,725230,359748,365464,18,252038,123863,128137,38
ABBOTTABAD,ABBOTTABAD,TEHSIL,OTHERS,80,42,38,0,46,29,17,0,34,13,21,0
ABBOTTABAD,ABBOTTABAD,TEHSIL,PARSI,5,2,3,0,3,1,2,0,2,1,1,0
ABBOTTABAD,ABBOTTABAD,TEHSIL,SCHEDULED CASTE,10,3,7,0,9,3,6,0,1,0,1,0
ABBOTTABAD,ABBOTTABAD,TEHSIL,SIKH,31,16,15,0,13,7,6,0,18,9,9,0
ADENZAI,LOWER DIR,SUB-DIVISION,QADIANI/AHMADI,6,3,3,0,6,3,3,0,0,0,0,0
ADENZAI,LOWER DIR,SUB-DIVISION,CHRISTIAN,938,525,413,0,938,525,413,0,0,0,0,0
ADENZAI,LOWER DIR,SUB-DIVISION,HINDU JATI,4,2,2,0,4,2,2,0,0,0,0,0
ADENZAI,LOWER DIR,SUB-DIVISION,MUSLIM,376594,184787,191800,7,376594,184787,191800,7,0,0,0,0
ADENZAI,LOWER DIR,SUB-DIVISION,OTHERS,17,5,12,0,17,5,12,0,0,0,0,0
ADENZAI,LOWER DIR,SUB-DIVISION,PARSI,0,0,0,0,0,0,0,0,0,0,0,0
ADENZAI,LOWER DIR,SUB-DIVISION,SCHEDULED CASTE,6,2,4,0,6,2,4,0,0,0,0,0
ADENZAI,LOWER DIR,SUB-DIVISION,SIKH,3,1,2,0,3,1,2,0,0,0,0,0
ALLAI,BATAGRAM,TEHSIL,QADIANI/AHMADI,3,2,1,0,3,2,1,0,0,0,0,0
ALLAI,BATAGRAM,TEHSIL,CHRISTIAN,408,217,191,0,408,217,191,0,0,0,0,0
ALLAI,BATAGRAM,TEHSIL,HINDU JATI,1,1,0,0,1,1,0,0,0,0,0,0
ALLAI,BATAGRAM,TEHSIL,MUSLIM,217130,105351,111774,5,217130,105351,111774,5,0,0,0,0
ALLAI,BATAGRAM,TEHSIL,OTHERS,23,12,11,0,23,12,11,0,0,0,0,0
ALLAI,BATAGRAM,TEHSIL,PARSI,0,0,0,0,0,0,0,0,0,0,0,0
ALLAI,BATAGRAM,TEHSIL,SCHEDULED CASTE,0,0,0,0,0,0,0,0,0,0,0,0
ALLAI,BATAGRAM,TEHSIL,SIKH,1,1,0,0,1,1,0,0,0,0,0,0
ALPURI,SHANGLA,TEHSIL,QADIANI/AHMADI,6,2,4,0,6,2,4,0,0,0,0,0
ALPURI,SHANGLA,TEHSIL,CHRISTIAN,733,378,354,1,733,378,354,1,0,0,0,0
ALPURI,SHANGLA,TEHSIL,HINDU JATI,18,13,5,0,18,13,5,0,0,0,0,0
ALPURI,SHANGLA,TEHSIL,MUSLIM,365758,176975,188781,2,365758,176975,188781,2,0,0,0,0
ALPURI,SHANGLA,TEHSIL,OTHERS,118,64,54,0,118,64,54,0,0,0,0,0
ALPURI,SHANGLA,TEHSIL,PARSI,0,0,0,0,0,0,0,0,0,0,0,0
ALPURI,SHANGLA,TEHSIL,SCHEDULED CASTE,5,1,4,0,5,1,4,0,0,0,0,0
ALPURI,SHANGLA,TEHSIL,SIKH,5,4,1,0,5,4,1,0,0,0,0,0
AMBAR UTMAN KHEL,MOHMAND,TEHSIL,QADIANI/AHMADI,0,0,0,0,0,0,0,0,0,0,0,0
AMBAR UTMAN KHEL,MOHMAND,TEHSIL,CHRISTIAN,208,119,89,0,208,119,89,0,0,0,0,0
AMBAR UTMAN KHEL,MOHMAND,TEHSIL,HINDU JATI,0,0,0,0,0,0,0,0,0,0,0,0
AMBAR UTMAN KHEL,MOHMAND,TEHSIL,MUSLIM,79241,38946,40294,1,79241,38946,40294,1,0,0,0,0
AMBAR UTMAN KHEL,MOHMAND,TEHSIL,OTHERS,5,5,0,0,5,5,0,0,0,0,0,0
AMBAR UTMAN KHEL,MOHMAND,TEHSIL,PARSI,0,0,0,0,0,0,0,0,0,0,0,0
AMBAR UTMAN KHEL,MOHMAND,TEHSIL,SCHEDULED CASTE,0,0,0,0,0,0,0,0,0,0,0,0
AMBAR UTMAN KHEL,MOHMAND,TEHSIL,SIKH,1,1,0,0,1,1,0,0,0,0,0,0
BABUZAI,SWAT,TEHSIL,QADIANI/AHMADI,7,3,4,0,2,0,2,0,5,3,2,0
BABUZAI,SWAT,TEHSIL,CHRISTIAN,2171,1167,1004,0,933,511,422,0,1238,656,582,0
BABUZAI,SWAT,TEHSIL,HINDU JATI,32,15,17,0,15,6,9,0,17,9,8,0
BABUZAI,SWAT,TEHSIL,MUSLIM,693701,332093,361561,47,334591,160882,173708,1,359110,171211,187853,46
BABUZAI,SWAT,TEHSIL,OTHERS,28,17,11,0,19,11,8,0,9,6,3,0
BABUZAI,SWAT,TEHSIL,PARSI,0,0,0,0,0,0,0,0,0,0,0,0
BABUZAI,SWAT,TEHSIL,SCHEDULED CASTE,9,4,5,0,6,2,4,0,3,2,1,0
BABUZAI,SWAT,TEHSIL,SIKH,456,218,238,0,18,8,10,0,438,210,228,0
BADHBER,PESHAWAR,TEHSIL,QADIANI/AHMADI,9,5,4,0,9,5,4,0,0,0,0,0
BADHBER,PESHAWAR,TEHSIL,CHRISTIAN,878,476,402,0,878,476,402,0,0,0,0,0
BADHBER,PESHAWAR,TEHSIL,HINDU JATI,10,4,6,0,10,4,6,0,0,0,0,0
BADHBER,PESHAWAR,TEHSIL,MUSLIM,438929,216376,222551,2,438929,216376,222551,2,0,0,0,0
BADHBER,PESHAWAR,TEHSIL,OTHERS,10,6,4,0,10,6,4,0,0,0,0,0
BADHBER,PESHAWAR,TEHSIL,PARSI,0,0,0,0,0,0,0,0,0,0,0,0
BADHBER,PESHAWAR,TEHSIL,SCHEDULED CASTE,8,2,6,0,8,2,6,0,0,0,0,0
BADHBER,PESHAWAR,TEHSIL,SIKH,5,2,3,0,5,2,3,0,0,0,0,0
BAFFA PAKHAL,MANSEHRA,TEHSIL,QADIANI/AHMADI,1,1,0,0,1,1,0,0,0,0,0,0
BAFFA PAKHAL,MANSEHRA,TEHSIL,CHRISTIAN,973,507,466,0,903,467,436,0,70,40,30,0
BAFFA PAKHAL,MANSEHRA,TEHSIL,HINDU JATI,8,2,6,0,8,2,6,0,0,0,0,0
BAFFA PAKHAL,MANSEHRA,TEHSIL,MUSLIM,454351,221924,232412,15,436922,213548,223361,13,17429,8376,9051,2
BAFFA PAKHAL,MANSEHRA,TEHSIL,OTHERS,201,125,76,0,199,123,76,0,2,2,0,0
BAFFA PAKHAL,MANSEHRA,TEHSIL,PARSI,0,0,0,0,0,0,0,0,0,0,0,0
BAFFA PAKHAL,MANSEHRA,TEHSIL,SCHEDULED CASTE,3,0,3,0,3,0,3,0,0,0,0,0
BAFFA PAKHAL,MANSEHRA,TEHSIL,SIKH,7,3,4,0,7,3,4,0,0,0,0,0
BAJAUR,BAJAUR,DISTRICT,QADIANI/AHMADI,21,10,11,0,21,10,11,0,0,0,0,0
BAJAUR,BAJAUR,DISTRICT,CHRISTIAN,3068,1651,1417,0,3068,1651,1417,0,0,0,0,0
BAJAUR,BAJAUR,DISTRICT,HINDU JATI,34,19,15,0,34,19,15,0,0,0,0,0
BAJAUR,BAJAUR,DISTRICT,MUSLIM,1279889,632888,646986,15,1279889,632888,646986,15,0,0,0,0
BAJAUR,BAJAUR,DISTRICT,OTHERS,63,37,26,0,63,37,26,0,0,0,0,0
BAJAUR,BAJAUR,DISTRICT,PARSI,0,0,0,0,0,0,0,0,0,0,0,0
BAJAUR,BAJAUR,DISTRICT,SCHEDULED CASTE,16,8,8,0,16,8,8,0,0,0,0,0
BAJAUR,BAJAUR,DISTRICT,SIKH,22,12,10,0,22,12,10,0,0,0,0,0
BAKKA KHEL,BANNU,TEHSIL,QADIANI/AHMADI,3,1,2,0,3,1,2,0,0,0,0,0
BAKKA KHEL,BANNU,TEHSIL,CHRISTIAN,836,422,414,0,836,422,414,0,0,0,0,0
BAKKA KHEL,BANNU,TEHSIL,HINDU JATI,0,0,0,0,0,0,0,0,0,0,0,0
BAKKA KHEL,BANNU,TEHSIL,MUSLIM,191878,92297,99581,0,191878,92297,99581,0,0,0,0,0
BAKKA KHEL,BANNU,TEHSIL,OTHERS,14,7,7,0,14,7,7,0,0,0,0,0
BAKKA KHEL,BANNU,TEHSIL,PARSI,0,0,0,0,0,0,0,0,0,0,0,0
BAKKA KHEL,BANNU,TEHSIL,SCHEDULED CASTE,1,1,0,0,1,1,0,0,0,0,0,0
BAKKA KHEL,BANNU,TEHSIL,SIKH,0,0,0,0,0,0,0,0,0,0,0,0
BALAKOT,MANSEHRA,TEHSIL,QADIANI/AHMADI,6,3,3,0,6,3,3,0,0,0,0,0
BALAKOT,MANSEHRA,TEHSIL,CHRISTIAN,661,369,292,0,661,369,292,0,0,0,0,0
BALAKOT,MANSEHRA,TEHSIL,HINDU JATI,5,3,2,0,5,3,2,0,0,0,0,0
BALAKOT,MANSEHRA,TEHSIL,MUSLIM,309363,152537,156809,17,309363,152537,156809,17,0,0,0,0
BALAKOT,MANSEHRA,TEHSIL,OTHERS,118,68,50,0,118,68,50,0,0,0,0,0
BALAKOT,MANSEHRA,TEHSIL,PARSI,2,1,1,0,2,1,1,0,0,0,0,0
BALAKOT,MANSEHRA,TEHSIL,SCHEDULED CASTE,2,1,1,0,2,1,1,0,0,0,0,0
BALAKOT,MANSEHRA,TEHSIL,SIKH,7,5,2,0,7,5,2,0,0,0,0,0
BANDA DAUD SHAH,KARAK,TEHSIL,QADIANI/AHMADI,1,0,1,0,1,0,1,0,0,0,0,0
BANDA DAUD SHAH,KARAK,TEHSIL,CHRISTIAN,348,174,174,0,348,174,174,0,0,0,0,0
BANDA DAUD SHAH,KARAK,TEHSIL,HINDU JATI,0,0,0,0,0,0,0,0,0,0,0,0
BANDA DAUD SHAH,KARAK,TEHSIL,MUSLIM,176777,87911,88865,1,176777,87911,88865,1,0,0,0,0
BANDA DAUD SHAH,KARAK,TEHSIL,OTHERS,9,6,3,0,9,6,3,0,0,0,0,0
BANDA DAUD SHAH,KARAK,TEHSIL,PARSI,1,0,1,0,1,0,1,0,0,0,0,0
BANDA DAUD SHAH,KARAK,TEHSIL,SCHEDULED CASTE,0,0,0,0,0,0,0,0,0,0,0,0
BANDA DAUD SHAH,KARAK,TEHSIL,SIKH,0,0,0,0,0,0,0,0,0,0,0,0
BANKAND RANOLIA,LOWER KOHISTAN,TEHSIL,QADIANI/AHMADI,1,0,1,0,1,0,1,0,0,0,0,0
BANKAND RANOLIA,LOWER KOHISTAN,TEHSIL,CHRISTIAN,546,270,276,0,546,270,276,0,0,0,0,0
BANKAND RANOLIA,LOWER KOHISTAN,TEHSIL,HINDU JATI,1,0,1,0,1,0,1,0,0,0,0,0
BANKAND RANOLIA,LOWER KOHISTAN,TEHSIL,MUSLIM,176436,85397,91032,7,176436,85397,91032,7,0,0,0,0
BANKAND RANOLIA,LOWER KOHISTAN,TEHSIL,OTHERS,67,41,26,0,67,41,26,0,0,0,0,0
BANKAND RANOLIA,LOWER KOHISTAN,TEHSIL,PARSI,0,0,0,0,0,0,0,0,0,0,0,0
BANKAND RANOLIA,LOWER KOHISTAN,TEHSIL,SCHEDULED CASTE,5,1,4,0,5,1,4,0,0,0,0,0
BANKAND RANOLIA,LOWER KOHISTAN,TEHSIL,SIKH,1,0,1,0,1,0,1,0,0,0,0,0
BANNU,BANNU,DISTRICT,QADIANI/AHMADI,68,35,33,0,68,35,33,0,0,0,0,0
BANNU,BANNU,DISTRICT,CHRISTIAN,4844,2527,2317,0,3572,1890,1682,0,1272,637,635,0
BANNU,BANNU,DISTRICT,HINDU JATI,236,120,116,0,121,70,51,0,115,50,65,0
BANNU,BANNU,DISTRICT,MUSLIM,1349359,647333,702008,18,1302684,625863,676810,11,46675,21470,25198,7
BANNU,BANNU,DISTRICT,OTHERS,101,47,53,1,68,34,33,1,33,13,20,0
BANNU,BANNU,DISTRICT,PARSI,1,0,1,0,1,0,1,0,0,0,0,0
BANNU,BANNU,DISTRICT,SCHEDULED CASTE,43,28,15,0,42,27,15,0,1,1,0,0
BANNU,BANNU,DISTRICT,SIKH,22,9,13,0,22,9,13,0,0,0,0,0
BANNU,BANNU,TEHSIL,QADIANI/AHMADI,6,3,3,0,6,3,3,0,0,0,0,0
BANNU,BANNU,TEHSIL,CHRISTIAN,2860,1488,1372,0,1588,851,737,0,1272,637,635,0
BANNU,BANNU,TEHSIL,HINDU JATI,158,72,86,0,43,22,21,0,115,50,65,0
BANNU,BANNU,TEHSIL,MUSLIM,639731,308908,330807,16,593056,287438,305609,9,46675,21470,25198,7
BANNU,BANNU,TEHSIL,OTHERS,65,30,34,1,32,17,14,1,33,13,20,0
BANNU,BANNU,TEHSIL,PARSI,1,0,1,0,1,0,1,0,0,0,0,0
BANNU,BANNU,TEHSIL,SCHEDULED CASTE,7,4,3,0,6,3,3,0,1,1,0,0
BANNU,BANNU,TEHSIL,SIKH,7,1,6,0,7,1,6,0,0,0,0,0
BAR CHAMER KAND,BAJAUR,TEHSIL,QADIANI/AHMADI,0,0,0,0,0,0,0,0,0,0,0,0
BAR CHAMER KAND,BAJAUR,TEHSIL,CHRISTIAN,1,1,0,0,1,1,0,0,0,0,0,0
BAR CHAMER KAND,BAJAUR,TEHSIL,HINDU JATI,0,0,0,0,0,0,0,0,0,0,0,0
BAR CHAMER KAND,BAJAUR,TEHSIL,MUSLIM,3573,1747,1825,1,3573,1747,1825,1,0,0,0,0
BAR CHAMER KAND,BAJAUR,TEHSIL,OTHERS,0,0,0,0,0,0,0,0,0,0,0,0
BAR CHAMER KAND,BAJAUR,TEHSIL,PARSI,0,0,0,0,0,0,0,0,0,0,0,0
BAR CHAMER KAND,BAJAUR,TEHSIL,SCHEDULED CASTE,0,0,0,0,0,0,0,0,0,0,0,0
BAR CHAMER KAND,BAJAUR,TEHSIL,SIKH,0,0,0,0,0,0,0,0,0,0,0,0
BARA,KHYBER,TEHSIL,QADIANI/AHMADI,5,0,5,0,5,0,5,0,0,0,0,0
BARA,KHYBER,TEHSIL,CHRISTIAN,1179,624,555,0,1179,624,555,0,0,0,0,0
BARA,KHYBER,TEHSIL,HINDU JATI,11,5,6,0,11,5,6,0,0,0,0,0
BARA,KHYBER,TEHSIL,MUSLIM,546815,263253,283557,5,546815,263253,283557,5,0,0,0,0
BARA,KHYBER,TEHSIL,OTHERS,40,24,15,1,40,24,15,1,0,0,0,0
BARA,KHYBER,TEHSIL,PARSI,0,0,0,0,0,0,0,0,0,0,0,0
BARA,KHYBER,TEHSIL,SCHEDULED CASTE,23,12,11,0,23,12,11,0,0,0,0,0
BARA,KHYBER,TEHSIL,SIKH,11,3,8,0,11,3,8,0,0,0,0,0
BARANG,BAJAUR,TEHSIL,QADIANI/AHMADI,3,2,1,0,3,2,1,0,0,0,0,0
BARANG,BAJAUR,TEHSIL,CHRISTIAN,103,62,41,0,103,62,41,0,0,0,0,0
BARANG,BAJAUR,TEHSIL,HINDU JATI,1,0,1,0,1,0,1,0,0,0,0,0
BARANG,BAJAUR,TEHSIL,MUSLIM,89873,44863,45010,0,89873,44863,45010,0,0,0,0,0
BARANG,BAJAUR,TEHSIL,OTHERS,0,0,0,0,0,0,0,0,0,0,0,0
BARANG,BAJAUR,TEHSIL,PARSI,0,0,0,0,0,0,0,0,0,0,0,0
BARANG,BAJAUR,TEHSIL,SCHEDULED CASTE,1,1,0,0,1,1,0,0,0,0,0,0
BARANG,BAJAUR,TEHSIL,SIKH,0,0,0,0,0,0,0,0,0,0,0,0
BARIKOT,SWAT,TEHSIL,QADIANI/AHMADI,0,0,0,0,0,0,0,0,0,0,0,0
BARIKOT,SWAT,TEHSIL,CHRISTIAN,411,235,176,0,239,144,95,0,172,91,81,0
BARIKOT,SWAT,TEHSIL,HINDU JATI,38,16,22,0,29,11,18,0,9,5,4,0
BARIKOT,SWAT,TEHSIL,MUSLIM,219357,108980,110375,2,104829,51101,53728,0,114528,57879,56647,2
BARIKOT,SWAT,TEHSIL,OTHERS,9,5,4,0,5,2,3,0,4,3,1,0
BARIKOT,SWAT,TEHSIL,PARSI,0,0,0,0,0,0,0,0,0,0,0,0
BARIKOT,SWAT,TEHSIL,SCHEDULED CASTE,2,0,2,0,1,0,1,0,1,0,1,0
BARIKOT,SWAT,TEHSIL,SIKH,26,17,9,0,0,0,0,0,26,17,9,0
BATAGRAM,BATAGRAM,DISTRICT,QADIANI/AHMADI,4,2,2,0,4,2,2,0,0,0,0,0
BATAGRAM,BATAGRAM,DISTRICT,CHRISTIAN,986,527,459,0,986,527,459,0,0,0,0,0
BATAGRAM,BATAGRAM,DISTRICT,HINDU JATI,61,26,35,0,61,26,35,0,0,0,0,0
BATAGRAM,BATAGRAM,DISTRICT,MUSLIM,552050,271715,280325,10,552050,271715,280325,10,0,0,0,0
BATAGRAM,BATAGRAM,DISTRICT,OTHERS,153,96,57,0,153,96,57,0,0,0,0,0
BATAGRAM,BATAGRAM,DISTRICT,PARSI,1,1,0,0,1,1,0,0,0,0,0,0
BATAGRAM,BATAGRAM,DISTRICT,SCHEDULED CASTE,8,6,2,0,8,6,2,0,0,0,0,0
BATAGRAM,BATAGRAM,DISTRICT,SIKH,22,9,13,0,22,9,13,0,0,0,0,0
BATAGRAM,BATAGRAM,TEHSIL,QADIANI/AHMADI,1,0,1,0,1,0,1,0,0,0,0,0
BATAGRAM,BATAGRAM,TEHSIL,CHRISTIAN,578,310,268,0,578,310,268,0,0,0,0,0
BATAGRAM,BATAGRAM,TEHSIL,HINDU JATI,60,25,35,0,60,25,35,0,0,0,0,0
BATAGRAM,BATAGRAM,TEHSIL,MUSLIM,334920,166364,168551,5,334920,166364,168551,5,0,0,0,0
BATAGRAM,BATAGRAM,TEHSIL,OTHERS,130,84,46,0,130,84,46,0,0,0,0,0
BATAGRAM,BATAGRAM,TEHSIL,PARSI,1,1,0,0,1,1,0,0,0,0,0,0
BATAGRAM,BATAGRAM,TEHSIL,SCHEDULED CASTE,8,6,2,0,8,6,2,0,0,0,0,0
BATAGRAM,BATAGRAM,TEHSIL,SIKH,21,8,13,0,21,8,13,0,0,0,0,0
BATTAIRA,KOLAI PALAS KOHISTAN,SUB-DIVISION,QADIANI/AHMADI,2,2,0,0,2,2,0,0,0,0,0,0
BATTAIRA,KOLAI PALAS KOHISTAN,SUB-DIVISION,CHRISTIAN,443,227,216,0,443,227,216,0,0,0,0,0
BATTAIRA,KOLAI PALAS KOHISTAN,SUB-DIVISION,HINDU JATI,19,14,5,0,19,14,5,0,0,0,0,0
BATTAIRA,KOLAI PALAS KOHISTAN,SUB-DIVISION,MUSLIM,139374,67156,72217,1,139374,67156,72217,1,0,0,0,0
BATTAIRA,KOLAI PALAS KOHISTAN,SUB-DIVISION,OTHERS,123,60,63,0,123,60,63,0,0,0,0,0
BATTAIRA,KOLAI PALAS KOHISTAN,SUB-DIVISION,PARSI,2,1,1,0,2,1,1,0,0,0,0,0
BATTAIRA,KOLAI PALAS KOHISTAN,SUB-DIVISION,SCHEDULED CASTE,5,3,2,0,5,3,2,0,0,0,0,0
BATTAIRA,KOLAI PALAS KOHISTAN,SUB-DIVISION,SIKH,8,3,5,0,8,3,5,0,0,0,0,0
BEHRAIN,SWAT,TEHSIL,QADIANI/AHMADI,4,3,1,0,2,2,0,0,2,1,1,0
BEHRAIN,SWAT,TEHSIL,CHRISTIAN,383,212,171,0,193,110,83,0,190,102,88,0
BEHRAIN,SWAT,TEHSIL,HINDU JATI,3,1,2,0,2,1,1,0,1,0,1,0
BEHRAIN,SWAT,TEHSIL,MUSLIM,269896,130786,139104,6,193376,93137,100235,4,76520,37649,38869,2
BEHRAIN,SWAT,TEHSIL,OTHERS,327,176,151,0,316,170,146,0,11,6,5,0
BEHRAIN,SWAT,TEHSIL,PARSI,2,2,0,0,2,2,0,0,0,0,0,0
BEHRAIN,SWAT,TEHSIL,SCHEDULED CASTE,0,0,0,0,0,0,0,0,0,0,0,0
BEHRAIN,SWAT,TEHSIL,SIKH,5,2,3,0,4,2,2,0,1,0,1,0
BETTANI,LAKKI MARWAT,SUB-DIVISION,QADIANI/AHMADI,0,0,0,0,0,0,0,0,0,0,0,0
BETTANI,LAKKI MARWAT,SUB-DIVISION,CHRISTIAN,53,37,16,0,53,37,16,0,0,0,0,0
BETTANI,LAKKI MARWAT,SUB-DIVISION,HINDU JATI,0,0,0,0,0,0,0,0,0,0,0,0
BETTANI,LAKKI MARWAT,SUB-DIVISION,MUSLIM,35517,17243,18274,0,35517,17243,18274,0,0,0,0,0
BETTANI,LAKKI MARWAT,SUB-DIVISION,OTHERS,0,0,0,0,0,0,0,0,0,0,0,0
BETTANI,LAKKI MARWAT,SUB-DIVISION,PARSI,0,0,0,0,0,0,0,0,0,0,0,0
BETTANI,LAKKI MARWAT,SUB-DIVISION,SCHEDULED CASTE,0,0,0,0,0,0,0,0,0,0,0,0
BETTANI,LAKKI MARWAT,SUB-DIVISION,SIKH,0,0,0,0,0,0,0,0,0,0,0,0
BIRMIL,SOUTH WAZIRISTAN,TEHSIL,QADIANI/AHMADI,1,1,0,0,1,1,0,0,0,0,0,0
BIRMIL,SOUTH WAZIRISTAN,TEHSIL,CHRISTIAN,103,43,60,0,103,43,60,0,0,0,0,0
BIRMIL,SOUTH WAZIRISTAN,TEHSIL,HINDU JATI,0,0,0,0,0,0,0,0,0,0,0,0
BIRMIL,SOUTH WAZIRISTAN,TEHSIL,MUSLIM,112648,56321,56326,1,112648,56321,56326,1,0,0,0,0
BIRMIL,SOUTH WAZIRISTAN,TEHSIL,OTHERS,3,2,1,0,3,2,1,0,0,0,0,0
BIRMIL,SOUTH WAZIRISTAN,TEHSIL,PARSI,0,0,0,0,0,0,0,0,0,0,0,0
BIRMIL,SOUTH WAZIRISTAN,TEHSIL,SCHEDULED CASTE,1,1,0,0,1,1,0,0,0,0,0,0
BIRMIL,SOUTH WAZIRISTAN,TEHSIL,SIKH,1,0,1,0,1,0,1,0,0,0,0,0
BISHAM,SHANGLA,TEHSIL,QADIANI/AHMADI,0,0,0,0,0,0,0,0,0,0,0,0
BISHAM,SHANGLA,TEHSIL,CHRISTIAN,186,93,93,0,186,93,93,0,0,0,0,0
BISHAM,SHANGLA,TEHSIL,HINDU JATI,0,0,0,0,0,0,0,0,0,0,0,0
BISHAM,SHANGLA,TEHSIL,MUSLIM,121048,59094,61953,1,121048,59094,61953,1,0,0,0,0
BISHAM,SHANGLA,TEHSIL,OTHERS,13,8,5,0,13,8,5,0,0,0,0,0
BISHAM,SHANGLA,TEHSIL,PARSI,0,0,0,0,0,0,0,0,0,0,0,0
BISHAM,SHANGLA,TEHSIL,SCHEDULED CASTE,0,0,0,0,0,0,0,0,0,0,0,0
BISHAM,SHANGLA,TEHSIL,SIKH,5,2,3,0,5,2,3,0,0,0,0,0
BUNER,BUNER,DISTRICT,QADIANI/AHMADI,17,9,8,0,17,9,8,0,0,0,0,0
BUNER,BUNER,DISTRICT,CHRISTIAN,1872,1018,854,0,1872,1018,854,0,0,0,0,0
BUNER,BUNER,DISTRICT,HINDU JATI,131,68,63,0,131,68,63,0,0,0,0,0
BUNER,BUNER,DISTRICT,MUSLIM,1013575,506931,506616,28,1013575,506931,506616,28,0,0,0,0
BUNER,BUNER,DISTRICT,OTHERS,46,29,17,0,46,29,17,0,0,0,0,0
BUNER,BUNER,DISTRICT,PARSI,0,0,0,0,0,0,0,0,0,0,0,0
BUNER,BUNER,DISTRICT,SCHEDULED CASTE,10,2,8,0,10,2,8,0,0,0,0,0
BUNER,BUNER,DISTRICT,SIKH,1023,510,513,0,1023,510,513,0,0,0,0,0
CENTRAL,ORAKZAI,TEHSIL,QADIANI/AHMADI,6,2,4,0,6,2,4,0,0,0,0,0
CENTRAL,ORAKZAI,TEHSIL,CHRISTIAN,132,75,57,0,132,75,57,0,0,0,0,0
CENTRAL,ORAKZAI,TEHSIL,HINDU JATI,1,1,0,0,1,1,0,0,0,0,0,0
CENTRAL,ORAKZAI,TEHSIL,MUSLIM,92670,43780,48888,2,92670,43780,48888,2,0,0,0,0
CENTRAL,ORAKZAI,TEHSIL,OTHERS,7,4,3,0,7,4,3,0,0,0,0,0
CENTRAL,ORAKZAI,TEHSIL,PARSI,0,0,0,0,0,0,0,0,0,0,0,0
CENTRAL,ORAKZAI,TEHSIL,SCHEDULED CASTE,2,1,1,0,2,1,1,0,0,0,0,0
CENTRAL,ORAKZAI,TEHSIL,SIKH,1,1,0,0,1,1,0,0,0,0,0,0
CENTRAL KURRAM F.R,KURRAM,TEHSIL,QADIANI/AHMADI,4,1,3,0,4,1,3,0,0,0,0,0
CENTRAL KURRAM F.R,KURRAM,TEHSIL,CHRISTIAN,859,424,435,0,859,424,435,0,0,0,0,0
CENTRAL KURRAM F.R,KURRAM,TEHSIL,HINDU JATI,5,2,3,0,5,2,3,0,0,0,0,0
CENTRAL KURRAM F.R,KURRAM,TEHSIL,MUSLIM,357787,167776,190004,7,357787,167776,190004,7,0,0,0,0
CENTRAL KURRAM F.R,KURRAM,TEHSIL,OTHERS,8,4,4,0,8,4,4,0,0,0,0,0
CENTRAL KURRAM F.R,KURRAM,TEHSIL,PARSI,0,0,0,0,0,0,0,0,0,0,0,0
CENTRAL KURRAM F.R,KURRAM,TEHSIL,SCHEDULED CASTE,3,1,2,0,3,1,2,0,0,0,0,0
CENTRAL KURRAM F.R,KURRAM,TEHSIL,SIKH,4,2,2,0,4,2,2,0,0,0,0,0
CHAGHARZAI,BUNER,TEHSIL,QADIANI/AHMADI,0,0,0,0,0,0,0,0,0,0,0,0
CHAGHARZAI,BUNER,TEHSIL,CHRISTIAN,325,176,149,0,325,176,149,0,0,0,0,0
CHAGHARZAI,BUNER,TEHSIL,HINDU JATI,1,1,0,0,1,1,0,0,0,0,0,0
CHAGHARZAI,BUNER,TEHSIL,MUSLIM,125587,62849,62734,4,125587,62849,62734,4,0,0,0,0
CHAGHARZAI,BUNER,TEHSIL,OTHERS,4,3,1,0,4,3,1,0,0,0,0,0
CHAGHARZAI,BUNER,TEHSIL,PARSI,0,0,0,0,0,0,0,0,0,0,0,0
CHAGHARZAI,BUNER,TEHSIL,SCHEDULED CASTE,1,0,1,0,1,0,1,0,0,0,0,0
CHAGHARZAI,BUNER,TEHSIL,SIKH,1,0,1,0,1,0,1,0,0,0,0,0
CHAKISAR,SHANGLA,TEHSIL,QADIANI/AHMADI,0,0,0,0,0,0,0,0,0,0,0,0
CHAKISAR,SHANGLA,TEHSIL,CHRISTIAN,382,196,186,0,382,196,186,0,0,0,0,0
CHAKISAR,SHANGLA,TEHSIL,HINDU JATI,0,0,0,0,0,0,0,0,0,0,0,0
CHAKISAR,SHANGLA,TEHSIL,MUSLIM,127527,62559,64967,1,127527,62559,64967,1,0,0,0,0
CHAKISAR,SHANGLA,TEHSIL,OTHERS,47,25,22,0,47,25,22,0,0,0,0,0
CHAKISAR,SHANGLA,TEHSIL,PARSI,0,0,0,0,0,0,0,0,0,0,0,0
CHAKISAR,SHANGLA,TEHSIL,SCHEDULED CASTE,1,1,0,0,1,1,0,0,0,0,0,0
CHAKISAR,SHANGLA,TEHSIL,SIKH,36,15,21,0,36,15,21,0,0,0,0,0
CHAM KANI,PESHAWAR,TEHSIL,QADIANI/AHMADI,10,9,1,0,10,9,1,0,0,0,0,0
CHAM KANI,PESHAWAR,TEHSIL,CHRISTIAN,2254,1192,1062,0,2254,1192,1062,0,0,0,0,0
CHAM KANI,PESHAWAR,TEHSIL,HINDU JATI,10,4,6,0,10,4,6,0,0,0,0,0
CHAM KANI,PESHAWAR,TEHSIL,MUSLIM,621989,307397,314581,11,621989,307397,314581,11,0,0,0,0
CHAM KANI,PESHAWAR,TEHSIL,OTHERS,80,45,34,1,80,45,34,1,0,0,0,0
CHAM KANI,PESHAWAR,TEHSIL,PARSI,0,0,0,0,0,0,0,0,0,0,0,0
CHAM KANI,PESHAWAR,TEHSIL,SCHEDULED CASTE,3,1,2,0,3,1,2,0,0,0,0,0
CHAM KANI,PESHAWAR,TEHSIL,SIKH,8,6,2,0,8,6,2,0,0,0,0,0
CHARBAGH,SWAT,TEHSIL,QADIANI/AHMADI,1,1,0,0,1,1,0,0,0,0,0,0
CHARBAGH,SWAT,TEHSIL,CHRISTIAN,268,139,129,0,268,139,129,0,0,0,0,0
CHARBAGH,SWAT,TEHSIL,HINDU JATI,0,0,0,0,0,0,0,0,0,0,0,0
CHARBAGH,SWAT,TEHSIL,MUSLIM,158998,76985,82012,1,158998,76985,82012,1,0,0,0,0
CHARBAGH,SWAT,TEHSIL,OTHERS,1,0,1,0,1,0,1,0,0,0,0,0
CHARBAGH,SWAT,TEHSIL,PARSI,0,0,0,0,0,0,0,0,0,0,0,0
CHARBAGH,SWAT,TEHSIL,SCHEDULED CASTE,1,0,1,0,1,0,1,0,0,0,0,0
CHARBAGH,SWAT,TEHSIL,SIKH,0,0,0,0,0,0,0,0,0,0,0,0
CHARSADDA,CHARSADDA,DISTRICT,QADIANI/AHMADI,22,10,12,0,20,10,10,0,2,0,2,0
CHARSADDA,CHARSADDA,DISTRICT,CHRISTIAN,4392,2353,2039,0,3286,1779,1507,0,1106,574,532,0
CHARSADDA,CHARSADDA,DISTRICT,HINDU JATI,18,10,8,0,11,7,4,0,7,3,4,0
CHARSADDA,CHARSADDA,DISTRICT,MUSLIM,1830646,882027,948600,19,1539359,741963,797380,16,291287,140064,151220,3
CHARSADDA,CHARSADDA,DISTRICT,OTHERS,21,10,11,0,18,9,9,0,3,1,2,0
CHARSADDA,CHARSADDA,DISTRICT,PARSI,0,0,0,0,0,0,0,0,0,0,0,0
CHARSADDA,CHARSADDA,DISTRICT,SCHEDULED CASTE,23,7,16,0,17,6,11,0,6,1,5,0
CHARSADDA,CHARSADDA,DISTRICT,SIKH,14,2,12,0,10,2,8,0,4,0,4,0
CHARSADDA,CHARSADDA,TEHSIL,QADIANI/AHMADI,10,4,6,0,9,4,5,0,1,0,1,0
CHARSADDA,CHARSADDA,TEHSIL,CHRISTIAN,2157,1129,1028,0,1605,851,754,0,552,278,274,0
CHARSADDA,CHARSADDA,TEHSIL,HINDU JATI,1,1,0,0,1,1,0,0,0,0,0,0
CHARSADDA,CHARSADDA,TEHSIL,MUSLIM,907244,434582,472654,8,753378,360280,393092,6,153866,74302,79562,2
CHARSADDA,CHARSADDA,TEHSIL,OTHERS,10,6,4,0,7,5,2,0,3,1,2,0
CHARSADDA,CHARSADDA,TEHSIL,PARSI,0,0,0,0,0,0,0,0,0,0,0,0
CHARSADDA,CHARSADDA,TEHSIL,SCHEDULED CASTE,8,4,4,0,6,3,3,0,2,1,1,0
CHARSADDA,CHARSADDA,TEHSIL,SIKH,8,1,7,0,5,1,4,0,3,0,3,0
CHITRAL,LOWER CHITRAL,SUB-DIVISION,QADIANI/AHMADI,1,0,1,0,0,0,0,0,1,0,1,0
CHITRAL,LOWER CHITRAL,SUB-DIVISION,CHRISTIAN,349,192,157,0,203,125,78,0,146,67,79,0
CHITRAL,LOWER CHITRAL,SUB-DIVISION,HINDU JATI,0,0,0,0,0,0,0,0,0,0,0,0
CHITRAL,LOWER CHITRAL,SUB-DIVISION,MUSLIM,205439,100614,104825,0,150233,73753,76480,0,55206,26861,28345,0
CHITRAL,LOWER CHITRAL,SUB-DIVISION,OTHERS,3509,1737,1772,0,3341,1641,1700,0,168,96,72,0
CHITRAL,LOWER CHITRAL,SUB-DIVISION,PARSI,0,0,0,0,0,0,0,0,0,0,0,0
CHITRAL,LOWER CHITRAL,SUB-DIVISION,SCHEDULED CASTE,2,1,1,0,0,0,0,0,2,1,1,0
CHITRAL,LOWER CHITRAL,SUB-DIVISION,SIKH,1,1,0,0,0,0,0,0,1,1,0,0
DAGGAR,BUNER,TEHSIL,QADIANI/AHMADI,8,7,1,0,8,7,1,0,0,0,0,0
DAGGAR,BUNER,TEHSIL,CHRISTIAN,381,218,163,0,381,218,163,0,0,0,0,0
DAGGAR,BUNER,TEHSIL,HINDU JATI,0,0,0,0,0,0,0,0,0,0,0,0
DAGGAR,BUNER,TEHSIL,MUSLIM,192300,97071,95228,1,192300,97071,95228,1,0,0,0,0
DAGGAR,BUNER,TEHSIL,OTHERS,9,4,5,0,9,4,5,0,0,0,0,0
DAGGAR,BUNER,TEHSIL,PARSI,0,0,0,0,0,0,0,0,0,0,0,0
DAGGAR,BUNER,TEHSIL,SCHEDULED CASTE,5,2,3,0,5,2,3,0,0,0,0,0
DAGGAR,BUNER,TEHSIL,SIKH,46,22,24,0,46,22,24,0,0,0,0,0
DARABAN,DERA ISMAIL KHAN,TEHSIL,QADIANI/AHMADI,0,0,0,0,0,0,0,0,0,0,0,0
DARABAN,DERA ISMAIL KHAN,TEHSIL,CHRISTIAN,202,108,94,0,202,108,94,0,0,0,0,0
DARABAN,DERA ISMAIL KHAN,TEHSIL,HINDU JATI,0,0,0,0,0,0,0,0,0,0,0,0
DARABAN,DERA ISMAIL KHAN,TEHSIL,MUSLIM,149242,70165,79076,1,149242,70165,79076,1,0,0,0,0
DARABAN,DERA ISMAIL KHAN,TEHSIL,OTHERS,2,2,0,0,2,2,0,0,0,0,0,0
DARABAN,DERA ISMAIL KHAN,TEHSIL,PARSI,0,0,0,0,0,0,0,0,0,0,0,0
DARABAN,DERA ISMAIL KHAN,TEHSIL,SCHEDULED CASTE,1,0,1,0,1,0,1,0,0,0,0,0
DARABAN,DERA ISMAIL KHAN,TEHSIL,SIKH,0,0,0,0,0,0,0,0,0,0,0,0
DARBAND,MANSEHRA,TEHSIL,QADIANI/AHMADI,0,0,0,0,0,0,0,0,0,0,0,0
DARBAND,MANSEHRA,TEHSIL,CHRISTIAN,143,88,55,0,143,88,55,0,0,0,0,0
DARBAND,MANSEHRA,TEHSIL,HINDU JATI,6,2,4,0,6,2,4,0,0,0,0,0
DARBAND,MANSEHRA,TEHSIL,MUSLIM,51547,26619,24927,1,51547,26619,24927,1,0,0,0,0
DARBAND,MANSEHRA,TEHSIL,OTHERS,5,2,3,0,5,2,3,0,0,0,0,0
DARBAND,MANSEHRA,TEHSIL,PARSI,0,0,0,0,0,0,0,0,0,0,0,0
DARBAND,MANSEHRA,TEHSIL,SCHEDULED CASTE,0,0,0,0,0,0,0,0,0,0,0,0
DARBAND,MANSEHRA,TEHSIL,SIKH,1,1,0,0,1,1,0,0,0,0,0,0
DARRA ADAM KHEL,KOHAT,SUB-DIVISION,QADIANI/AHMADI,0,0,0,0,0,0,0,0,0,0,0,0
DARRA ADAM KHEL,KOHAT,SUB-DIVISION,CHRISTIAN,254,135,119,0,254,135,119,0,0,0,0,0
DARRA ADAM KHEL,KOHAT,SUB-DIVISION,HINDU JATI,0,0,0,0,0,0,0,0,0,0,0,0
DARRA ADAM KHEL,KOHAT,SUB-DIVISION,MUSLIM,139579,69036,70543,0,139579,69036,70543,0,0,0,0,0
DARRA ADAM KHEL,KOHAT,SUB-DIVISION,OTHERS,3,0,3,0,3,0,3,0,0,0,0,0
DARRA ADAM KHEL,KOHAT,SUB-DIVISION,PARSI,0,0,0,0,0,0,0,0,0,0,0,0
DARRA ADAM KHEL,KOHAT,SUB-DIVISION,SCHEDULED CASTE,1,0,1,0,1,0,1,0,0,0,0,0
DARRA ADAM KHEL,KOHAT,SUB-DIVISION,SIKH,2,1,1,0,2,1,1,0,0,0,0,0
DASSU,UPPER KOHISTAN,SUB-DIVISION,QADIANI/AHMADI,1,0,1,0,1,0,1,0,0,0,0,0
DASSU,UPPER KOHISTAN,SUB-DIVISION,CHRISTIAN,233,119,114,0,233,119,114,0,0,0,0,0
DASSU,UPPER KOHISTAN,SUB-DIVISION,HINDU JATI,0,0,0,0,0,0,0,0,0,0,0,0
DASSU,UPPER KOHISTAN,SUB-DIVISION,MUSLIM,133349,63928,69420,1,133349,63928,69420,1,0,0,0,0
DASSU,UPPER KOHISTAN,SUB-DIVISION,OTHERS,25,7,18,0,25,7,18,0,0,0,0,0
DASSU,UPPER KOHISTAN,SUB-DIVISION,PARSI,2,0,2,0,2,0,2,0,0,0,0,0
DASSU,UPPER KOHISTAN,SUB-DIVISION,SCHEDULED CASTE,0,0,0,0,0,0,0,0,0,0,0,0
DASSU,UPPER KOHISTAN,SUB-DIVISION,SIKH,0,0,0,0,0,0,0,0,0,0,0,0
DATTA KHEL,NORTH WAZIRISTAN,TEHSIL,QADIANI/AHMADI,1,1,0,0,1,1,0,0,0,0,0,0
DATTA KHEL,NORTH WAZIRISTAN,TEHSIL,CHRISTIAN,178,100,78,0,178,100,78,0,0,0,0,0
DATTA KHEL,NORTH WAZIRISTAN,TEHSIL,HINDU JATI,0,0,0,0,0,0,0,0,0,0,0,0
DATTA KHEL,NORTH WAZIRISTAN,TEHSIL,MUSLIM,92016,45875,46140,1,92016,45875,46140,1,0,0,0,0
DATTA KHEL,NORTH WAZIRISTAN,TEHSIL,OTHERS,0,0,0,0,0,0,0,0,0,0,0,0
DATTA KHEL,NORTH WAZIRISTAN,TEHSIL,PARSI,0,0,0,0,0,0,0,0,0,0,0,0
DATTA KHEL,NORTH WAZIRISTAN,TEHSIL,SCHEDULED CASTE,1,0,1,0,1,0,1,0,0,0,0,0
DATTA KHEL,NORTH WAZIRISTAN,TEHSIL,SIKH,0,0,0,0,0,0,0,0,0,0,0,0
DAUR MERA,TORGHAR,TEHSIL,QADIANI/AHMADI,0,0,0,0,0,0,0,0,0,0,0,0
DAUR MERA,TORGHAR,TEHSIL,CHRISTIAN,87,45,42,0,87,45,42,0,0,0,0,0
DAUR MERA,TORGHAR,TEHSIL,HINDU JATI,0,0,0,0,0,0,0,0,0,0,0,0
DAUR MERA,TORGHAR,TEHSIL,MUSLIM,50415,24519,25894,2,50415,24519,25894,2,0,0,0,0
DAUR MERA,TORGHAR,TEHSIL,OTHERS,0,0,0,0,0,0,0,0,0,0,0,0
DAUR MERA,TORGHAR,TEHSIL,PARSI,0,0,0,0,0,0,0,0,0,0,0,0
DAUR MERA,TORGHAR,TEHSIL,SCHEDULED CASTE,1,1,0,0,1,1,0,0,0,0,0,0
DAUR MERA,TORGHAR,TEHSIL,SIKH,0,0,0,0,0,0,0,0,0,0,0,0
DERA ISMAIL KHAN,DERA ISMAIL KHAN,DISTRICT,QADIANI/AHMADI,13,5,8,0,6,2,4,0,7,3,4,0
DERA ISMAIL KHAN,DERA ISMAIL KHAN,DISTRICT,CHRISTIAN,5645,2849,2795,1,2935,1524,1411,0,2710,1325,1384,1
DERA ISMAIL KHAN,DERA ISMAIL KHAN,DISTRICT,HINDU JATI,668,338,330,0,93,49,44,0,575,289,286,0
DERA ISMAIL KHAN,DERA ISMAIL KHAN,DISTRICT,MUSLIM,1816418,863400,952868,150,1448333,689216,759104,13,368085,174184,193764,137
DERA ISMAIL KHAN,DERA ISMAIL KHAN,DISTRICT,OTHERS,85,43,42,0,60,30,30,0,25,13,12,0
DERA ISMAIL KHAN,DERA ISMAIL KHAN,DISTRICT,PARSI,0,0,0,0,0,0,0,0,0,0,0,0
DERA ISMAIL KHAN,DERA ISMAIL KHAN,DISTRICT,SCHEDULED CASTE,29,8,21,0,18,5,13,0,11,3,8,0
DERA ISMAIL KHAN,DERA ISMAIL KHAN,DISTRICT,SIKH,58,24,34,0,9,2,7,0,49,22,27,0
DERA ISMAIL KHAN,DERA ISMAIL KHAN,TEHSIL,QADIANI/AHMADI,8,3,5,0,3,0,3,0,5,3,2,0
DERA ISMAIL KHAN,DERA ISMAIL KHAN,TEHSIL,CHRISTIAN,3657,1835,1821,1,1184,639,545,0,2473,1196,1276,1
DERA ISMAIL KHAN,DERA ISMAIL KHAN,TEHSIL,HINDU JATI,587,295,292,0,12,6,6,0,575,289,286,0
DERA ISMAIL KHAN,DERA ISMAIL KHAN,TEHSIL,MUSLIM,758839,358904,399797,138,544515,257961,286549,5,214324,100943,113248,133
DERA ISMAIL KHAN,DERA ISMAIL KHAN,TEHSIL,OTHERS,36,16,20,0,15,6,9,0,21,10,11,0
DERA ISMAIL KHAN,DERA ISMAIL KHAN,TEHSIL,PARSI,0,0,0,0,0,0,0,0,0,0,0,0
DERA ISMAIL KHAN,DERA ISMAIL KHAN,TEHSIL,SCHEDULED CASTE,19,7,12,0,8,4,4,0,11,3,8,0
DERA ISMAIL KHAN,DERA ISMAIL KHAN,TEHSIL,SIKH,49,21,28,0,3,0,3,0,46,21,25,0
DIR,UPPER DIR,SUB-DIVISION,QADIANI/AHMADI,5,3,2,0,5,3,2,0,0,0,0,0
DIR,UPPER DIR,SUB-DIVISION,CHRISTIAN,633,341,292,0,575,310,265,0,58,31,27,0
DIR,UPPER DIR,SUB-DIVISION,HINDU JATI,4,3,1,0,2,2,0,0,2,1,1,0
DIR,UPPER DIR,SUB-DIVISION,MUSLIM,382866,191944,190917,5,336091,168965,167122,4,46775,22979,23795,1
DIR,UPPER DIR,SUB-DIVISION,OTHERS,24,12,12,0,21,12,9,0,3,0,3,0
DIR,UPPER DIR,SUB-DIVISION,PARSI,0,0,0,0,0,0,0,0,0,0,0,0
DIR,UPPER DIR,SUB-DIVISION,SCHEDULED CASTE,7,4,3,0,7,4,3,0,0,0,0,0
DIR,UPPER DIR,SUB-DIVISION,SIKH,2,1,1,0,2,1,1,0,0,0,0,0
DOMEL,BANNU,TEHSIL,QADIANI/AHMADI,54,29,25,0,54,29,25,0,0,0,0,0
DOMEL,BANNU,TEHSIL,CHRISTIAN,506,256,250,0,506,256,250,0,0,0,0,0
DOMEL,BANNU,TEHSIL,HINDU JATI,76,47,29,0,76,47,29,0,0,0,0,0
DOMEL,BANNU,TEHSIL,MUSLIM,222849,103304,119545,0,222849,103304,119545,0,0,0,0,0
DOMEL,BANNU,TEHSIL,OTHERS,11,2,9,0,11,2,9,0,0,0,0,0
DOMEL,BANNU,TEHSIL,PARSI,0,0,0,0,0,0,0,0,0,0,0,0
DOMEL,BANNU,TEHSIL,SCHEDULED CASTE,29,18,11,0,29,18,11,0,0,0,0,0
DOMEL,BANNU,TEHSIL,SIKH,9,4,5,0,9,4,5,0,0,0,0,0
DOSSALI,NORTH WAZIRISTAN,TEHSIL,QADIANI/AHMADI,0,0,0,0,0,0,0,0,0,0,0,0
DOSSALI,NORTH WAZIRISTAN,TEHSIL,CHRISTIAN,89,39,50,0,89,39,50,0,0,0,0,0
DOSSALI,NORTH WAZIRISTAN,TEHSIL,HINDU JATI,0,0,0,0,0,0,0,0,0,0,0,0
DOSSALI,NORTH WAZIRISTAN,TEHSIL,MUSLIM,50432,25186,25246,0,50432,25186,25246,0,0,0,0,0
DOSSALI,NORTH WAZIRISTAN,TEHSIL,OTHERS,0,0,0,0,0,0,0,0,0,0,0,0
DOSSALI,NORTH WAZIRISTAN,TEHSIL,PARSI,0,0,0,0,0,0,0,0,0,0,0,0
DOSSALI,NORTH WAZIRISTAN,TEHSIL,SCHEDULED CASTE,3,1,2,0,3,1,2,0,0,0,0,0
DOSSALI,NORTH WAZIRISTAN,TEHSIL,SIKH,0,0,0,0,0,0,0,0,0,0,0,0
DRAZANDA,DERA ISMAIL KHAN,SUB-DIVISION,QADIANI/AHMADI,2,1,1,0,2,1,1,0,0,0,0,0
DRAZANDA,DERA ISMAIL KHAN,SUB-DIVISION,CHRISTIAN,166,78,88,0,166,78,88,0,0,0,0,0
DRAZANDA,DERA ISMAIL KHAN,SUB-DIVISION,HINDU JATI,5,2,3,0,5,2,3,0,0,0,0,0
DRAZANDA,DERA ISMAIL KHAN,SUB-DIVISION,MUSLIM,82209,38629,43580,0,82209,38629,43580,0,0,0,0,0
DRAZANDA,DERA ISMAIL KHAN,SUB-DIVISION,OTHERS,3,1,2,0,3,1,2,0,0,0,0,0
DRAZANDA,DERA ISMAIL KHAN,SUB-DIVISION,PARSI,0,0,0,0,0,0,0,0,0,0,0,0
DRAZANDA,DERA ISMAIL KHAN,SUB-DIVISION,SCHEDULED CASTE,1,0,1,0,1,0,1,0,0,0,0,0
DRAZANDA,DERA ISMAIL KHAN,SUB-DIVISION,SIKH,0,0,0,0,0,0,0,0,0,0,0,0
DROSH,LOWER CHITRAL,SUB-DIVISION,QADIANI/AHMADI,1,1,0,0,1,1,0,0,0,0,0,0
DROSH,LOWER CHITRAL,SUB-DIVISION,CHRISTIAN,160,89,71,0,160,89,71,0,0,0,0,0
DROSH,LOWER CHITRAL,SUB-DIVISION,HINDU JATI,1,0,1,0,1,0,1,0,0,0,0,0
DROSH,LOWER CHITRAL,SUB-DIVISION,MUSLIM,107662,52526,55136,0,107662,52526,55136,0,0,0,0,0
DROSH,LOWER CHITRAL,SUB-DIVISION,OTHERS,1108,532,576,0,1108,532,576,0,0,0,0,0
DROSH,LOWER CHITRAL,SUB-DIVISION,PARSI,0,0,0,0,0,0,0,0,0,0,0,0
DROSH,LOWER CHITRAL,SUB-DIVISION,SCHEDULED CASTE,1,0,1,0,1,0,1,0,0,0,0,0
DROSH,LOWER CHITRAL,SUB-DIVISION,SIKH,0,0,0,0,0,0,0,0,0,0,0,0
GADEZAI,BUNER,TEHSIL,QADIANI/AHMADI,6,2,4,0,6,2,4,0,0,0,0,0
GADEZAI,BUNER,TEHSIL,CHRISTIAN,411,228,183,0,411,228,183,0,0,0,0,0
GADEZAI,BUNER,TEHSIL,HINDU JATI,15,5,10,0,15,5,10,0,0,0,0,0
GADEZAI,BUNER,TEHSIL,MUSLIM,196545,99291,97253,1,196545,99291,97253,1,0,0,0,0
GADEZAI,BUNER,TEHSIL,OTHERS,22,15,7,0,22,15,7,0,0,0,0,0
GADEZAI,BUNER,TEHSIL,PARSI,0,0,0,0,0,0,0,0,0,0,0,0
GADEZAI,BUNER,TEHSIL,SCHEDULED CASTE,2,0,2,0,2,0,2,0,0,0,0,0
GADEZAI,BUNER,TEHSIL,SIKH,465,231,234,0,465,231,234,0,0,0,0,0
GAGRA,BUNER,TEHSIL,QADIANI/AHMADI,2,0,2,0,2,0,2,0,0,0,0,0
GAGRA,BUNER,TEHSIL,CHRISTIAN,322,165,157,0,322,165,157,0,0,0,0,0
GAGRA,BUNER,TEHSIL,HINDU JATI,100,55,45,0,100,55,45,0,0,0,0,0
GAGRA,BUNER,TEHSIL,MUSLIM,178255,88733,89501,21,178255,88733,89501,21,0,0,0,0
GAGRA,BUNER,TEHSIL,OTHERS,4,3,1,0,4,3,1,0,0,0,0,0
GAGRA,BUNER,TEHSIL,PARSI,0,0,0,0,0,0,0,0,0,0,0,0
GAGRA,BUNER,TEHSIL,SCHEDULED CASTE,1,0,1,0,1,0,1,0,0,0,0,0
GAGRA,BUNER,TEHSIL,SIKH,265,132,133,0,265,132,133,0,0,0,0,0
GHARI KAPOORA,MARDAN,TEHSIL,QADIANI/AHMADI,4,2,2,0,4,2,2,0,0,0,0,0
GHARI KAPOORA,MARDAN,TEHSIL,CHRISTIAN,1030,567,463,0,1030,567,463,0,0,0,0,0
GHARI KAPOORA,MARDAN,TEHSIL,HINDU JATI,11,5,6,0,11,5,6,0,0,0,0,0
GHARI KAPOORA,MARDAN,TEHSIL,MUSLIM,318330,156476,161850,4,318330,156476,161850,4,0,0,0,0
GHARI KAPOORA,MARDAN,TEHSIL,OTHERS,82,40,42,0,82,40,42,0,0,0,0,0
GHARI KAPOORA,MARDAN,TEHSIL,PARSI,0,0,0,0,0,0,0,0,0,0,0,0
GHARI KAPOORA,MARDAN,TEHSIL,SCHEDULED CASTE,1,1,0,0,1,1,0,0,0,0,0,0
GHARI KAPOORA,MARDAN,TEHSIL,SIKH,4,2,2,0,4,2,2,0,0,0,0,0
GHARYUM,NORTH WAZIRISTAN,TEHSIL,QADIANI/AHMADI,0,0,0,0,0,0,0,0,0,0,0,0
GHARYUM,NORTH WAZIRISTAN,TEHSIL,CHRISTIAN,33,20,13,0,33,20,13,0,0,0,0,0
GHARYUM,NORTH WAZIRISTAN,TEHSIL,HINDU JATI,1,1,0,0,1,1,0,0,0,0,0,0
GHARYUM,NORTH WAZIRISTAN,TEHSIL,MUSLIM,18895,9350,9544,1,18895,9350,9544,1,0,0,0,0
GHARYUM,NORTH WAZIRISTAN,TEHSIL,OTHERS,1,0,1,0,1,0,1,0,0,0,0,0
GHARYUM,NORTH WAZIRISTAN,TEHSIL,PARSI,0,0,0,0,0,0,0,0,0,0,0,0
GHARYUM,NORTH WAZIRISTAN,TEHSIL,SCHEDULED CASTE,0,0,0,0,0,0,0,0,0,0,0,0
GHARYUM,NORTH WAZIRISTAN,TEHSIL,SIKH,1,0,1,0,1,0,1,0,0,0,0,0
GHAZI,HARIPUR,TEHSIL,QADIANI/AHMADI,20,11,9,0,20,11,9,0,0,0,0,0
GHAZI,HARIPUR,TEHSIL,CHRISTIAN,1299,705,594,0,1299,705,594,0,0,0,0,0
GHAZI,HARIPUR,TEHSIL,HINDU JATI,6,2,4,0,6,2,4,0,0,0,0,0
GHAZI,HARIPUR,TEHSIL,MUSLIM,150044,75287,74755,2,150044,75287,74755,2,0,0,0,0
GHAZI,HARIPUR,TEHSIL,OTHERS,71,41,30,0,71,41,30,0,0,0,0,0
GHAZI,HARIPUR,TEHSIL,PARSI,0,0,0,0,0,0,0,0,0,0,0,0
GHAZI,HARIPUR,TEHSIL,SCHEDULED CASTE,2,0,2,0,2,0,2,0,0,0,0,0
GHAZI,HARIPUR,TEHSIL,SIKH,4,2,2,0,4,2,2,0,0,0,0,0
GHAZNI KHEL,LAKKI MARWAT,TEHSIL,QADIANI/AHMADI,4,2,2,0,4,2,2,0,0,0,0,0
GHAZNI KHEL,LAKKI MARWAT,TEHSIL,CHRISTIAN,472,272,200,0,472,272,200,0,0,0,0,0
GHAZNI KHEL,LAKKI MARWAT,TEHSIL,HINDU JATI,0,0,0,0,0,0,0,0,0,0,0,0
GHAZNI KHEL,LAKKI MARWAT,TEHSIL,MUSLIM,327099,162550,164546,3,327099,162550,164546,3,0,0,0,0
GHAZNI KHEL,LAKKI MARWAT,TEHSIL,OTHERS,0,0,0,0,0,0,0,0,0,0,0,0
GHAZNI KHEL,LAKKI MARWAT,TEHSIL,PARSI,0,0,0,0,0,0,0,0,0,0,0,0
GHAZNI KHEL,LAKKI MARWAT,TEHSIL,SCHEDULED CASTE,6,1,5,0,6,1,5,0,0,0,0,0
GHAZNI KHEL,LAKKI MARWAT,TEHSIL,SIKH,3,2,1,0,3,2,1,0,0,0,0,0
GHULAM KHAN,NORTH WAZIRISTAN,TEHSIL,QADIANI/AHMADI,1,1,0,0,1,1,0,0,0,0,0,0
GHULAM KHAN,NORTH WAZIRISTAN,TEHSIL,CHRISTIAN,49,25,24,0,49,25,24,0,0,0,0,0
GHULAM KHAN,NORTH WAZIRISTAN,TEHSIL,HINDU JATI,0,0,0,0,0,0,0,0,0,0,0,0
GHULAM KHAN,NORTH WAZIRISTAN,TEHSIL,MUSLIM,30964,15532,15431,1,30964,15532,15431,1,0,0,0,0
GHULAM KHAN,NORTH WAZIRISTAN,TEHSIL,OTHERS,0,0,0,0,0,0,0,0,0,0,0,0
GHULAM KHAN,NORTH WAZIRISTAN,TEHSIL,PARSI,0,0,0,0,0,0,0,0,0,0,0,0
GHULAM KHAN,NORTH WAZIRISTAN,TEHSIL,SCHEDULED CASTE,0,0,0,0,0,0,0,0,0,0,0,0
GHULAM KHAN,NORTH WAZIRISTAN,TEHSIL,SIKH,1,1,0,0,1,1,0,0,0,0,0,0
GUMBAT,KOHAT,TEHSIL,QADIANI/AHMADI,1,1,0,0,1,1,0,0,0,0,0,0
GUMBAT,KOHAT,TEHSIL,CHRISTIAN,150,87,63,0,150,87,63,0,0,0,0,0
GUMBAT,KOHAT,TEHSIL,HINDU JATI,1,1,0,0,1,1,0,0,0,0,0,0
GUMBAT,KOHAT,TEHSIL,MUSLIM,124371,61410,62960,1,124371,61410,62960,1,0,0,0,0
GUMBAT,KOHAT,TEHSIL,OTHERS,6,3,3,0,6,3,3,0,0,0,0,0
GUMBAT,KOHAT,TEHSIL,PARSI,0,0,0,0,0,0,0,0,0,0,0,0
GUMBAT,KOHAT,TEHSIL,SCHEDULED CASTE,1,0,1,0,1,0,1,0,0,0,0,0
GUMBAT,KOHAT,TEHSIL,SIKH,0,0,0,0,0,0,0,0,0,0,0,0
HALIM ZAI,MOHMAND,TEHSIL,QADIANI/AHMADI,2,1,1,0,2,1,1,0,0,0,0,0
HALIM ZAI,MOHMAND,TEHSIL,CHRISTIAN,409,220,189,0,409,220,189,0,0,0,0,0
HALIM ZAI,MOHMAND,TEHSIL,HINDU JATI,0,0,0,0,0,0,0,0,0,0,0,0
HALIM ZAI,MOHMAND,TEHSIL,MUSLIM,88738,43712,45025,1,88738,43712,45025,1,0,0,0,0
HALIM ZAI,MOHMAND,TEHSIL,OTHERS,0,0,0,0,0,0,0,0,0,0,0,0
HALIM ZAI,MOHMAND,TEHSIL,PARSI,0,0,0,0,0,0,0,0,0,0,0,0
HALIM ZAI,MOHMAND,TEHSIL,SCHEDULED CASTE,0,0,0,0,0,0,0,0,0,0,0,0
HALIM ZAI,MOHMAND,TEHSIL,SIKH,0,0,0,0,0,0,0,0,0,0,0,0
HANGU,HANGU,DISTRICT,QADIANI/AHMADI,16,6,10,0,16,6,10,0,0,0,0,0
HANGU,HANGU,DISTRICT,CHRISTIAN,2256,1226,1030,0,1751,968,783,0,505,258,247,0
HANGU,HANGU,DISTRICT,HINDU JATI,145,79,66,0,52,32,20,0,93,47,46,0
HANGU,HANGU,DISTRICT,MUSLIM,522967,265472,257487,8,440199,224665,215530,4,82768,40807,41957,4
HANGU,HANGU,DISTRICT,OTHERS,65,27,38,0,10,6,4,0,55,21,34,0
HANGU,HANGU,DISTRICT,PARSI,0,0,0,0,0,0,0,0,0,0,0,0
HANGU,HANGU,DISTRICT,SCHEDULED CASTE,14,8,6,0,14,8,6,0,0,0,0,0
HANGU,HANGU,DISTRICT,SIKH,160,76,84,0,12,7,5,0,148,69,79,0
HANGU,HANGU,TEHSIL,QADIANI/AHMADI,2,0,2,0,2,0,2,0,0,0,0,0
HANGU,HANGU,TEHSIL,CHRISTIAN,989,514,475,0,730,377,353,0,259,137,122,0
HANGU,HANGU,TEHSIL,HINDU JATI,108,57,51,0,15,10,5,0,93,47,46,0
HANGU,HANGU,TEHSIL,MUSLIM,279477,141768,137707,2,236333,120354,115978,1,43144,21414,21729,1
HANGU,HANGU,TEHSIL,OTHERS,59,24,35,0,4,3,1,0,55,21,34,0
HANGU,HANGU,TEHSIL,PARSI,0,0,0,0,0,0,0,0,0,0,0,0
HANGU,HANGU,TEHSIL,SCHEDULED CASTE,2,2,0,0,2,2,0,0,0,0,0,0
HANGU,HANGU,TEHSIL,SIKH,66,28,38,0,3,1,2,0,63,27,36,0
HARBAN BHASHA,UPPER KOHISTAN,TEHSIL,QADIANI/AHMADI,0,0,0,0,0,0,0,0,0,0,0,0
HARBAN BHASHA,UPPER KOHISTAN,TEHSIL,CHRISTIAN,78,45,33,0,78,45,33,0,0,0,0,0
HARBAN BHASHA,UPPER KOHISTAN,TEHSIL,HINDU JATI,0,0,0,0,0,0,0,0,0,0,0,0
HARBAN BHASHA,UPPER KOHISTAN,TEHSIL,MUSLIM,44593,23920,20672,1,44593,23920,20672,1,0,0,0,0
HARBAN BHASHA,UPPER KOHISTAN,TEHSIL,OTHERS,5,2,3,0,5,2,3,0,0,0,0,0
HARBAN BHASHA,UPPER KOHISTAN,TEHSIL,PARSI,0,0,0,0,0,0,0,0,0,0,0,0
HARBAN BHASHA,UPPER KOHISTAN,TEHSIL,SCHEDULED CASTE,0,0,0,0,0,0,0,0,0,0,0,0
HARBAN BHASHA,UPPER KOHISTAN,TEHSIL,SIKH,0,0,0,0,0,0,0,0,0,0,0,0
HARIPUR,HARIPUR,DISTRICT,QADIANI/AHMADI,124,61,63,0,94,47,47,0,30,14,16,0
HARIPUR,HARIPUR,DISTRICT,CHRISTIAN,3570,1939,1628,3,3125,1708,1417,0,445,231,211,3
HARIPUR,HARIPUR,DISTRICT,HINDU JATI,41,18,23,0,40,17,23,0,1,1,0,0
HARIPUR,HARIPUR,DISTRICT,MUSLIM,1169155,580191,588922,42,1022285,507095,515175,15,146870,73096,73747,27
HARIPUR,HARIPUR,DISTRICT,OTHERS,135,77,58,0,125,72,53,0,10,5,5,0
HARIPUR,HARIPUR,DISTRICT,PARSI,0,0,0,0,0,0,0,0,0,0,0,0
HARIPUR,HARIPUR,DISTRICT,SCHEDULED CASTE,9,2,7,0,8,1,7,0,1,1,0,0
HARIPUR,HARIPUR,DISTRICT,SIKH,22,11,11,0,19,9,10,0,3,2,1,0
HARIPUR,HARIPUR,TEHSIL,QADIANI/AHMADI,103,49,54,0,73,35,38,0,30,14,16,0
HARIPUR,HARIPUR,TEHSIL,CHRISTIAN,1867,1000,864,3,1422,769,653,0,445,231,211,3
HARIPUR,HARIPUR,TEHSIL,HINDU JATI,18,9,9,0,17,8,9,0,1,1,0,0
HARIPUR,HARIPUR,TEHSIL,MUSLIM,832914,411315,421562,37,686044,338219,347815,10,146870,73096,73747,27
HARIPUR,HARIPUR,TEHSIL,OTHERS,53,31,22,0,43,26,17,0,10,5,5,0
HARIPUR,HARIPUR,TEHSIL,PARSI,0,0,0,0,0,0,0,0,0,0,0,0
HARIPUR,HARIPUR,TEHSIL,SCHEDULED CASTE,6,1,5,0,5,0,5,0,1,1,0,0
HARIPUR,HARIPUR,TEHSIL,SIKH,13,6,7,0,10,4,6,0,3,2,1,0
HASSAN KHEL,PESHAWAR,SUB-DIVISION,QADIANI/AHMADI,0,0,0,0,0,0,0,0,0,0,0,0
HASSAN KHEL,PESHAWAR,SUB-DIVISION,CHRISTIAN,182,107,75,0,182,107,75,0,0,0,0,0
HASSAN KHEL,PESHAWAR,SUB-DIVISION,HINDU JATI,0,0,0,0,0,0,0,0,0,0,0,0
HASSAN KHEL,PESHAWAR,SUB-DIVISION,MUSLIM,72364,36746,35618,0,72364,36746,35618,0,0,0,0,0
HASSAN KHEL,PESHAWAR,SUB-DIVISION,OTHERS,1,1,0,0,1,1,0,0,0,0,0,0
HASSAN KHEL,PESHAWAR,SUB-DIVISION,PARSI,0,0,0,0,0,0,0,0,0,0,0,0
HASSAN KHEL,PESHAWAR,SUB-DIVISION,SCHEDULED CASTE,0,0,0,0,0,0,0,0,0,0,0,0
HASSAN KHEL,PESHAWAR,SUB-DIVISION,SIKH,0,0,0,0,0,0,0,0,0,0,0,0
HAVELIAN,ABBOTTABAD,TEHSIL,QADIANI/AHMADI,2,1,1,0,2,1,1,0,0,0,0,0
HAVELIAN,ABBOTTABAD,TEHSIL,CHRISTIAN,945,533,412,0,671,390,281,0,274,143,131,0
HAVELIAN,ABBOTTABAD,TEHSIL,HINDU JATI,1,1,0,0,1,1,0,0,0,0,0,0
HAVELIAN,ABBOTTABAD,TEHSIL,MUSLIM,255703,128547,127112,44,199608,100516,99090,2,56095,28031,28022,42
HAVELIAN,ABBOTTABAD,TEHSIL,OTHERS,47,24,23,0,40,20,20,0,7,4,3,0
HAVELIAN,ABBOTTABAD,TEHSIL,PARSI,0,0,0,0,0,0,0,0,0,0,0,0
HAVELIAN,ABBOTTABAD,TEHSIL,SCHEDULED CASTE,2,2,0,0,2,2,0,0,0,0,0,0
HAVELIAN,ABBOTTABAD,TEHSIL,SIKH,10,2,8,0,5,1,4,0,5,1,4,0
ISMAIL ZAI,ORAKZAI,TEHSIL,QADIANI/AHMADI,22,9,13,0,22,9,13,0,0,0,0,0
ISMAIL ZAI,ORAKZAI,TEHSIL,CHRISTIAN,44,26,18,0,44,26,18,0,0,0,0,0
ISMAIL ZAI,ORAKZAI,TEHSIL,HINDU JATI,1,0,1,0,1,0,1,0,0,0,0,0
ISMAIL ZAI,ORAKZAI,TEHSIL,MUSLIM,39258,18887,20371,0,39258,18887,20371,0,0,0,0,0
ISMAIL ZAI,ORAKZAI,TEHSIL,OTHERS,3,3,0,0,3,3,0,0,0,0,0,0
ISMAIL ZAI,ORAKZAI,TEHSIL,PARSI,0,0,0,0,0,0,0,0,0,0,0,0
ISMAIL ZAI,ORAKZAI,TEHSIL,SCHEDULED CASTE,0,0,0,0,0,0,0,0,0,0,0,0
ISMAIL ZAI,ORAKZAI,TEHSIL,SIKH,0,0,0,0,0,0,0,0,0,0,0,0
JAMRUD,KHYBER,TEHSIL,QADIANI/AHMADI,3,1,2,0,1,1,0,0,2,0,2,0
JAMRUD,KHYBER,TEHSIL,CHRISTIAN,996,518,478,0,578,301,277,0,418,217,201,0
JAMRUD,KHYBER,TEHSIL,HINDU JATI,1,1,0,0,0,0,0,0,1,1,0,0
JAMRUD,KHYBER,TEHSIL,MUSLIM,241988,114251,127734,3,185901,87528,98370,3,56087,26723,29364,0
JAMRUD,KHYBER,TEHSIL,OTHERS,12,6,6,0,9,5,4,0,3,1,2,0
JAMRUD,KHYBER,TEHSIL,PARSI,0,0,0,0,0,0,0,0,0,0,0,0
JAMRUD,KHYBER,TEHSIL,SCHEDULED CASTE,3,0,3,0,1,0,1,0,2,0,2,0
JAMRUD,KHYBER,TEHSIL,SIKH,2,2,0,0,2,2,0,0,0,0,0,0
JANDOLA,TANK,SUB-DIVISION,QADIANI/AHMADI,1,0,1,0,1,0,1,0,0,0,0,0
JANDOLA,TANK,SUB-DIVISION,CHRISTIAN,50,16,34,0,50,16,34,0,0,0,0,0
JANDOLA,TANK,SUB-DIVISION,HINDU JATI,0,0,0,0,0,0,0,0,0,0,0,0
JANDOLA,TANK,SUB-DIVISION,MUSLIM,44742,21840,22902,0,44742,21840,22902,0,0,0,0,0
JANDOLA,TANK,SUB-DIVISION,OTHERS,1,0,1,0,1,0,1,0,0,0,0,0
JANDOLA,TANK,SUB-DIVISION,PARSI,0,0,0,0,0,0,0,0,0,0,0,0
JANDOLA,TANK,SUB-DIVISION,SCHEDULED CASTE,0,0,0,0,0,0,0,0,0,0,0,0
JANDOLA,TANK,SUB-DIVISION,SIKH,0,0,0,0,0,0,0,0,0,0,0,0
JEHANGIRA,NOWSHERA,TEHSIL,QADIANI/AHMADI,20,16,4,0,19,15,4,0,1,1,0,0
JEHANGIRA,NOWSHERA,TEHSIL,CHRISTIAN,1109,600,509,0,815,444,371,0,294,156,138,0
JEHANGIRA,NOWSHERA,TEHSIL,HINDU JATI,2,1,1,0,2,1,1,0,0,0,0,0
JEHANGIRA,NOWSHERA,TEHSIL,MUSLIM,433810,216069,217736,5,347368,172991,174373,4,86442,43078,43363,1
JEHANGIRA,NOWSHERA,TEHSIL,OTHERS,30,17,13,0,9,7,2,0,21,10,11,0
JEHANGIRA,NOWSHERA,TEHSIL,PARSI,0,0,0,0,0,0,0,0,0,0,0,0
JEHANGIRA,NOWSHERA,TEHSIL,SCHEDULED CASTE,10,3,7,0,7,3,4,0,3,0,3,0
JEHANGIRA,NOWSHERA,TEHSIL,SIKH,3,2,1,0,3,2,1,0,0,0,0,0
JUDBA,TORGHAR,TEHSIL,QADIANI/AHMADI,1,1,0,0,1,1,0,0,0,0,0,0
JUDBA,TORGHAR,TEHSIL,CHRISTIAN,110,56,54,0,110,56,54,0,0,0,0,0
JUDBA,TORGHAR,TEHSIL,HINDU JATI,1,1,0,0,1,1,0,0,0,0,0,0
JUDBA,TORGHAR,TEHSIL,MUSLIM,62970,30929,32040,1,62970,30929,32040,1,0,0,0,0
JUDBA,TORGHAR,TEHSIL,OTHERS,0,0,0,0,0,0,0,0,0,0,0,0
JUDBA,TORGHAR,TEHSIL,PARSI,0,0,0,0,0,0,0,0,0,0,0,0
JUDBA,TORGHAR,TEHSIL,SCHEDULED CASTE,0,0,0,0,0,0,0,0,0,0,0,0
JUDBA,TORGHAR,TEHSIL,SIKH,1,0,1,0,1,0,1,0,0,0,0,0
KABAL,SWAT,TEHSIL,QADIANI/AHMADI,3,2,1,0,3,2,1,0,0,0,0,0
KABAL,SWAT,TEHSIL,CHRISTIAN,1734,974,760,0,1533,855,678,0,201,119,82,0
KABAL,SWAT,TEHSIL,HINDU JATI,1,0,1,0,1,0,1,0,0,0,0,0
KABAL,SWAT,TEHSIL,MUSLIM,478925,233674,245244,7,346718,170922,175793,3,132207,62752,69451,4
KABAL,SWAT,TEHSIL,OTHERS,21,13,8,0,16,10,6,0,5,3,2,0
KABAL,SWAT,TEHSIL,PARSI,0,0,0,0,0,0,0,0,0,0,0,0
KABAL,SWAT,TEHSIL,SCHEDULED CASTE,4,2,2,0,3,1,2,0,1,1,0,0
KABAL,SWAT,TEHSIL,SIKH,4,1,3,0,4,1,3,0,0,0,0,0
KAKKI,BANNU,TEHSIL,QADIANI/AHMADI,3,0,3,0,3,0,3,0,0,0,0,0
KAKKI,BANNU,TEHSIL,CHRISTIAN,139,65,74,0,139,65,74,0,0,0,0,0
KAKKI,BANNU,TEHSIL,HINDU JATI,2,1,1,0,2,1,1,0,0,0,0,0
KAKKI,BANNU,TEHSIL,MUSLIM,91870,43955,47914,1,91870,43955,47914,1,0,0,0,0
KAKKI,BANNU,TEHSIL,OTHERS,4,3,1,0,4,3,1,0,0,0,0,0
KAKKI,BANNU,TEHSIL,PARSI,0,0,0,0,0,0,0,0,0,0,0,0
KAKKI,BANNU,TEHSIL,SCHEDULED CASTE,2,2,0,0,2,2,0,0,0,0,0,0
KAKKI,BANNU,TEHSIL,SIKH,1,0,1,0,1,0,1,0,0,0,0,0
KANDIA,UPPER KOHISTAN,SUB-DIVISION,QADIANI/AHMADI,1,0,1,0,1,0,1,0,0,0,0,0
KANDIA,UPPER KOHISTAN,SUB-DIVISION,CHRISTIAN,283,136,147,0,283,136,147,0,0,0,0,0
KANDIA,UPPER KOHISTAN,SUB-DIVISION,HINDU JATI,11,6,5,0,11,6,5,0,0,0,0,0
KANDIA,UPPER KOHISTAN,SUB-DIVISION,MUSLIM,140924,65237,75686,1,140924,65237,75686,1,0,0,0,0
KANDIA,UPPER KOHISTAN,SUB-DIVISION,OTHERS,47,19,28,0,47,19,28,0,0,0,0,0
KANDIA,UPPER KOHISTAN,SUB-DIVISION,PARSI,0,0,0,0,0,0,0,0,0,0,0,0
KANDIA,UPPER KOHISTAN,SUB-DIVISION,SCHEDULED CASTE,2,1,1,0,2,1,1,0,0,0,0,0
KANDIA,UPPER KOHISTAN,SUB-DIVISION,SIKH,3,1,2,0,3,1,2,0,0,0,0,0
KARAK,KARAK,DISTRICT,QADIANI/AHMADI,10,7,3,0,8,5,3,0,2,2,0,0
KARAK,KARAK,DISTRICT,CHRISTIAN,2335,1246,1089,0,1968,1051,917,0,367,195,172,0
KARAK,KARAK,DISTRICT,HINDU JATI,10,7,3,0,10,7,3,0,0,0,0,0
KARAK,KARAK,DISTRICT,MUSLIM,812726,392894,419821,11,755070,365135,389924,11,57656,27759,29897,0
KARAK,KARAK,DISTRICT,OTHERS,48,28,20,0,38,24,14,0,10,4,6,0
KARAK,KARAK,DISTRICT,PARSI,1,0,1,0,1,0,1,0,0,0,0,0
KARAK,KARAK,DISTRICT,SCHEDULED CASTE,13,5,8,0,11,5,6,0,2,0,2,0
KARAK,KARAK,DISTRICT,SIKH,7,3,4,0,7,3,4,0,0,0,0,0
KARAK,KARAK,TEHSIL,QADIANI/AHMADI,6,5,1,0,4,3,1,0,2,2,0,0
KARAK,KARAK,TEHSIL,CHRISTIAN,1408,768,640,0,1041,573,468,0,367,195,172,0
KARAK,KARAK,TEHSIL,HINDU JATI,6,5,1,0,6,5,1,0,0,0,0,0
KARAK,KARAK,TEHSIL,MUSLIM,338422,162880,175536,6,280766,135121,145639,6,57656,27759,29897,0
KARAK,KARAK,TEHSIL,OTHERS,30,17,13,0,20,13,7,0,10,4,6,0
KARAK,KARAK,TEHSIL,PARSI,0,0,0,0,0,0,0,0,0,0,0,0
KARAK,KARAK,TEHSIL,SCHEDULED CASTE,11,4,7,0,9,4,5,0,2,0,2,0
KARAK,KARAK,TEHSIL,SIKH,6,2,4,0,6,2,4,0,0,0,0,0
KATLANG,MARDAN,TEHSIL,QADIANI/AHMADI,3,1,2,0,3,1,2,0,0,0,0,0
KATLANG,MARDAN,TEHSIL,CHRISTIAN,756,405,351,0,756,405,351,0,0,0,0,0
KATLANG,MARDAN,TEHSIL,HINDU JATI,1,0,1,0,1,0,1,0,0,0,0,0
KATLANG,MARDAN,TEHSIL,MUSLIM,376750,184452,192298,0,376750,184452,192298,0,0,0,0,0
KATLANG,MARDAN,TEHSIL,OTHERS,14,5,9,0,14,5,9,0,0,0,0,0
KATLANG,MARDAN,TEHSIL,PARSI,0,0,0,0,0,0,0,0,0,0,0,0
KATLANG,MARDAN,TEHSIL,SCHEDULED CASTE,10,3,6,1,10,3,6,1,0,0,0,0
KATLANG,MARDAN,TEHSIL,SIKH,1,1,0,0,1,1,0,0,0,0,0,0
KHADO KHEL,BUNER,TEHSIL,QADIANI/AHMADI,1,0,1,0,1,0,1,0,0,0,0,0
KHADO KHEL,BUNER,TEHSIL,CHRISTIAN,186,100,86,0,186,100,86,0,0,0,0,0
KHADO KHEL,BUNER,TEHSIL,HINDU JATI,14,7,7,0,14,7,7,0,0,0,0,0
KHADO KHEL,BUNER,TEHSIL,MUSLIM,136170,68010,68159,1,136170,68010,68159,1,0,0,0,0
KHADO KHEL,BUNER,TEHSIL,OTHERS,4,2,2,0,4,2,2,0,0,0,0,0
KHADO KHEL,BUNER,TEHSIL,PARSI,0,0,0,0,0,0,0,0,0,0,0,0
KHADO KHEL,BUNER,TEHSIL,SCHEDULED CASTE,0,0,0,0,0,0,0,0,0,0,0,0
KHADO KHEL,BUNER,TEHSIL,SIKH,185,94,91,0,185,94,91,0,0,0,0,0
KHANDER,TORGHAR,TEHSIL,QADIANI/AHMADI,0,0,0,0,0,0,0,0,0,0,0,0
KHANDER,TORGHAR,TEHSIL,CHRISTIAN,83,53,30,0,83,53,30,0,0,0,0,0
KHANDER,TORGHAR,TEHSIL,HINDU JATI,0,0,0,0,0,0,0,0,0,0,0,0
KHANDER,TORGHAR,TEHSIL,MUSLIM,86773,42675,44097,1,86773,42675,44097,1,0,0,0,0
KHANDER,TORGHAR,TEHSIL,OTHERS,2,1,1,0,2,1,1,0,0,0,0,0
KHANDER,TORGHAR,TEHSIL,PARSI,0,0,0,0,0,0,0,0,0,0,0,0
KHANDER,TORGHAR,TEHSIL,SCHEDULED CASTE,0,0,0,0,0,0,0,0,0,0,0,0
KHANDER,TORGHAR,TEHSIL,SIKH,1,0,1,0,1,0,1,0,0,0,0,0
KHANPUR,HARIPUR,TEHSIL,QADIANI/AHMADI,1,1,0,0,1,1,0,0,0,0,0,0
KHANPUR,HARIPUR,TEHSIL,CHRISTIAN,404,234,170,0,404,234,170,0,0,0,0,0
KHANPUR,HARIPUR,TEHSIL,HINDU JATI,17,7,10,0,17,7,10,0,0,0,0,0
KHANPUR,HARIPUR,TEHSIL,MUSLIM,186197,93589,92605,3,186197,93589,92605,3,0,0,0,0
KHANPUR,HARIPUR,TEHSIL,OTHERS,11,5,6,0,11,5,6,0,0,0,0,0
KHANPUR,HARIPUR,TEHSIL,PARSI,0,0,0,0,0,0,0,0,0,0,0,0
KHANPUR,HARIPUR,TEHSIL,SCHEDULED CASTE,1,1,0,0,1,1,0,0,0,0,0,0
KHANPUR,HARIPUR,TEHSIL,SIKH,5,3,2,0,5,3,2,0,0,0,0,0
KHAR BAJAUR,BAJAUR,TEHSIL,QADIANI/AHMADI,1,0,1,0,1,0,1,0,0,0,0,0
KHAR BAJAUR,BAJAUR,TEHSIL,CHRISTIAN,479,266,213,0,479,266,213,0,0,0,0,0
KHAR BAJAUR,BAJAUR,TEHSIL,HINDU JATI,3,3,0,0,3,3,0,0,0,0,0,0
KHAR BAJAUR,BAJAUR,TEHSIL,MUSLIM,298872,147268,151602,2,298872,147268,151602,2,0,0,0,0
KHAR BAJAUR,BAJAUR,TEHSIL,OTHERS,24,13,11,0,24,13,11,0,0,0,0,0
KHAR BAJAUR,BAJAUR,TEHSIL,PARSI,0,0,0,0,0,0,0,0,0,0,0,0
KHAR BAJAUR,BAJAUR,TEHSIL,SCHEDULED CASTE,4,1,3,0,4,1,3,0,0,0,0,0
KHAR BAJAUR,BAJAUR,TEHSIL,SIKH,2,1,1,0,2,1,1,0,0,0,0,0
KHAWAZAKHELA,SWAT,TEHSIL,QADIANI/AHMADI,2,0,2,0,1,0,1,0,1,0,1,0
KHAWAZAKHELA,SWAT,TEHSIL,CHRISTIAN,1053,580,473,0,830,453,377,0,223,127,96,0
KHAWAZAKHELA,SWAT,TEHSIL,HINDU JATI,5,2,3,0,4,1,3,0,1,1,0,0
KHAWAZAKHELA,SWAT,TEHSIL,MUSLIM,306153,152220,153916,17,249292,124975,124304,13,56861,27245,29612,4
KHAWAZAKHELA,SWAT,TEHSIL,OTHERS,10,7,3,0,6,3,3,0,4,4,0,0
KHAWAZAKHELA,SWAT,TEHSIL,PARSI,0,0,0,0,0,0,0,0,0,0,0,0
KHAWAZAKHELA,SWAT,TEHSIL,SCHEDULED CASTE,3,3,0,0,3,3,0,0,0,0,0,0
KHAWAZAKHELA,SWAT,TEHSIL,SIKH,42,17,25,0,19,7,12,0,23,10,13,0
KHYBER,KHYBER,DISTRICT,QADIANI/AHMADI,8,1,7,0,6,1,5,0,2,0,2,0
KHYBER,KHYBER,DISTRICT,CHRISTIAN,3482,1809,1673,0,2463,1284,1179,0,1019,525,494,0
KHYBER,KHYBER,DISTRICT,HINDU JATI,18,10,8,0,17,9,8,0,1,1,0,0
KHYBER,KHYBER,DISTRICT,MUSLIM,1142377,545973,596395,9,1048827,501578,547240,9,93550,44395,49155,0
KHYBER,KHYBER,DISTRICT,OTHERS,54,30,23,1,51,29,21,1,3,1,2,0
KHYBER,KHYBER,DISTRICT,PARSI,0,0,0,0,0,0,0,0,0,0,0,0
KHYBER,KHYBER,DISTRICT,SCHEDULED CASTE,26,12,14,0,24,12,12,0,2,0,2,0
KHYBER,KHYBER,DISTRICT,SIKH,17,6,11,0,16,5,11,0,1,1,0,0
KHYBER PAKHTUNKHWA,,PROVINCE,QADIANI/AHMADI,951,476,475,,644,325,319,,307,151,156,
KHYBER PAKHTUNKHWA,,PROVINCE,CHRISTIAN,134884,71190,63685,9,85005,45673,39331,1,49879,25517,24354,8
KHYBER PAKHTUNKHWA,,PROVINCE,HINDU JATI,5473,2752,2721,,1476,757,719,,3997,1995,2002,
KHYBER PAKHTUNKHWA,,PROVINCE,MUSLIM,40486153,19816122,20668933,1098,34457326,16898245,17558627,454,6028827,2917877,3110306,644
KHYBER PAKHTUNKHWA,,PROVINCE,OTHERS,8944,4566,4371,7,7837,4020,3814,3,1107,546,557,4
KHYBER PAKHTUNKHWA,,PROVINCE,PARSI,36,16,20,,29,14,15,,7,2,5,
KHYBER PAKHTUNKHWA,,PROVINCE,SCHEDULED CASTE,629,298,330,1,478,209,268,1,151,89,62,
KHYBER PAKHTUNKHWA,,PROVINCE,SIKH,4050,1964,2084,2,1620,764,854,2,2430,1200,1230,
KOHAT,KOHAT,DISTRICT,QADIANI/AHMADI,14,6,8,0,10,3,7,0,4,3,1,0
KOHAT,KOHAT,DISTRICT,CHRISTIAN,5464,2827,2637,0,1870,1015,855,0,3594,1812,1782,0
KOHAT,KOHAT,DISTRICT,HINDU JATI,599,304,295,0,18,9,9,0,581,295,286,0
KOHAT,KOHAT,DISTRICT,MUSLIM,1228271,601760,626483,28,953908,469956,483943,9,274363,131804,142540,19
KOHAT,KOHAT,DISTRICT,OTHERS,114,58,55,1,50,25,25,0,64,33,30,1
KOHAT,KOHAT,DISTRICT,PARSI,1,0,1,0,0,0,0,0,1,0,1,0
KOHAT,KOHAT,DISTRICT,SCHEDULED CASTE,10,4,6,0,7,3,4,0,3,1,2,0
KOHAT,KOHAT,DISTRICT,SIKH,106,62,44,0,17,9,8,0,89,53,36,0
KOHAT,KOHAT,TEHSIL,QADIANI/AHMADI,9,3,6,0,6,1,5,0,3,2,1,0
KOHAT,KOHAT,TEHSIL,CHRISTIAN,4708,2415,2293,0,1239,673,566,0,3469,1742,1727,0
KOHAT,KOHAT,TEHSIL,HINDU JATI,598,303,295,0,17,8,9,0,581,295,286,0
KOHAT,KOHAT,TEHSIL,MUSLIM,812007,397337,414648,22,580379,285964,294410,5,231628,111373,120238,17
KOHAT,KOHAT,TEHSIL,OTHERS,95,50,44,1,31,17,14,0,64,33,30,1
KOHAT,KOHAT,TEHSIL,PARSI,1,0,1,0,0,0,0,0,1,0,1,0
KOHAT,KOHAT,TEHSIL,SCHEDULED CASTE,8,4,4,0,5,3,2,0,3,1,2,0
KOHAT,KOHAT,TEHSIL,SIKH,104,61,43,0,15,8,7,0,89,53,36,0
KOLAI PALAS KOHISTAN,KOLAI PALAS KOHISTAN,DISTRICT,QADIANI/AHMADI,2,2,0,0,2,2,0,0,0,0,0,0
KOLAI PALAS KOHISTAN,KOLAI PALAS KOHISTAN,DISTRICT,CHRISTIAN,611,323,288,0,611,323,288,0,0,0,0,0
KOLAI PALAS KOHISTAN,KOLAI PALAS KOHISTAN,DISTRICT,HINDU JATI,24,15,9,0,24,15,9,0,0,0,0,0
KOLAI PALAS KOHISTAN,KOLAI PALAS KOHISTAN,DISTRICT,MUSLIM,235939,114573,121364,2,235939,114573,121364,2,0,0,0,0
KOLAI PALAS KOHISTAN,KOLAI PALAS KOHISTAN,DISTRICT,OTHERS,132,62,70,0,132,62,70,0,0,0,0,0
KOLAI PALAS KOHISTAN,KOLAI PALAS KOHISTAN,DISTRICT,PARSI,2,1,1,0,2,1,1,0,0,0,0,0
KOLAI PALAS KOHISTAN,KOLAI PALAS KOHISTAN,DISTRICT,SCHEDULED CASTE,6,3,3,0,6,3,3,0,0,0,0,0
KOLAI PALAS KOHISTAN,KOLAI PALAS KOHISTAN,DISTRICT,SIKH,10,3,7,0,10,3,7,0,0,0,0,0
KULACHI,DERA ISMAIL KHAN,TEHSIL,QADIANI/AHMADI,0,0,0,0,0,0,0,0,0,0,0,0
KULACHI,DERA ISMAIL KHAN,TEHSIL,CHRISTIAN,225,120,105,0,194,100,94,0,31,20,11,0
KULACHI,DERA ISMAIL KHAN,TEHSIL,HINDU JATI,1,1,0,0,1,1,0,0,0,0,0,0
KULACHI,DERA ISMAIL KHAN,TEHSIL,MUSLIM,102363,48228,54133,2,77914,36771,41141,2,24449,11457,12992,0
KULACHI,DERA ISMAIL KHAN,TEHSIL,OTHERS,6,4,2,0,5,3,2,0,1,1,0,0
KULACHI,DERA ISMAIL KHAN,TEHSIL,PARSI,0,0,0,0,0,0,0,0,0,0,0,0
KULACHI,DERA ISMAIL KHAN,TEHSIL,SCHEDULED CASTE,0,0,0,0,0,0,0,0,0,0,0,0
KULACHI,DERA ISMAIL KHAN,TEHSIL,SIKH,0,0,0,0,0,0,0,0,0,0,0,0
KURRAM,KURRAM,DISTRICT,QADIANI/AHMADI,7,1,6,0,7,1,6,0,0,0,0,0
KURRAM,KURRAM,DISTRICT,CHRISTIAN,2517,1285,1232,0,2174,1108,1066,0,343,177,166,0
KURRAM,KURRAM,DISTRICT,HINDU JATI,39,20,19,0,30,13,17,0,9,7,2,0
KURRAM,KURRAM,DISTRICT,MUSLIM,782792,377158,405620,14,737682,356044,381625,13,45110,21114,23995,1
KURRAM,KURRAM,DISTRICT,OTHERS,44,25,19,0,35,20,15,0,9,5,4,0
KURRAM,KURRAM,DISTRICT,PARSI,0,0,0,0,0,0,0,0,0,0,0,0
KURRAM,KURRAM,DISTRICT,SCHEDULED CASTE,17,7,10,0,17,7,10,0,0,0,0,0
KURRAM,KURRAM,DISTRICT,SIKH,18,9,8,1,18,9,8,1,0,0,0,0
LACHI,KOHAT,TEHSIL,QADIANI/AHMADI,4,2,2,0,3,1,2,0,1,1,0,0
LACHI,KOHAT,TEHSIL,CHRISTIAN,352,190,162,0,227,120,107,0,125,70,55,0
LACHI,KOHAT,TEHSIL,HINDU JATI,0,0,0,0,0,0,0,0,0,0,0,0
LACHI,KOHAT,TEHSIL,MUSLIM,152314,73977,78332,5,109579,53546,56030,3,42735,20431,22302,2
LACHI,KOHAT,TEHSIL,OTHERS,10,5,5,0,10,5,5,0,0,0,0,0
LACHI,KOHAT,TEHSIL,PARSI,0,0,0,0,0,0,0,0,0,0,0,0
LACHI,KOHAT,TEHSIL,SCHEDULED CASTE,0,0,0,0,0,0,0,0,0,0,0,0
LACHI,KOHAT,TEHSIL,SIKH,0,0,0,0,0,0,0,0,0,0,0,0
LADHA,SOUTH WAZIRISTAN,TEHSIL,QADIANI/AHMADI,1,0,1,0,1,0,1,0,0,0,0,0
LADHA,SOUTH WAZIRISTAN,TEHSIL,CHRISTIAN,176,98,78,0,176,98,78,0,0,0,0,0
LADHA,SOUTH WAZIRISTAN,TEHSIL,HINDU JATI,0,0,0,0,0,0,0,0,0,0,0,0
LADHA,SOUTH WAZIRISTAN,TEHSIL,MUSLIM,108131,51406,56722,3,108131,51406,56722,3,0,0,0,0
LADHA,SOUTH WAZIRISTAN,TEHSIL,OTHERS,35,17,18,0,35,17,18,0,0,0,0,0
LADHA,SOUTH WAZIRISTAN,TEHSIL,PARSI,0,0,0,0,0,0,0,0,0,0,0,0
LADHA,SOUTH WAZIRISTAN,TEHSIL,SCHEDULED CASTE,1,0,1,0,1,0,1,0,0,0,0,0
LADHA,SOUTH WAZIRISTAN,TEHSIL,SIKH,0,0,0,0,0,0,0,0,0,0,0,0
LAHOR,SWABI,TEHSIL,QADIANI/AHMADI,7,6,1,0,6,5,1,0,1,1,0,0
LAHOR,SWABI,TEHSIL,CHRISTIAN,839,450,389,0,774,414,360,0,65,36,29,0
LAHOR,SWABI,TEHSIL,HINDU JATI,1,1,0,0,0,0,0,0,1,1,0,0
LAHOR,SWABI,TEHSIL,MUSLIM,353486,173144,180339,3,307236,150178,157055,3,46250,22966,23284,0
LAHOR,SWABI,TEHSIL,OTHERS,40,22,18,0,37,21,16,0,3,1,2,0
LAHOR,SWABI,TEHSIL,PARSI,1,0,1,0,1,0,1,0,0,0,0,0
LAHOR,SWABI,TEHSIL,SCHEDULED CASTE,7,4,3,0,7,4,3,0,0,0,0,0
LAHOR,SWABI,TEHSIL,SIKH,2,0,2,0,2,0,2,0,0,0,0,0
LAKKI MARWAT,LAKKI MARWAT,DISTRICT,QADIANI/AHMADI,9,7,2,0,9,7,2,0,0,0,0,0
LAKKI MARWAT,LAKKI MARWAT,DISTRICT,CHRISTIAN,2040,1124,916,0,1869,1034,835,0,171,90,81,0
LAKKI MARWAT,LAKKI MARWAT,DISTRICT,HINDU JATI,1,0,1,0,1,0,1,0,0,0,0,0
LAKKI MARWAT,LAKKI MARWAT,DISTRICT,MUSLIM,1034204,510205,523986,13,932441,460020,472409,12,101763,50185,51577,1
LAKKI MARWAT,LAKKI MARWAT,DISTRICT,OTHERS,11,7,4,0,9,5,4,0,2,2,0,0
LAKKI MARWAT,LAKKI MARWAT,DISTRICT,PARSI,0,0,0,0,0,0,0,0,0,0,0,0
LAKKI MARWAT,LAKKI MARWAT,DISTRICT,SCHEDULED CASTE,23,6,17,0,21,6,15,0,2,0,2,0
LAKKI MARWAT,LAKKI MARWAT,DISTRICT,SIKH,12,5,7,0,12,5,7,0,0,0,0,0
LAKKI MARWAT,LAKKI MARWAT,TEHSIL,QADIANI/AHMADI,0,0,0,0,0,0,0,0,0,0,0,0
LAKKI MARWAT,LAKKI MARWAT,TEHSIL,CHRISTIAN,620,330,290,0,535,288,247,0,85,42,43,0
LAKKI MARWAT,LAKKI MARWAT,TEHSIL,HINDU JATI,0,0,0,0,0,0,0,0,0,0,0,0
LAKKI MARWAT,LAKKI MARWAT,TEHSIL,MUSLIM,339957,167825,172126,6,270319,133575,136739,5,69638,34250,35387,1
LAKKI MARWAT,LAKKI MARWAT,TEHSIL,OTHERS,4,3,1,0,3,2,1,0,1,1,0,0
LAKKI MARWAT,LAKKI MARWAT,TEHSIL,PARSI,0,0,0,0,0,0,0,0,0,0,0,0
LAKKI MARWAT,LAKKI MARWAT,TEHSIL,SCHEDULED CASTE,12,4,8,0,10,4,6,0,2,0,2,0
LAKKI MARWAT,LAKKI MARWAT,TEHSIL,SIKH,5,0,5,0,5,0,5,0,0,0,0,0
LAL QILA,LOWER DIR,SUB-DIVISION,QADIANI/AHMADI,1,0,1,0,1,0,1,0,0,0,0,0
LAL QILA,LOWER DIR,SUB-DIVISION,CHRISTIAN,644,366,278,0,644,366,278,0,0,0,0,0
LAL QILA,LOWER DIR,SUB-DIVISION,HINDU JATI,3,3,0,0,3,3,0,0,0,0,0,0
LAL QILA,LOWER DIR,SUB-DIVISION,MUSLIM,246641,129996,116643,2,246641,129996,116643,2,0,0,0,0
LAL QILA,LOWER DIR,SUB-DIVISION,OTHERS,8,4,4,0,8,4,4,0,0,0,0,0
LAL QILA,LOWER DIR,SUB-DIVISION,PARSI,0,0,0,0,0,0,0,0,0,0,0,0
LAL QILA,LOWER DIR,SUB-DIVISION,SCHEDULED CASTE,0,0,0,0,0,0,0,0,0,0,0,0
LAL QILA,LOWER DIR,SUB-DIVISION,SIKH,0,0,0,0,0,0,0,0,0,0,0,0
LANDI KOTAL,KHYBER,TEHSIL,QADIANI/AHMADI,0,0,0,0,0,0,0,0,0,0,0,0
LANDI KOTAL,KHYBER,TEHSIL,CHRISTIAN,1126,563,563,0,525,255,270,0,601,308,293,0
LANDI KOTAL,KHYBER,TEHSIL,HINDU JATI,1,1,0,0,1,1,0,0,0,0,0,0
LANDI KOTAL,KHYBER,TEHSIL,MUSLIM,311180,148580,162599,1,273717,130908,142808,1,37463,17672,19791,0
LANDI KOTAL,KHYBER,TEHSIL,OTHERS,2,0,2,0,2,0,2,0,0,0,0,0
LANDI KOTAL,KHYBER,TEHSIL,PARSI,0,0,0,0,0,0,0,0,0,0,0,0
LANDI KOTAL,KHYBER,TEHSIL,SCHEDULED CASTE,0,0,0,0,0,0,0,0,0,0,0,0
LANDI KOTAL,KHYBER,TEHSIL,SIKH,4,1,3,0,3,0,3,0,1,1,0,0
LARJUM,UPPER DIR,SUB-DIVISION,QADIANI/AHMADI,2,0,2,0,2,0,2,0,0,0,0,0
LARJUM,UPPER DIR,SUB-DIVISION,CHRISTIAN,156,78,78,0,156,78,78,0,0,0,0,0
LARJUM,UPPER DIR,SUB-DIVISION,HINDU JATI,0,0,0,0,0,0,0,0,0,0,0,0
LARJUM,UPPER DIR,SUB-DIVISION,MUSLIM,119231,59335,59893,3,119231,59335,59893,3,0,0,0,0
LARJUM,UPPER DIR,SUB-DIVISION,OTHERS,4,4,0,0,4,4,0,0,0,0,0,0
LARJUM,UPPER DIR,SUB-DIVISION,PARSI,0,0,0,0,0,0,0,0,0,0,0,0
LARJUM,UPPER DIR,SUB-DIVISION,SCHEDULED CASTE,2,1,1,0,2,1,1,0,0,0,0,0
LARJUM,UPPER DIR,SUB-DIVISION,SIKH,1,0,1,0,1,0,1,0,0,0,0,0
LORA,ABBOTTABAD,TEHSIL,QADIANI/AHMADI,2,0,2,0,2,0,2,0,0,0,0,0
LORA,ABBOTTABAD,TEHSIL,CHRISTIAN,268,160,108,0,268,160,108,0,0,0,0,0
LORA,ABBOTTABAD,TEHSIL,HINDU JATI,10,3,7,0,10,3,7,0,0,0,0,0
LORA,ABBOTTABAD,TEHSIL,MUSLIM,98326,49826,48499,1,98326,49826,48499,1,0,0,0,0
LORA,ABBOTTABAD,TEHSIL,OTHERS,60,36,24,0,60,36,24,0,0,0,0,0
LORA,ABBOTTABAD,TEHSIL,PARSI,1,1,0,0,1,1,0,0,0,0,0,0
LORA,ABBOTTABAD,TEHSIL,SCHEDULED CASTE,3,2,1,0,3,2,1,0,0,0,0,0
LORA,ABBOTTABAD,TEHSIL,SIKH,1,1,0,0,1,1,0,0,0,0,0,0
LOWER,ORAKZAI,TEHSIL,QADIANI/AHMADI,4,2,2,0,4,2,2,0,0,0,0,0
LOWER,ORAKZAI,TEHSIL,CHRISTIAN,328,162,166,0,328,162,166,0,0,0,0,0
LOWER,ORAKZAI,TEHSIL,HINDU JATI,23,12,11,0,23,12,11,0,0,0,0,0
LOWER,ORAKZAI,TEHSIL,MUSLIM,125576,60455,65120,1,125576,60455,65120,1,0,0,0,0
LOWER,ORAKZAI,TEHSIL,OTHERS,6,1,5,0,6,1,5,0,0,0,0,0
LOWER,ORAKZAI,TEHSIL,PARSI,0,0,0,0,0,0,0,0,0,0,0,0
LOWER,ORAKZAI,TEHSIL,SCHEDULED CASTE,2,1,1,0,2,1,1,0,0,0,0,0
LOWER,ORAKZAI,TEHSIL,SIKH,5,2,3,0,5,2,3,0,0,0,0,0
LOWER CHITRAL,LOWER CHITRAL,DISTRICT,QADIANI/AHMADI,2,1,1,0,1,1,0,0,1,0,1,0
LOWER CHITRAL,LOWER CHITRAL,DISTRICT,CHRISTIAN,509,281,228,0,363,214,149,0,146,67,79,0
LOWER CHITRAL,LOWER CHITRAL,DISTRICT,HINDU JATI,1,0,1,0,1,0,1,0,0,0,0,0
LOWER CHITRAL,LOWER CHITRAL,DISTRICT,MUSLIM,313101,153140,159961,0,257895,126279,131616,0,55206,26861,28345,0
LOWER CHITRAL,LOWER CHITRAL,DISTRICT,OTHERS,4617,2269,2348,0,4449,2173,2276,0,168,96,72,0
LOWER CHITRAL,LOWER CHITRAL,DISTRICT,PARSI,0,0,0,0,0,0,0,0,0,0,0,0
LOWER CHITRAL,LOWER CHITRAL,DISTRICT,SCHEDULED CASTE,3,1,2,0,1,0,1,0,2,1,1,0
LOWER CHITRAL,LOWER CHITRAL,DISTRICT,SIKH,1,1,0,0,0,0,0,0,1,1,0,0
LOWER DIR,LOWER DIR,DISTRICT,QADIANI/AHMADI,22,8,14,0,22,8,14,0,0,0,0,0
LOWER DIR,LOWER DIR,DISTRICT,CHRISTIAN,4268,2320,1948,0,3904,2148,1756,0,364,172,192,0
LOWER DIR,LOWER DIR,DISTRICT,HINDU JATI,51,24,27,0,17,10,7,0,34,14,20,0
LOWER DIR,LOWER DIR,DISTRICT,MUSLIM,1644181,833392,810762,27,1596721,810138,786557,26,47460,23254,24205,1
LOWER DIR,LOWER DIR,DISTRICT,OTHERS,59,30,29,0,57,30,27,0,2,0,2,0
LOWER DIR,LOWER DIR,DISTRICT,PARSI,1,1,0,0,1,1,0,0,0,0,0,0
LOWER DIR,LOWER DIR,DISTRICT,SCHEDULED CASTE,22,10,12,0,22,10,12,0,0,0,0,0
LOWER DIR,LOWER DIR,DISTRICT,SIKH,16,6,10,0,16,6,10,0,0,0,0,0
LOWER KOHISTAN,LOWER KOHISTAN,DISTRICT,QADIANI/AHMADI,2,1,1,0,2,1,1,0,0,0,0,0
LOWER KOHISTAN,LOWER KOHISTAN,DISTRICT,CHRISTIAN,834,425,409,0,834,425,409,0,0,0,0,0
LOWER KOHISTAN,LOWER KOHISTAN,DISTRICT,HINDU JATI,2,1,1,0,2,1,1,0,0,0,0,0
LOWER KOHISTAN,LOWER KOHISTAN,DISTRICT,MUSLIM,302360,146777,155572,11,302360,146777,155572,11,0,0,0,0
LOWER KOHISTAN,LOWER KOHISTAN,DISTRICT,OTHERS,94,53,41,0,94,53,41,0,0,0,0,0
LOWER KOHISTAN,LOWER KOHISTAN,DISTRICT,PARSI,2,2,0,0,2,2,0,0,0,0,0,0
LOWER KOHISTAN,LOWER KOHISTAN,DISTRICT,SCHEDULED CASTE,7,1,6,0,7,1,6,0,0,0,0,0
LOWER KOHISTAN,LOWER KOHISTAN,DISTRICT,SIKH,4,2,2,0,4,2,2,0,0,0,0,0
LOWER KURRAM,KURRAM,TEHSIL,QADIANI/AHMADI,0,0,0,0,0,0,0,0,0,0,0,0
LOWER KURRAM,KURRAM,TEHSIL,CHRISTIAN,380,211,169,0,222,124,98,0,158,87,71,0
LOWER KURRAM,KURRAM,TEHSIL,HINDU JATI,8,4,4,0,8,4,4,0,0,0,0,0
LOWER KURRAM,KURRAM,TEHSIL,MUSLIM,150539,72995,77540,4,110818,54393,56422,3,39721,18602,21118,1
LOWER KURRAM,KURRAM,TEHSIL,OTHERS,14,6,8,0,5,1,4,0,9,5,4,0
LOWER KURRAM,KURRAM,TEHSIL,PARSI,0,0,0,0,0,0,0,0,0,0,0,0
LOWER KURRAM,KURRAM,TEHSIL,SCHEDULED CASTE,1,0,1,0,1,0,1,0,0,0,0,0
LOWER KURRAM,KURRAM,TEHSIL,SIKH,3,0,2,1,3,0,2,1,0,0,0,0
LOWER TANAWAL,ABBOTTABAD,TEHSIL,QADIANI/AHMADI,1,1,0,0,1,1,0,0,0,0,0,0
LOWER TANAWAL,ABBOTTABAD,TEHSIL,CHRISTIAN,129,77,52,0,129,77,52,0,0,0,0,0
LOWER TANAWAL,ABBOTTABAD,TEHSIL,HINDU JATI,5,4,1,0,5,4,1,0,0,0,0,0
LOWER TANAWAL,ABBOTTABAD,TEHSIL,MUSLIM,60097,30203,29892,2,60097,30203,29892,2,0,0,0,0
LOWER TANAWAL,ABBOTTABAD,TEHSIL,OTHERS,4,2,2,0,4,2,2,0,0,0,0,0
LOWER TANAWAL,ABBOTTABAD,TEHSIL,PARSI,0,0,0,0,0,0,0,0,0,0,0,0
LOWER TANAWAL,ABBOTTABAD,TEHSIL,SCHEDULED CASTE,2,0,2,0,2,0,2,0,0,0,0,0
LOWER TANAWAL,ABBOTTABAD,TEHSIL,SIKH,1,0,1,0,1,0,1,0,0,0,0,0
MAKIN,SOUTH WAZIRISTAN,TEHSIL,QADIANI/AHMADI,1,0,1,0,1,0,1,0,0,0,0,0
MAKIN,SOUTH WAZIRISTAN,TEHSIL,CHRISTIAN,155,62,93,0,155,62,93,0,0,0,0,0
MAKIN,SOUTH WAZIRISTAN,TEHSIL,HINDU JATI,1,1,0,0,1,1,0,0,0,0,0,0
MAKIN,SOUTH WAZIRISTAN,TEHSIL,MUSLIM,65879,30070,35807,2,65879,30070,35807,2,0,0,0,0
MAKIN,SOUTH WAZIRISTAN,TEHSIL,OTHERS,4,1,3,0,4,1,3,0,0,0,0,0
MAKIN,SOUTH WAZIRISTAN,TEHSIL,PARSI,0,0,0,0,0,0,0,0,0,0,0,0
MAKIN,SOUTH WAZIRISTAN,TEHSIL,SCHEDULED CASTE,0,0,0,0,0,0,0,0,0,0,0,0
MAKIN,SOUTH WAZIRISTAN,TEHSIL,SIKH,2,1,1,0,2,1,1,0,0,0,0,0
MALAKAND,MALAKAND,DISTRICT,QADIANI/AHMADI,15,10,5,0,10,9,1,0,5,1,4,0
MALAKAND,MALAKAND,DISTRICT,CHRISTIAN,2092,1103,989,0,1615,868,747,0,477,235,242,0
MALAKAND,MALAKAND,DISTRICT,HINDU JATI,75,42,33,0,73,40,33,0,2,2,0,0
MALAKAND,MALAKAND,DISTRICT,MUSLIM,823056,401765,421279,12,750018,366834,383178,6,73038,34931,38101,6
MALAKAND,MALAKAND,DISTRICT,OTHERS,98,50,48,0,98,50,48,0,0,0,0,0
MALAKAND,MALAKAND,DISTRICT,PARSI,0,0,0,0,0,0,0,0,0,0,0,0
MALAKAND,MALAKAND,DISTRICT,SCHEDULED CASTE,11,6,5,0,8,5,3,0,3,1,2,0
MALAKAND,MALAKAND,DISTRICT,SIKH,30,15,15,0,30,15,15,0,0,0,0,0
MAMUND,BAJAUR,TEHSIL,QADIANI/AHMADI,11,5,6,0,11,5,6,0,0,0,0,0
MAMUND,BAJAUR,TEHSIL,CHRISTIAN,1329,691,638,0,1329,691,638,0,0,0,0,0
MAMUND,BAJAUR,TEHSIL,HINDU JATI,8,5,3,0,8,5,3,0,0,0,0,0
MAMUND,BAJAUR,TEHSIL,MUSLIM,355762,174927,180831,4,355762,174927,180831,4,0,0,0,0
MAMUND,BAJAUR,TEHSIL,OTHERS,10,7,3,0,10,7,3,0,0,0,0,0
MAMUND,BAJAUR,TEHSIL,PARSI,0,0,0,0,0,0,0,0,0,0,0,0
MAMUND,BAJAUR,TEHSIL,SCHEDULED CASTE,7,4,3,0,7,4,3,0,0,0,0,0
MAMUND,BAJAUR,TEHSIL,SIKH,8,5,3,0,8,5,3,0,0,0,0,0
MANDANR,BUNER,TEHSIL,QADIANI/AHMADI,0,0,0,0,0,0,0,0,0,0,0,0
MANDANR,BUNER,TEHSIL,CHRISTIAN,247,131,116,0,247,131,116,0,0,0,0,0
MANDANR,BUNER,TEHSIL,HINDU JATI,1,0,1,0,1,0,1,0,0,0,0,0
MANDANR,BUNER,TEHSIL,MUSLIM,184718,90977,93741,0,184718,90977,93741,0,0,0,0,0
MANDANR,BUNER,TEHSIL,OTHERS,3,2,1,0,3,2,1,0,0,0,0,0
MANDANR,BUNER,TEHSIL,PARSI,0,0,0,0,0,0,0,0,0,0,0,0
MANDANR,BUNER,TEHSIL,SCHEDULED CASTE,1,0,1,0,1,0,1,0,0,0,0,0
MANDANR,BUNER,TEHSIL,SIKH,61,31,30,0,61,31,30,0,0,0,0,0
MANSEHRA,MANSEHRA,DISTRICT,QADIANI/AHMADI,26,13,13,0,25,13,12,0,1,0,1,0
MANSEHRA,MANSEHRA,DISTRICT,CHRISTIAN,3986,2191,1794,1,3492,1936,1556,0,494,255,238,1
MANSEHRA,MANSEHRA,DISTRICT,HINDU JATI,32,17,15,0,30,16,14,0,2,1,1,0
MANSEHRA,MANSEHRA,DISTRICT,MUSLIM,1785071,878466,906499,106,1631253,803784,827426,43,153818,74682,79073,63
MANSEHRA,MANSEHRA,DISTRICT,OTHERS,467,268,199,0,452,258,194,0,15,10,5,0
MANSEHRA,MANSEHRA,DISTRICT,PARSI,4,2,2,0,3,2,1,0,1,0,1,0
MANSEHRA,MANSEHRA,DISTRICT,SCHEDULED CASTE,7,2,5,0,7,2,5,0,0,0,0,0
MANSEHRA,MANSEHRA,DISTRICT,SIKH,31,18,13,0,29,17,12,0,2,1,1,0
MANSEHRA,MANSEHRA,TEHSIL,QADIANI/AHMADI,12,6,6,0,11,6,5,0,1,0,1,0
MANSEHRA,MANSEHRA,TEHSIL,CHRISTIAN,1574,874,699,1,1150,659,491,0,424,215,208,1
MANSEHRA,MANSEHRA,TEHSIL,HINDU JATI,7,5,2,0,5,4,1,0,2,1,1,0
MANSEHRA,MANSEHRA,TEHSIL,MUSLIM,718975,350637,368271,67,582586,284331,298249,6,136389,66306,70022,61
MANSEHRA,MANSEHRA,TEHSIL,OTHERS,97,49,48,0,84,41,43,0,13,8,5,0
MANSEHRA,MANSEHRA,TEHSIL,PARSI,2,1,1,0,1,1,0,0,1,0,1,0
MANSEHRA,MANSEHRA,TEHSIL,SCHEDULED CASTE,2,1,1,0,2,1,1,0,0,0,0,0
MANSEHRA,MANSEHRA,TEHSIL,SIKH,12,8,4,0,10,7,3,0,2,1,1,0
MARDAN,MARDAN,DISTRICT,QADIANI/AHMADI,78,36,42,0,31,16,15,0,47,20,27,0
MARDAN,MARDAN,DISTRICT,CHRISTIAN,7567,4018,3549,0,4856,2641,2215,0,2711,1377,1334,0
MARDAN,MARDAN,DISTRICT,HINDU JATI,340,171,169,0,58,27,31,0,282,144,138,0
MARDAN,MARDAN,DISTRICT,MUSLIM,2732331,1329474,1402805,52,2282415,1112308,1170089,18,449916,217166,232716,34
MARDAN,MARDAN,DISTRICT,OTHERS,167,81,86,0,143,67,76,0,24,14,10,0
MARDAN,MARDAN,DISTRICT,PARSI,3,0,3,0,1,0,1,0,2,0,2,0
MARDAN,MARDAN,DISTRICT,SCHEDULED CASTE,39,20,18,1,34,16,17,1,5,4,1,0
MARDAN,MARDAN,DISTRICT,SIKH,167,76,91,0,39,11,28,0,128,65,63,0
MARDAN,MARDAN,TEHSIL,QADIANI/AHMADI,62,29,33,0,15,9,6,0,47,20,27,0
MARDAN,MARDAN,TEHSIL,CHRISTIAN,3849,2010,1839,0,1361,744,617,0,2488,1266,1222,0
MARDAN,MARDAN,TEHSIL,HINDU JATI,304,154,150,0,23,11,12,0,281,143,138,0
MARDAN,MARDAN,TEHSIL,MUSLIM,1035537,498557,536940,40,670318,323047,347265,6,365219,175510,189675,34
MARDAN,MARDAN,TEHSIL,OTHERS,40,24,16,0,18,12,6,0,22,12,10,0
MARDAN,MARDAN,TEHSIL,PARSI,3,0,3,0,1,0,1,0,2,0,2,0
MARDAN,MARDAN,TEHSIL,SCHEDULED CASTE,19,9,10,0,15,6,9,0,4,3,1,0
MARDAN,MARDAN,TEHSIL,SIKH,148,70,78,0,20,5,15,0,128,65,63,0
MARTUNG,SHANGLA,TEHSIL,QADIANI/AHMADI,0,0,0,0,0,0,0,0,0,0,0,0
MARTUNG,SHANGLA,TEHSIL,CHRISTIAN,294,168,126,0,294,168,126,0,0,0,0,0
MARTUNG,SHANGLA,TEHSIL,HINDU JATI,0,0,0,0,0,0,0,0,0,0,0,0
MARTUNG,SHANGLA,TEHSIL,MUSLIM,102907,49608,53298,1,102907,49608,53298,1,0,0,0,0
MARTUNG,SHANGLA,TEHSIL,OTHERS,2,0,2,0,2,0,2,0,0,0,0,0
MARTUNG,SHANGLA,TEHSIL,PARSI,0,0,0,0,0,0,0,0,0,0,0,0
MARTUNG,SHANGLA,TEHSIL,SCHEDULED CASTE,0,0,0,0,0,0,0,0,0,0,0,0
MARTUNG,SHANGLA,TEHSIL,SIKH,2,1,1,0,2,1,1,0,0,0,0,0
MASTUJ,UPPER CHITRAL,SUB-DIVISION,QADIANI/AHMADI,2,1,1,0,2,1,1,0,0,0,0,0
MASTUJ,UPPER CHITRAL,SUB-DIVISION,CHRISTIAN,425,232,193,0,425,232,193,0,0,0,0,0
MASTUJ,UPPER CHITRAL,SUB-DIVISION,HINDU JATI,1,1,0,0,1,1,0,0,0,0,0,0
MASTUJ,UPPER CHITRAL,SUB-DIVISION,MUSLIM,194379,94409,99970,0,194379,94409,99970,0,0,0,0,0
MASTUJ,UPPER CHITRAL,SUB-DIVISION,OTHERS,353,198,155,0,353,198,155,0,0,0,0,0
MASTUJ,UPPER CHITRAL,SUB-DIVISION,PARSI,1,1,0,0,1,1,0,0,0,0,0,0
MASTUJ,UPPER CHITRAL,SUB-DIVISION,SCHEDULED CASTE,0,0,0,0,0,0,0,0,0,0,0,0
MASTUJ,UPPER CHITRAL,SUB-DIVISION,SIKH,0,0,0,0,0,0,0,0,0,0,0,0
MATHRA,PESHAWAR,TEHSIL,QADIANI/AHMADI,14,8,6,0,14,8,6,0,0,0,0,0
MATHRA,PESHAWAR,TEHSIL,CHRISTIAN,1034,565,469,0,1034,565,469,0,0,0,0,0
MATHRA,PESHAWAR,TEHSIL,HINDU JATI,10,4,6,0,10,4,6,0,0,0,0,0
MATHRA,PESHAWAR,TEHSIL,MUSLIM,493966,244629,249330,7,493966,244629,249330,7,0,0,0,0
MATHRA,PESHAWAR,TEHSIL,OTHERS,17,14,3,0,17,14,3,0,0,0,0,0
MATHRA,PESHAWAR,TEHSIL,PARSI,5,1,4,0,5,1,4,0,0,0,0,0
MATHRA,PESHAWAR,TEHSIL,SCHEDULED CASTE,3,1,2,0,3,1,2,0,0,0,0,0
MATHRA,PESHAWAR,TEHSIL,SIKH,10,1,9,0,10,1,9,0,0,0,0,0
MATTA,SWAT,TEHSIL,QADIANI/AHMADI,10,5,5,0,10,5,5,0,0,0,0,0
MATTA,SWAT,TEHSIL,CHRISTIAN,1199,650,549,0,1125,605,520,0,74,45,29,0
MATTA,SWAT,TEHSIL,HINDU JATI,10,4,6,0,5,1,4,0,5,3,2,0
MATTA,SWAT,TEHSIL,MUSLIM,550715,272007,278701,7,499202,246896,252300,6,51513,25111,26401,1
MATTA,SWAT,TEHSIL,OTHERS,29,13,16,0,27,12,15,0,2,1,1,0
MATTA,SWAT,TEHSIL,PARSI,1,0,1,0,1,0,1,0,0,0,0,0
MATTA,SWAT,TEHSIL,SCHEDULED CASTE,9,1,8,0,9,1,8,0,0,0,0,0
MATTA,SWAT,TEHSIL,SIKH,7,5,2,0,7,5,2,0,0,0,0,0
MERYAN,BANNU,TEHSIL,QADIANI/AHMADI,2,2,0,0,2,2,0,0,0,0,0,0
MERYAN,BANNU,TEHSIL,CHRISTIAN,358,224,134,0,358,224,134,0,0,0,0,0
MERYAN,BANNU,TEHSIL,HINDU JATI,0,0,0,0,0,0,0,0,0,0,0,0
MERYAN,BANNU,TEHSIL,MUSLIM,165920,81081,84838,1,165920,81081,84838,1,0,0,0,0
MERYAN,BANNU,TEHSIL,OTHERS,3,3,0,0,3,3,0,0,0,0,0,0
MERYAN,BANNU,TEHSIL,PARSI,0,0,0,0,0,0,0,0,0,0,0,0
MERYAN,BANNU,TEHSIL,SCHEDULED CASTE,2,1,1,0,2,1,1,0,0,0,0,0
MERYAN,BANNU,TEHSIL,SIKH,5,4,1,0,5,4,1,0,0,0,0,0
MIR ALI,NORTH WAZIRISTAN,TEHSIL,QADIANI/AHMADI,2,0,2,0,2,0,2,0,0,0,0,0
MIR ALI,NORTH WAZIRISTAN,TEHSIL,CHRISTIAN,395,203,192,0,395,203,192,0,0,0,0,0
MIR ALI,NORTH WAZIRISTAN,TEHSIL,HINDU JATI,24,11,13,0,24,11,13,0,0,0,0,0
MIR ALI,NORTH WAZIRISTAN,TEHSIL,MUSLIM,229206,110336,118868,2,229206,110336,118868,2,0,0,0,0
MIR ALI,NORTH WAZIRISTAN,TEHSIL,OTHERS,7,4,3,0,7,4,3,0,0,0,0,0
MIR ALI,NORTH WAZIRISTAN,TEHSIL,PARSI,1,1,0,0,1,1,0,0,0,0,0,0
MIR ALI,NORTH WAZIRISTAN,TEHSIL,SCHEDULED CASTE,4,3,1,0,4,3,1,0,0,0,0,0
MIR ALI,NORTH WAZIRISTAN,TEHSIL,SIKH,8,5,2,1,8,5,2,1,0,0,0,0
MIRAN SHAH,NORTH WAZIRISTAN,TEHSIL,QADIANI/AHMADI,13,5,8,0,12,5,7,0,1,0,1,0
MIRAN SHAH,NORTH WAZIRISTAN,TEHSIL,CHRISTIAN,816,404,411,1,371,198,173,0,445,206,238,1
MIRAN SHAH,NORTH WAZIRISTAN,TEHSIL,HINDU JATI,59,26,33,0,1,0,1,0,58,26,32,0
MIRAN SHAH,NORTH WAZIRISTAN,TEHSIL,MUSLIM,122226,60500,61725,1,118794,58968,59825,1,3432,1532,1900,0
MIRAN SHAH,NORTH WAZIRISTAN,TEHSIL,OTHERS,7,4,3,0,7,4,3,0,0,0,0,0
MIRAN SHAH,NORTH WAZIRISTAN,TEHSIL,PARSI,0,0,0,0,0,0,0,0,0,0,0,0
MIRAN SHAH,NORTH WAZIRISTAN,TEHSIL,SCHEDULED CASTE,0,0,0,0,0,0,0,0,0,0,0,0
MIRAN SHAH,NORTH WAZIRISTAN,TEHSIL,SIKH,1,1,0,0,1,1,0,0,0,0,0,0
MOHMAND,MOHMAND,DISTRICT,QADIANI/AHMADI,5,3,2,0,5,3,2,0,0,0,0,0
MOHMAND,MOHMAND,DISTRICT,CHRISTIAN,1554,823,731,0,1554,823,731,0,0,0,0,0
MOHMAND,MOHMAND,DISTRICT,HINDU JATI,0,0,0,0,0,0,0,0,0,0,0,0
MOHMAND,MOHMAND,DISTRICT,MUSLIM,552341,271701,280634,6,552341,271701,280634,6,0,0,0,0
MOHMAND,MOHMAND,DISTRICT,OTHERS,18,13,5,0,18,13,5,0,0,0,0,0
MOHMAND,MOHMAND,DISTRICT,PARSI,0,0,0,0,0,0,0,0,0,0,0,0
MOHMAND,MOHMAND,DISTRICT,SCHEDULED CASTE,1,1,0,0,1,1,0,0,0,0,0,0
MOHMAND,MOHMAND,DISTRICT,SIKH,14,2,12,0,14,2,12,0,0,0,0,0
MULLA GORI,KHYBER,TEHSIL,QADIANI/AHMADI,0,0,0,0,0,0,0,0,0,0,0,0
MULLA GORI,KHYBER,TEHSIL,CHRISTIAN,181,104,77,0,181,104,77,0,0,0,0,0
MULLA GORI,KHYBER,TEHSIL,HINDU JATI,5,3,2,0,5,3,2,0,0,0,0,0
MULLA GORI,KHYBER,TEHSIL,MUSLIM,42394,19889,22505,0,42394,19889,22505,0,0,0,0,0
MULLA GORI,KHYBER,TEHSIL,OTHERS,0,0,0,0,0,0,0,0,0,0,0,0
MULLA GORI,KHYBER,TEHSIL,PARSI,0,0,0,0,0,0,0,0,0,0,0,0
MULLA GORI,KHYBER,TEHSIL,SCHEDULED CASTE,0,0,0,0,0,0,0,0,0,0,0,0
MULLA GORI,KHYBER,TEHSIL,SIKH,0,0,0,0,0,0,0,0,0,0,0,0
NAWAGAI,BAJAUR,TEHSIL,QADIANI/AHMADI,0,0,0,0,0,0,0,0,0,0,0,0
NAWAGAI,BAJAUR,TEHSIL,CHRISTIAN,224,124,100,0,224,124,100,0,0,0,0,0
NAWAGAI,BAJAUR,TEHSIL,HINDU JATI,1,1,0,0,1,1,0,0,0,0,0,0
NAWAGAI,BAJAUR,TEHSIL,MUSLIM,93466,45976,47486,4,93466,45976,47486,4,0,0,0,0
NAWAGAI,BAJAUR,TEHSIL,OTHERS,11,7,4,0,11,7,4,0,0,0,0,0
NAWAGAI,BAJAUR,TEHSIL,PARSI,0,0,0,0,0,0,0,0,0,0,0,0
NAWAGAI,BAJAUR,TEHSIL,SCHEDULED CASTE,1,0,1,0,1,0,1,0,0,0,0,0
NAWAGAI,BAJAUR,TEHSIL,SIKH,3,1,2,0,3,1,2,0,0,0,0,0
NORTH WAZIRISTAN,NORTH WAZIRISTAN,DISTRICT,QADIANI/AHMADI,21,8,13,0,20,8,12,0,1,0,1,0
NORTH WAZIRISTAN,NORTH WAZIRISTAN,DISTRICT,CHRISTIAN,2009,988,1020,1,1564,782,782,0,445,206,238,1
NORTH WAZIRISTAN,NORTH WAZIRISTAN,DISTRICT,HINDU JATI,87,39,48,0,29,13,16,0,58,26,32,0
NORTH WAZIRISTAN,NORTH WAZIRISTAN,DISTRICT,MUSLIM,690967,337515,353439,13,687535,335983,351539,13,3432,1532,1900,0
NORTH WAZIRISTAN,NORTH WAZIRISTAN,DISTRICT,OTHERS,29,15,14,0,29,15,14,0,0,0,0,0
NORTH WAZIRISTAN,NORTH WAZIRISTAN,DISTRICT,PARSI,1,1,0,0,1,1,0,0,0,0,0,0
NORTH WAZIRISTAN,NORTH WAZIRISTAN,DISTRICT,SCHEDULED CASTE,9,4,5,0,9,4,5,0,0,0,0,0
NORTH WAZIRISTAN,NORTH WAZIRISTAN,DISTRICT,SIKH,14,10,3,1,14,10,3,1,0,0,0,0
NOWSHERA,NOWSHERA,DISTRICT,QADIANI/AHMADI,54,31,23,0,40,26,14,0,14,5,9,0
NOWSHERA,NOWSHERA,DISTRICT,CHRISTIAN,8886,4609,4276,1,4916,2622,2294,0,3970,1987,1982,1
NOWSHERA,NOWSHERA,DISTRICT,HINDU JATI,815,406,409,0,324,166,158,0,491,240,251,0
NOWSHERA,NOWSHERA,DISTRICT,MUSLIM,1725710,846421,879240,49,1392706,687332,705356,18,333004,159089,173884,31
NOWSHERA,NOWSHERA,DISTRICT,OTHERS,145,70,75,0,87,49,38,0,58,21,37,0
NOWSHERA,NOWSHERA,DISTRICT,PARSI,1,1,0,0,0,0,0,0,1,1,0,0
NOWSHERA,NOWSHERA,DISTRICT,SCHEDULED CASTE,47,21,26,0,27,13,14,0,20,8,12,0
NOWSHERA,NOWSHERA,DISTRICT,SIKH,31,14,17,0,17,7,10,0,14,7,7,0
NOWSHERA,NOWSHERA,TEHSIL,QADIANI/AHMADI,30,14,16,0,17,10,7,0,13,4,9,0
NOWSHERA,NOWSHERA,TEHSIL,CHRISTIAN,6099,3054,3044,1,2824,1453,1371,0,3275,1601,1673,1
NOWSHERA,NOWSHERA,TEHSIL,HINDU JATI,802,398,404,0,311,158,153,0,491,240,251,0
NOWSHERA,NOWSHERA,TEHSIL,MUSLIM,784122,379625,404461,36,589860,289457,300395,8,194262,90168,104066,28
NOWSHERA,NOWSHERA,TEHSIL,OTHERS,102,43,59,0,65,32,33,0,37,11,26,0
NOWSHERA,NOWSHERA,TEHSIL,PARSI,1,1,0,0,0,0,0,0,1,1,0,0
NOWSHERA,NOWSHERA,TEHSIL,SCHEDULED CASTE,31,16,15,0,14,8,6,0,17,8,9,0
NOWSHERA,NOWSHERA,TEHSIL,SIKH,23,10,13,0,9,3,6,0,14,7,7,0
OGHI,MANSEHRA,TEHSIL,QADIANI/AHMADI,7,3,4,0,7,3,4,0,0,0,0,0
OGHI,MANSEHRA,TEHSIL,CHRISTIAN,635,353,282,0,635,353,282,0,0,0,0,0
OGHI,MANSEHRA,TEHSIL,HINDU JATI,6,5,1,0,6,5,1,0,0,0,0,0
OGHI,MANSEHRA,TEHSIL,MUSLIM,250835,126749,124080,6,250835,126749,124080,6,0,0,0,0
OGHI,MANSEHRA,TEHSIL,OTHERS,46,24,22,0,46,24,22,0,0,0,0,0
OGHI,MANSEHRA,TEHSIL,PARSI,0,0,0,0,0,0,0,0,0,0,0,0
OGHI,MANSEHRA,TEHSIL,SCHEDULED CASTE,0,0,0,0,0,0,0,0,0,0,0,0
OGHI,MANSEHRA,TEHSIL,SIKH,4,1,3,0,4,1,3,0,0,0,0,0
ORAKZAI,ORAKZAI,DISTRICT,QADIANI/AHMADI,33,13,20,0,33,13,20,0,0,0,0,0
ORAKZAI,ORAKZAI,DISTRICT,CHRISTIAN,719,366,353,0,719,366,353,0,0,0,0,0
ORAKZAI,ORAKZAI,DISTRICT,HINDU JATI,27,14,13,0,27,14,13,0,0,0,0,0
ORAKZAI,ORAKZAI,DISTRICT,MUSLIM,386749,182273,204469,7,386749,182273,204469,7,0,0,0,0
ORAKZAI,ORAKZAI,DISTRICT,OTHERS,16,8,8,0,16,8,8,0,0,0,0,0
ORAKZAI,ORAKZAI,DISTRICT,PARSI,0,0,0,0,0,0,0,0,0,0,0,0
ORAKZAI,ORAKZAI,DISTRICT,SCHEDULED CASTE,7,4,3,0,7,4,3,0,0,0,0,0
ORAKZAI,ORAKZAI,DISTRICT,SIKH,10,6,4,0,10,6,4,0,0,0,0,0
PABBI,NOWSHERA,TEHSIL,QADIANI/AHMADI,4,1,3,0,4,1,3,0,0,0,0,0
PABBI,NOWSHERA,TEHSIL,CHRISTIAN,1678,955,723,0,1277,725,552,0,401,230,171,0
PABBI,NOWSHERA,TEHSIL,HINDU JATI,11,7,4,0,11,7,4,0,0,0,0,0
PABBI,NOWSHERA,TEHSIL,MUSLIM,507778,250727,257043,8,455478,224884,230588,6,52300,25843,26455,2
PABBI,NOWSHERA,TEHSIL,OTHERS,13,10,3,0,13,10,3,0,0,0,0,0
PABBI,NOWSHERA,TEHSIL,PARSI,0,0,0,0,0,0,0,0,0,0,0,0
PABBI,NOWSHERA,TEHSIL,SCHEDULED CASTE,6,2,4,0,6,2,4,0,0,0,0,0
PABBI,NOWSHERA,TEHSIL,SIKH,5,2,3,0,5,2,3,0,0,0,0,0
PAHARPUR,DERA ISMAIL KHAN,TEHSIL,QADIANI/AHMADI,3,1,2,0,1,1,0,0,2,0,2,0
PAHARPUR,DERA ISMAIL KHAN,TEHSIL,CHRISTIAN,754,397,357,0,611,322,289,0,143,75,68,0
PAHARPUR,DERA ISMAIL KHAN,TEHSIL,HINDU JATI,6,2,4,0,6,2,4,0,0,0,0,0
PAHARPUR,DERA ISMAIL KHAN,TEHSIL,MUSLIM,405693,196220,209465,8,318147,154389,163753,5,87546,41831,45712,3
PAHARPUR,DERA ISMAIL KHAN,TEHSIL,OTHERS,5,4,1,0,3,2,1,0,2,2,0,0
PAHARPUR,DERA ISMAIL KHAN,TEHSIL,PARSI,0,0,0,0,0,0,0,0,0,0,0,0
PAHARPUR,DERA ISMAIL KHAN,TEHSIL,SCHEDULED CASTE,0,0,0,0,0,0,0,0,0,0,0,0
PAHARPUR,DERA ISMAIL KHAN,TEHSIL,SIKH,6,2,4,0,3,1,2,0,3,1,2,0
PALAS,KOLAI PALAS KOHISTAN,SUB-DIVISION,QADIANI/AHMADI,0,0,0,0,0,0,0,0,0,0,0,0
PALAS,KOLAI PALAS KOHISTAN,SUB-DIVISION,CHRISTIAN,168,96,72,0,168,96,72,0,0,0,0,0
PALAS,KOLAI PALAS KOHISTAN,SUB-DIVISION,HINDU JATI,5,1,4,0,5,1,4,0,0,0,0,0
PALAS,KOLAI PALAS KOHISTAN,SUB-DIVISION,MUSLIM,96565,47417,49147,1,96565,47417,49147,1,0,0,0,0
PALAS,KOLAI PALAS KOHISTAN,SUB-DIVISION,OTHERS,9,2,7,0,9,2,7,0,0,0,0,0
PALAS,KOLAI PALAS KOHISTAN,SUB-DIVISION,PARSI,0,0,0,0,0,0,0,0,0,0,0,0
PALAS,KOLAI PALAS KOHISTAN,SUB-DIVISION,SCHEDULED CASTE,1,0,1,0,1,0,1,0,0,0,0,0
PALAS,KOLAI PALAS KOHISTAN,SUB-DIVISION,SIKH,2,0,2,0,2,0,2,0,0,0,0,0
PAROA,DERA ISMAIL KHAN,TEHSIL,QADIANI/AHMADI,0,0,0,0,0,0,0,0,0,0,0,0
PAROA,DERA ISMAIL KHAN,TEHSIL,CHRISTIAN,641,311,330,0,578,277,301,0,63,34,29,0
PAROA,DERA ISMAIL KHAN,TEHSIL,HINDU JATI,69,38,31,0,69,38,31,0,0,0,0,0
PAROA,DERA ISMAIL KHAN,TEHSIL,MUSLIM,318072,151254,166817,1,276306,131301,145005,0,41766,19953,21812,1
PAROA,DERA ISMAIL KHAN,TEHSIL,OTHERS,33,16,17,0,32,16,16,0,1,0,1,0
PAROA,DERA ISMAIL KHAN,TEHSIL,PARSI,0,0,0,0,0,0,0,0,0,0,0,0
PAROA,DERA ISMAIL KHAN,TEHSIL,SCHEDULED CASTE,8,1,7,0,8,1,7,0,0,0,0,0
PAROA,DERA ISMAIL KHAN,TEHSIL,SIKH,3,1,2,0,3,1,2,0,0,0,0,0
PATTAN,LOWER KOHISTAN,SUB-DIVISION,QADIANI/AHMADI,1,1,0,0,1,1,0,0,0,0,0,0
PATTAN,LOWER KOHISTAN,SUB-DIVISION,CHRISTIAN,288,155,133,0,288,155,133,0,0,0,0,0
PATTAN,LOWER KOHISTAN,SUB-DIVISION,HINDU JATI,1,1,0,0,1,1,0,0,0,0,0,0
PATTAN,LOWER KOHISTAN,SUB-DIVISION,MUSLIM,125924,61380,64540,4,125924,61380,64540,4,0,0,0,0
PATTAN,LOWER KOHISTAN,SUB-DIVISION,OTHERS,27,12,15,0,27,12,15,0,0,0,0,0
PATTAN,LOWER KOHISTAN,SUB-DIVISION,PARSI,2,2,0,0,2,2,0,0,0,0,0,0
PATTAN,LOWER KOHISTAN,SUB-DIVISION,SCHEDULED CASTE,2,0,2,0,2,0,2,0,0,0,0,0
PATTAN,LOWER KOHISTAN,SUB-DIVISION,SIKH,3,2,1,0,3,2,1,0,0,0,0,0
PESHAWAR,PESHAWAR,DISTRICT,QADIANI/AHMADI,213,118,95,0,47,27,20,0,166,91,75,0
PESHAWAR,PESHAWAR,DISTRICT,CHRISTIAN,33249,17266,15983,0,9611,5114,4497,0,23638,12152,11486,0
PESHAWAR,PESHAWAR,DISTRICT,HINDU JATI,1708,844,864,0,68,33,35,0,1640,811,829,0
PESHAWAR,PESHAWAR,DISTRICT,MUSLIM,4713004,2309053,2403768,183,2840891,1400623,1440239,29,1872113,908430,963529,154
PESHAWAR,PESHAWAR,DISTRICT,OTHERS,614,316,294,4,138,84,53,1,476,232,241,3
PESHAWAR,PESHAWAR,DISTRICT,PARSI,5,1,4,0,5,1,4,0,0,0,0,0
PESHAWAR,PESHAWAR,DISTRICT,SCHEDULED CASTE,114,73,41,0,28,9,19,0,86,64,22,0
PESHAWAR,PESHAWAR,DISTRICT,SIKH,1481,727,754,0,40,13,27,0,1441,714,727,0
PESHAWAR,PESHAWAR,TEHSIL,QADIANI/AHMADI,169,91,78,0,3,0,3,0,166,91,75,0
PESHAWAR,PESHAWAR,TEHSIL,CHRISTIAN,26381,13558,12823,0,2743,1406,1337,0,23638,12152,11486,0
PESHAWAR,PESHAWAR,TEHSIL,HINDU JATI,1658,822,836,0,18,11,7,0,1640,811,829,0
PESHAWAR,PESHAWAR,TEHSIL,MUSLIM,2076914,1008170,1068588,156,204801,99740,105059,2,1872113,908430,963529,154
PESHAWAR,PESHAWAR,TEHSIL,OTHERS,487,238,246,3,11,6,5,0,476,232,241,3
PESHAWAR,PESHAWAR,TEHSIL,PARSI,0,0,0,0,0,0,0,0,0,0,0,0
PESHAWAR,PESHAWAR,TEHSIL,SCHEDULED CASTE,86,64,22,0,0,0,0,0,86,64,22,0
PESHAWAR,PESHAWAR,TEHSIL,SIKH,1441,714,727,0,0,0,0,0,1441,714,727,0
PINDIALI,MOHMAND,TEHSIL,QADIANI/AHMADI,0,0,0,0,0,0,0,0,0,0,0,0
PINDIALI,MOHMAND,TEHSIL,CHRISTIAN,243,137,106,0,243,137,106,0,0,0,0,0
PINDIALI,MOHMAND,TEHSIL,HINDU JATI,0,0,0,0,0,0,0,0,0,0,0,0
PINDIALI,MOHMAND,TEHSIL,MUSLIM,111998,54775,57221,2,111998,54775,57221,2,0,0,0,0
PINDIALI,MOHMAND,TEHSIL,OTHERS,4,3,1,0,4,3,1,0,0,0,0,0
PINDIALI,MOHMAND,TEHSIL,PARSI,0,0,0,0,0,0,0,0,0,0,0,0
PINDIALI,MOHMAND,TEHSIL,SCHEDULED CASTE,1,1,0,0,1,1,0,0,0,0,0,0
PINDIALI,MOHMAND,TEHSIL,SIKH,1,0,1,0,1,0,1,0,0,0,0,0
PISHTA KHARA,PESHAWAR,TEHSIL,QADIANI/AHMADI,3,3,0,0,3,3,0,0,0,0,0,0
PISHTA KHARA,PESHAWAR,TEHSIL,CHRISTIAN,1324,728,596,0,1324,728,596,0,0,0,0,0
PISHTA KHARA,PESHAWAR,TEHSIL,HINDU JATI,13,5,8,0,13,5,8,0,0,0,0,0
PISHTA KHARA,PESHAWAR,TEHSIL,MUSLIM,477243,234736,242501,6,477243,234736,242501,6,0,0,0,0
PISHTA KHARA,PESHAWAR,TEHSIL,OTHERS,8,5,3,0,8,5,3,0,0,0,0,0
PISHTA KHARA,PESHAWAR,TEHSIL,PARSI,0,0,0,0,0,0,0,0,0,0,0,0
PISHTA KHARA,PESHAWAR,TEHSIL,SCHEDULED CASTE,1,1,0,0,1,1,0,0,0,0,0,0
PISHTA KHARA,PESHAWAR,TEHSIL,SIKH,3,2,1,0,3,2,1,0,0,0,0,0
PRANG GHAR,MOHMAND,TEHSIL,QADIANI/AHMADI,0,0,0,0,0,0,0,0,0,0,0,0
PRANG GHAR,MOHMAND,TEHSIL,CHRISTIAN,34,22,12,0,34,22,12,0,0,0,0,0
PRANG GHAR,MOHMAND,TEHSIL,HINDU JATI,0,0,0,0,0,0,0,0,0,0,0,0
PRANG GHAR,MOHMAND,TEHSIL,MUSLIM,36006,18094,17912,0,36006,18094,17912,0,0,0,0,0
PRANG GHAR,MOHMAND,TEHSIL,OTHERS,5,3,2,0,5,3,2,0,0,0,0,0
PRANG GHAR,MOHMAND,TEHSIL,PARSI,0,0,0,0,0,0,0,0,0,0,0,0
PRANG GHAR,MOHMAND,TEHSIL,SCHEDULED CASTE,0,0,0,0,0,0,0,0,0,0,0,0
PRANG GHAR,MOHMAND,TEHSIL,SIKH,1,0,1,0,1,0,1,0,0,0,0,0
PURAN,SHANGLA,TEHSIL,QADIANI/AHMADI,3,3,0,0,3,3,0,0,0,0,0,0
PURAN,SHANGLA,TEHSIL,CHRISTIAN,545,289,256,0,545,289,256,0,0,0,0,0
PURAN,SHANGLA,TEHSIL,HINDU JATI,1,1,0,0,1,1,0,0,0,0,0,0
PURAN,SHANGLA,TEHSIL,MUSLIM,171196,81567,89629,0,171196,81567,89629,0,0,0,0,0
PURAN,SHANGLA,TEHSIL,OTHERS,1,0,1,0,1,0,1,0,0,0,0,0
PURAN,SHANGLA,TEHSIL,PARSI,0,0,0,0,0,0,0,0,0,0,0,0
PURAN,SHANGLA,TEHSIL,SCHEDULED CASTE,5,2,3,0,5,2,3,0,0,0,0,0
PURAN,SHANGLA,TEHSIL,SIKH,2,1,1,0,2,1,1,0,0,0,0,0
RAZAR,SWABI,TEHSIL,QADIANI/AHMADI,3,1,2,0,3,1,2,0,0,0,0,0
RAZAR,SWABI,TEHSIL,CHRISTIAN,1572,845,727,0,1524,818,706,0,48,27,21,0
RAZAR,SWABI,TEHSIL,HINDU JATI,34,19,15,0,34,19,15,0,0,0,0,0
RAZAR,SWABI,TEHSIL,MUSLIM,678335,332024,346302,9,650766,318547,332210,9,27569,13477,14092,0
RAZAR,SWABI,TEHSIL,OTHERS,11,6,5,0,10,6,4,0,1,0,1,0
RAZAR,SWABI,TEHSIL,PARSI,0,0,0,0,0,0,0,0,0,0,0,0
RAZAR,SWABI,TEHSIL,SCHEDULED CASTE,3,2,1,0,3,2,1,0,0,0,0,0
RAZAR,SWABI,TEHSIL,SIKH,9,5,4,0,9,5,4,0,0,0,0,0
RAZMAK,NORTH WAZIRISTAN,TEHSIL,QADIANI/AHMADI,1,0,1,0,1,0,1,0,0,0,0,0
RAZMAK,NORTH WAZIRISTAN,TEHSIL,CHRISTIAN,228,86,142,0,228,86,142,0,0,0,0,0
RAZMAK,NORTH WAZIRISTAN,TEHSIL,HINDU JATI,0,0,0,0,0,0,0,0,0,0,0,0
RAZMAK,NORTH WAZIRISTAN,TEHSIL,MUSLIM,49124,20947,28174,3,49124,20947,28174,3,0,0,0,0
RAZMAK,NORTH WAZIRISTAN,TEHSIL,OTHERS,11,4,7,0,11,4,7,0,0,0,0,0
RAZMAK,NORTH WAZIRISTAN,TEHSIL,PARSI,0,0,0,0,0,0,0,0,0,0,0,0
RAZMAK,NORTH WAZIRISTAN,TEHSIL,SCHEDULED CASTE,1,0,1,0,1,0,1,0,0,0,0,0
RAZMAK,NORTH WAZIRISTAN,TEHSIL,SIKH,2,2,0,0,2,2,0,0,0,0,0,0
RUSTAM,MARDAN,TEHSIL,QADIANI/AHMADI,2,2,0,0,2,2,0,0,0,0,0,0
RUSTAM,MARDAN,TEHSIL,CHRISTIAN,578,318,260,0,578,318,260,0,0,0,0,0
RUSTAM,MARDAN,TEHSIL,HINDU JATI,0,0,0,0,0,0,0,0,0,0,0,0
RUSTAM,MARDAN,TEHSIL,MUSLIM,278915,138295,140618,2,278915,138295,140618,2,0,0,0,0
RUSTAM,MARDAN,TEHSIL,OTHERS,10,3,7,0,10,3,7,0,0,0,0,0
RUSTAM,MARDAN,TEHSIL,PARSI,0,0,0,0,0,0,0,0,0,0,0,0
RUSTAM,MARDAN,TEHSIL,SCHEDULED CASTE,2,0,2,0,2,0,2,0,0,0,0,0
RUSTAM,MARDAN,TEHSIL,SIKH,2,1,1,0,2,1,1,0,0,0,0,0
SAFI,MOHMAND,TEHSIL,QADIANI/AHMADI,1,0,1,0,1,0,1,0,0,0,0,0
SAFI,MOHMAND,TEHSIL,CHRISTIAN,474,227,247,0,474,227,247,0,0,0,0,0
SAFI,MOHMAND,TEHSIL,HINDU JATI,0,0,0,0,0,0,0,0,0,0,0,0
SAFI,MOHMAND,TEHSIL,MUSLIM,109143,53028,56113,2,109143,53028,56113,2,0,0,0,0
SAFI,MOHMAND,TEHSIL,OTHERS,1,1,0,0,1,1,0,0,0,0,0,0
SAFI,MOHMAND,TEHSIL,PARSI,0,0,0,0,0,0,0,0,0,0,0,0
SAFI,MOHMAND,TEHSIL,SCHEDULED CASTE,0,0,0,0,0,0,0,0,0,0,0,0
SAFI,MOHMAND,TEHSIL,SIKH,1,1,0,0,1,1,0,0,0,0,0,0
SALARZAI,BAJAUR,TEHSIL,QADIANI/AHMADI,4,2,2,0,4,2,2,0,0,0,0,0
SALARZAI,BAJAUR,TEHSIL,CHRISTIAN,716,385,331,0,716,385,331,0,0,0,0,0
SALARZAI,BAJAUR,TEHSIL,HINDU JATI,21,10,11,0,21,10,11,0,0,0,0,0
SALARZAI,BAJAUR,TEHSIL,MUSLIM,314978,156645,158330,3,314978,156645,158330,3,0,0,0,0
SALARZAI,BAJAUR,TEHSIL,OTHERS,16,9,7,0,16,9,7,0,0,0,0,0
SALARZAI,BAJAUR,TEHSIL,PARSI,0,0,0,0,0,0,0,0,0,0,0,0
SALARZAI,BAJAUR,TEHSIL,SCHEDULED CASTE,2,1,1,0,2,1,1,0,0,0,0,0
SALARZAI,BAJAUR,TEHSIL,SIKH,8,4,4,0,8,4,4,0,0,0,0,0
SAM RANI ZAI,MALAKAND,SUB-DIVISION,QADIANI/AHMADI,3,3,0,0,3,3,0,0,0,0,0,0
SAM RANI ZAI,MALAKAND,SUB-DIVISION,CHRISTIAN,786,434,352,0,786,434,352,0,0,0,0,0
SAM RANI ZAI,MALAKAND,SUB-DIVISION,HINDU JATI,60,31,29,0,60,31,29,0,0,0,0,0
SAM RANI ZAI,MALAKAND,SUB-DIVISION,MUSLIM,351967,171829,180135,3,351967,171829,180135,3,0,0,0,0
SAM RANI ZAI,MALAKAND,SUB-DIVISION,OTHERS,27,14,13,0,27,14,13,0,0,0,0,0
SAM RANI ZAI,MALAKAND,SUB-DIVISION,PARSI,0,0,0,0,0,0,0,0,0,0,0,0
SAM RANI ZAI,MALAKAND,SUB-DIVISION,SCHEDULED CASTE,2,1,1,0,2,1,1,0,0,0,0,0
SAM RANI ZAI,MALAKAND,SUB-DIVISION,SIKH,27,14,13,0,27,14,13,0,0,0,0,0
SAMARBAGH,LOWER DIR,SUB-DIVISION,QADIANI/AHMADI,6,3,3,0,6,3,3,0,0,0,0,0
SAMARBAGH,LOWER DIR,SUB-DIVISION,CHRISTIAN,917,483,434,0,917,483,434,0,0,0,0,0
SAMARBAGH,LOWER DIR,SUB-DIVISION,HINDU JATI,8,4,4,0,8,4,4,0,0,0,0,0
SAMARBAGH,LOWER DIR,SUB-DIVISION,MUSLIM,426677,215523,211145,9,426677,215523,211145,9,0,0,0,0
SAMARBAGH,LOWER DIR,SUB-DIVISION,OTHERS,8,4,4,0,8,4,4,0,0,0,0,0
SAMARBAGH,LOWER DIR,SUB-DIVISION,PARSI,1,1,0,0,1,1,0,0,0,0,0,0
SAMARBAGH,LOWER DIR,SUB-DIVISION,SCHEDULED CASTE,5,2,3,0,5,2,3,0,0,0,0,0
SAMARBAGH,LOWER DIR,SUB-DIVISION,SIKH,6,4,2,0,6,4,2,0,0,0,0,0
SARAI NAURANG,LAKKI MARWAT,TEHSIL,QADIANI/AHMADI,5,5,0,0,5,5,0,0,0,0,0,0
SARAI NAURANG,LAKKI MARWAT,TEHSIL,CHRISTIAN,895,485,410,0,809,437,372,0,86,48,38,0
SARAI NAURANG,LAKKI MARWAT,TEHSIL,HINDU JATI,1,0,1,0,1,0,1,0,0,0,0,0
SARAI NAURANG,LAKKI MARWAT,TEHSIL,MUSLIM,331631,162587,169040,4,299506,146652,152850,4,32125,15935,16190,0
SARAI NAURANG,LAKKI MARWAT,TEHSIL,OTHERS,7,4,3,0,6,3,3,0,1,1,0,0
SARAI NAURANG,LAKKI MARWAT,TEHSIL,PARSI,0,0,0,0,0,0,0,0,0,0,0,0
SARAI NAURANG,LAKKI MARWAT,TEHSIL,SCHEDULED CASTE,5,1,4,0,5,1,4,0,0,0,0,0
SARAI NAURANG,LAKKI MARWAT,TEHSIL,SIKH,4,3,1,0,4,3,1,0,0,0,0,0
SARAROGHA,SOUTH WAZIRISTAN,TEHSIL,QADIANI/AHMADI,14,3,11,0,14,3,11,0,0,0,0,0
SARAROGHA,SOUTH WAZIRISTAN,TEHSIL,CHRISTIAN,217,98,119,0,217,98,119,0,0,0,0,0
SARAROGHA,SOUTH WAZIRISTAN,TEHSIL,HINDU JATI,0,0,0,0,0,0,0,0,0,0,0,0
SARAROGHA,SOUTH WAZIRISTAN,TEHSIL,MUSLIM,144863,69147,75714,2,144863,69147,75714,2,0,0,0,0
SARAROGHA,SOUTH WAZIRISTAN,TEHSIL,OTHERS,8,3,5,0,8,3,5,0,0,0,0,0
SARAROGHA,SOUTH WAZIRISTAN,TEHSIL,PARSI,0,0,0,0,0,0,0,0,0,0,0,0
SARAROGHA,SOUTH WAZIRISTAN,TEHSIL,SCHEDULED CASTE,3,1,2,0,3,1,2,0,0,0,0,0
SARAROGHA,SOUTH WAZIRISTAN,TEHSIL,SIKH,13,4,9,0,13,4,9,0,0,0,0,0
SEO,UPPER KOHISTAN,SUB-DIVISION,QADIANI/AHMADI,0,0,0,0,0,0,0,0,0,0,0,0
SEO,UPPER KOHISTAN,SUB-DIVISION,CHRISTIAN,67,33,34,0,67,33,34,0,0,0,0,0
SEO,UPPER KOHISTAN,SUB-DIVISION,HINDU JATI,5,2,3,0,5,2,3,0,0,0,0,0
SEO,UPPER KOHISTAN,SUB-DIVISION,MUSLIM,54542,27942,26599,1,54542,27942,26599,1,0,0,0,0
SEO,UPPER KOHISTAN,SUB-DIVISION,OTHERS,9,5,4,0,9,5,4,0,0,0,0,0
SEO,UPPER KOHISTAN,SUB-DIVISION,PARSI,0,0,0,0,0,0,0,0,0,0,0,0
SEO,UPPER KOHISTAN,SUB-DIVISION,SCHEDULED CASTE,2,0,2,0,2,0,2,0,0,0,0,0
SEO,UPPER KOHISTAN,SUB-DIVISION,SIKH,1,0,1,0,1,0,1,0,0,0,0,0
SERWEKAI,SOUTH WAZIRISTAN,TEHSIL,QADIANI/AHMADI,2,2,0,0,2,2,0,0,0,0,0,0
SERWEKAI,SOUTH WAZIRISTAN,TEHSIL,CHRISTIAN,119,64,55,0,119,64,55,0,0,0,0,0
SERWEKAI,SOUTH WAZIRISTAN,TEHSIL,HINDU JATI,1,0,1,0,1,0,1,0,0,0,0,0
SERWEKAI,SOUTH WAZIRISTAN,TEHSIL,MUSLIM,58682,28601,30080,1,58682,28601,30080,1,0,0,0,0
SERWEKAI,SOUTH WAZIRISTAN,TEHSIL,OTHERS,0,0,0,0,0,0,0,0,0,0,0,0
SERWEKAI,SOUTH WAZIRISTAN,TEHSIL,PARSI,0,0,0,0,0,0,0,0,0,0,0,0
SERWEKAI,SOUTH WAZIRISTAN,TEHSIL,SCHEDULED CASTE,0,0,0,0,0,0,0,0,0,0,0,0
SERWEKAI,SOUTH WAZIRISTAN,TEHSIL,SIKH,0,0,0,0,0,0,0,0,0,0,0,0
SHABQADAR,CHARSADDA,TEHSIL,QADIANI/AHMADI,11,6,5,0,10,6,4,0,1,0,1,0
SHABQADAR,CHARSADDA,TEHSIL,CHRISTIAN,981,539,442,0,594,330,264,0,387,209,178,0
SHABQADAR,CHARSADDA,TEHSIL,HINDU JATI,15,8,7,0,8,5,3,0,7,3,4,0
SHABQADAR,CHARSADDA,TEHSIL,MUSLIM,439141,213087,226047,7,337212,164566,172640,6,101929,48521,53407,1
SHABQADAR,CHARSADDA,TEHSIL,OTHERS,5,3,2,0,5,3,2,0,0,0,0,0
SHABQADAR,CHARSADDA,TEHSIL,PARSI,0,0,0,0,0,0,0,0,0,0,0,0
SHABQADAR,CHARSADDA,TEHSIL,SCHEDULED CASTE,12,2,10,0,8,2,6,0,4,0,4,0
SHABQADAR,CHARSADDA,TEHSIL,SIKH,1,0,1,0,0,0,0,0,1,0,1,0
SHAH ALAM,PESHAWAR,TEHSIL,QADIANI/AHMADI,8,2,6,0,8,2,6,0,0,0,0,0
SHAH ALAM,PESHAWAR,TEHSIL,CHRISTIAN,1196,640,556,0,1196,640,556,0,0,0,0,0
SHAH ALAM,PESHAWAR,TEHSIL,HINDU JATI,7,5,2,0,7,5,2,0,0,0,0,0
SHAH ALAM,PESHAWAR,TEHSIL,MUSLIM,531599,260999,270599,1,531599,260999,270599,1,0,0,0,0
SHAH ALAM,PESHAWAR,TEHSIL,OTHERS,11,7,4,0,11,7,4,0,0,0,0,0
SHAH ALAM,PESHAWAR,TEHSIL,PARSI,0,0,0,0,0,0,0,0,0,0,0,0
SHAH ALAM,PESHAWAR,TEHSIL,SCHEDULED CASTE,13,4,9,0,13,4,9,0,0,0,0,0
SHAH ALAM,PESHAWAR,TEHSIL,SIKH,14,2,12,0,14,2,12,0,0,0,0,0
SHAKTOI,SOUTH WAZIRISTAN,TEHSIL,QADIANI/AHMADI,3,3,0,0,3,3,0,0,0,0,0,0
SHAKTOI,SOUTH WAZIRISTAN,TEHSIL,CHRISTIAN,75,43,32,0,75,43,32,0,0,0,0,0
SHAKTOI,SOUTH WAZIRISTAN,TEHSIL,HINDU JATI,0,0,0,0,0,0,0,0,0,0,0,0
SHAKTOI,SOUTH WAZIRISTAN,TEHSIL,MUSLIM,44252,21132,23120,0,44252,21132,23120,0,0,0,0,0
SHAKTOI,SOUTH WAZIRISTAN,TEHSIL,OTHERS,1,1,0,0,1,1,0,0,0,0,0,0
SHAKTOI,SOUTH WAZIRISTAN,TEHSIL,PARSI,0,0,0,0,0,0,0,0,0,0,0,0
SHAKTOI,SOUTH WAZIRISTAN,TEHSIL,SCHEDULED CASTE,0,0,0,0,0,0,0,0,0,0,0,0
SHAKTOI,SOUTH WAZIRISTAN,TEHSIL,SIKH,1,1,0,0,1,1,0,0,0,0,0,0
SHANGLA,SHANGLA,DISTRICT,QADIANI/AHMADI,9,5,4,0,9,5,4,0,0,0,0,0
SHANGLA,SHANGLA,DISTRICT,CHRISTIAN,2140,1124,1015,1,2140,1124,1015,1,0,0,0,0
SHANGLA,SHANGLA,DISTRICT,HINDU JATI,19,14,5,0,19,14,5,0,0,0,0,0
SHANGLA,SHANGLA,DISTRICT,MUSLIM,888436,429803,458628,5,888436,429803,458628,5,0,0,0,0
SHANGLA,SHANGLA,DISTRICT,OTHERS,181,97,84,0,181,97,84,0,0,0,0,0
SHANGLA,SHANGLA,DISTRICT,PARSI,0,0,0,0,0,0,0,0,0,0,0,0
SHANGLA,SHANGLA,DISTRICT,SCHEDULED CASTE,11,4,7,0,11,4,7,0,0,0,0,0
SHANGLA,SHANGLA,DISTRICT,SIKH,50,23,27,0,50,23,27,0,0,0,0,0
SHARINGAL,UPPER DIR,SUB-DIVISION,QADIANI/AHMADI,3,2,1,0,3,2,1,0,0,0,0,0
SHARINGAL,UPPER DIR,SUB-DIVISION,CHRISTIAN,292,160,132,0,292,160,132,0,0,0,0,0
SHARINGAL,UPPER DIR,SUB-DIVISION,HINDU JATI,0,0,0,0,0,0,0,0,0,0,0,0
SHARINGAL,UPPER DIR,SUB-DIVISION,MUSLIM,210011,105043,104968,0,210011,105043,104968,0,0,0,0,0
SHARINGAL,UPPER DIR,SUB-DIVISION,OTHERS,45,21,24,0,45,21,24,0,0,0,0,0
SHARINGAL,UPPER DIR,SUB-DIVISION,PARSI,0,0,0,0,0,0,0,0,0,0,0,0
SHARINGAL,UPPER DIR,SUB-DIVISION,SCHEDULED CASTE,4,1,3,0,4,1,3,0,0,0,0,0
SHARINGAL,UPPER DIR,SUB-DIVISION,SIKH,1,0,1,0,1,0,1,0,0,0,0,0
SHEWA,NORTH WAZIRISTAN,TEHSIL,QADIANI/AHMADI,0,0,0,0,0,0,0,0,0,0,0,0
SHEWA,NORTH WAZIRISTAN,TEHSIL,CHRISTIAN,84,42,42,0,84,42,42,0,0,0,0,0
SHEWA,NORTH WAZIRISTAN,TEHSIL,HINDU JATI,0,0,0,0,0,0,0,0,0,0,0,0
SHEWA,NORTH WAZIRISTAN,TEHSIL,MUSLIM,44040,22735,21304,1,44040,22735,21304,1,0,0,0,0
SHEWA,NORTH WAZIRISTAN,TEHSIL,OTHERS,1,1,0,0,1,1,0,0,0,0,0,0
SHEWA,NORTH WAZIRISTAN,TEHSIL,PARSI,0,0,0,0,0,0,0,0,0,0,0,0
SHEWA,NORTH WAZIRISTAN,TEHSIL,SCHEDULED CASTE,0,0,0,0,0,0,0,0,0,0,0,0
SHEWA,NORTH WAZIRISTAN,TEHSIL,SIKH,1,1,0,0,1,1,0,0,0,0,0,0
SOUTH WAZIRISTAN,SOUTH WAZIRISTAN,DISTRICT,QADIANI/AHMADI,23,9,14,0,23,9,14,0,0,0,0,0
SOUTH WAZIRISTAN,SOUTH WAZIRISTAN,DISTRICT,CHRISTIAN,1556,785,771,0,1556,785,771,0,0,0,0,0
SOUTH WAZIRISTAN,SOUTH WAZIRISTAN,DISTRICT,HINDU JATI,4,2,2,0,4,2,2,0,0,0,0,0
SOUTH WAZIRISTAN,SOUTH WAZIRISTAN,DISTRICT,MUSLIM,886981,428283,458684,14,886981,428283,458684,14,0,0,0,0
SOUTH WAZIRISTAN,SOUTH WAZIRISTAN,DISTRICT,OTHERS,70,35,35,0,70,35,35,0,0,0,0,0
SOUTH WAZIRISTAN,SOUTH WAZIRISTAN,DISTRICT,PARSI,0,0,0,0,0,0,0,0,0,0,0,0
SOUTH WAZIRISTAN,SOUTH WAZIRISTAN,DISTRICT,SCHEDULED CASTE,13,4,9,0,13,4,9,0,0,0,0,0
SOUTH WAZIRISTAN,SOUTH WAZIRISTAN,DISTRICT,SIKH,28,12,16,0,28,12,16,0,0,0,0,0
SPINWAM,NORTH WAZIRISTAN,TEHSIL,QADIANI/AHMADI,3,1,2,0,3,1,2,0,0,0,0,0
SPINWAM,NORTH WAZIRISTAN,TEHSIL,CHRISTIAN,137,69,68,0,137,69,68,0,0,0,0,0
SPINWAM,NORTH WAZIRISTAN,TEHSIL,HINDU JATI,3,1,2,0,3,1,2,0,0,0,0,0
SPINWAM,NORTH WAZIRISTAN,TEHSIL,MUSLIM,54064,27054,27007,3,54064,27054,27007,3,0,0,0,0
SPINWAM,NORTH WAZIRISTAN,TEHSIL,OTHERS,2,2,0,0,2,2,0,0,0,0,0,0
SPINWAM,NORTH WAZIRISTAN,TEHSIL,PARSI,0,0,0,0,0,0,0,0,0,0,0,0
SPINWAM,NORTH WAZIRISTAN,TEHSIL,SCHEDULED CASTE,0,0,0,0,0,0,0,0,0,0,0,0
SPINWAM,NORTH WAZIRISTAN,TEHSIL,SIKH,0,0,0,0,0,0,0,0,0,0,0,0
SWABI,SWABI,DISTRICT,QADIANI/AHMADI,28,18,10,0,17,13,4,0,11,5,6,0
SWABI,SWABI,DISTRICT,CHRISTIAN,4608,2490,2118,0,3629,1966,1663,0,979,524,455,0
SWABI,SWABI,DISTRICT,HINDU JATI,64,35,29,0,42,23,19,0,22,12,10,0
SWABI,SWABI,DISTRICT,MUSLIM,1885379,930621,954723,35,1547111,763229,783863,19,338268,167392,170860,16
SWABI,SWABI,DISTRICT,OTHERS,77,43,34,0,57,31,26,0,20,12,8,0
SWABI,SWABI,DISTRICT,PARSI,1,0,1,0,1,0,1,0,0,0,0,0
SWABI,SWABI,DISTRICT,SCHEDULED CASTE,16,9,7,0,15,8,7,0,1,1,0,0
SWABI,SWABI,DISTRICT,SIKH,57,27,30,0,18,9,9,0,39,18,21,0
SWABI,SWABI,TEHSIL,QADIANI/AHMADI,7,5,2,0,6,5,1,0,1,0,1,0
SWABI,SWABI,TEHSIL,CHRISTIAN,1254,684,570,0,630,353,277,0,624,331,293,0
SWABI,SWABI,TEHSIL,HINDU JATI,2,2,0,0,1,1,0,0,1,1,0,0
SWABI,SWABI,TEHSIL,MUSLIM,474067,238001,236046,20,284008,143014,140990,4,190059,94987,95056,16
SWABI,SWABI,TEHSIL,OTHERS,14,8,6,0,5,2,3,0,9,6,3,0
SWABI,SWABI,TEHSIL,PARSI,0,0,0,0,0,0,0,0,0,0,0,0
SWABI,SWABI,TEHSIL,SCHEDULED CASTE,3,1,2,0,2,0,2,0,1,1,0,0
SWABI,SWABI,TEHSIL,SIKH,5,4,1,0,4,3,1,0,1,1,0,0
SWAT,SWAT,DISTRICT,QADIANI/AHMADI,27,14,13,0,19,10,9,0,8,4,4,0
SWAT,SWAT,DISTRICT,CHRISTIAN,7219,3957,3262,0,5121,2817,2304,0,2098,1140,958,0
SWAT,SWAT,DISTRICT,HINDU JATI,89,38,51,0,56,20,36,0,33,18,15,0
SWAT,SWAT,DISTRICT,MUSLIM,2677745,1306745,1370913,87,1887006,924898,962080,28,790739,381847,408833,59
SWAT,SWAT,DISTRICT,OTHERS,425,231,194,0,390,208,182,0,35,23,12,0
SWAT,SWAT,DISTRICT,PARSI,3,2,1,0,3,2,1,0,0,0,0,0
SWAT,SWAT,DISTRICT,SCHEDULED CASTE,28,10,18,0,23,7,16,0,5,3,2,0
SWAT,SWAT,DISTRICT,SIKH,540,260,280,0,52,23,29,0,488,237,251,0
SWAT RANI ZAI,MALAKAND,SUB-DIVISION,QADIANI/AHMADI,12,7,5,0,7,6,1,0,5,1,4,0
SWAT RANI ZAI,MALAKAND,SUB-DIVISION,CHRISTIAN,1306,669,637,0,829,434,395,0,477,235,242,0
SWAT RANI ZAI,MALAKAND,SUB-DIVISION,HINDU JATI,15,11,4,0,13,9,4,0,2,2,0,0
SWAT RANI ZAI,MALAKAND,SUB-DIVISION,MUSLIM,471089,229936,241144,9,398051,195005,203043,3,73038,34931,38101,6
SWAT RANI ZAI,MALAKAND,SUB-DIVISION,OTHERS,71,36,35,0,71,36,35,0,0,0,0,0
SWAT RANI ZAI,MALAKAND,SUB-DIVISION,PARSI,0,0,0,0,0,0,0,0,0,0,0,0
SWAT RANI ZAI,MALAKAND,SUB-DIVISION,SCHEDULED CASTE,9,5,4,0,6,4,2,0,3,1,2,0
SWAT RANI ZAI,MALAKAND,SUB-DIVISION,SIKH,3,1,2,0,3,1,2,0,0,0,0,0
TAKHT BHAI,MARDAN,TEHSIL,QADIANI/AHMADI,7,2,5,0,7,2,5,0,0,0,0,0
TAKHT BHAI,MARDAN,TEHSIL,CHRISTIAN,1354,718,636,0,1131,607,524,0,223,111,112,0
TAKHT BHAI,MARDAN,TEHSIL,HINDU JATI,24,12,12,0,23,11,12,0,1,1,0,0
TAKHT BHAI,MARDAN,TEHSIL,MUSLIM,722799,351694,371099,6,638102,310038,328058,6,84697,41656,43041,0
TAKHT BHAI,MARDAN,TEHSIL,OTHERS,21,9,12,0,19,7,12,0,2,2,0,0
TAKHT BHAI,MARDAN,TEHSIL,PARSI,0,0,0,0,0,0,0,0,0,0,0,0
TAKHT BHAI,MARDAN,TEHSIL,SCHEDULED CASTE,7,7,0,0,6,6,0,0,1,1,0,0
TAKHT BHAI,MARDAN,TEHSIL,SIKH,12,2,10,0,12,2,10,0,0,0,0,0
TAKHT-E-NASRATI,KARAK,TEHSIL,QADIANI/AHMADI,3,2,1,0,3,2,1,0,0,0,0,0
TAKHT-E-NASRATI,KARAK,TEHSIL,CHRISTIAN,579,304,275,0,579,304,275,0,0,0,0,0
TAKHT-E-NASRATI,KARAK,TEHSIL,HINDU JATI,4,2,2,0,4,2,2,0,0,0,0,0
TAKHT-E-NASRATI,KARAK,TEHSIL,MUSLIM,297527,142103,155420,4,297527,142103,155420,4,0,0,0,0
TAKHT-E-NASRATI,KARAK,TEHSIL,OTHERS,9,5,4,0,9,5,4,0,0,0,0,0
TAKHT-E-NASRATI,KARAK,TEHSIL,PARSI,0,0,0,0,0,0,0,0,0,0,0,0
TAKHT-E-NASRATI,KARAK,TEHSIL,SCHEDULED CASTE,2,1,1,0,2,1,1,0,0,0,0,0
TAKHT-E-NASRATI,KARAK,TEHSIL,SIKH,1,1,0,0,1,1,0,0,0,0,0,0
TALL,HANGU,TEHSIL,QADIANI/AHMADI,14,6,8,0,14,6,8,0,0,0,0,0
TALL,HANGU,TEHSIL,CHRISTIAN,1267,712,555,0,1021,591,430,0,246,121,125,0
TALL,HANGU,TEHSIL,HINDU JATI,37,22,15,0,37,22,15,0,0,0,0,0
TALL,HANGU,TEHSIL,MUSLIM,243490,123704,119780,6,203866,104311,99552,3,39624,19393,20228,3
TALL,HANGU,TEHSIL,OTHERS,6,3,3,0,6,3,3,0,0,0,0,0
TALL,HANGU,TEHSIL,PARSI,0,0,0,0,0,0,0,0,0,0,0,0
TALL,HANGU,TEHSIL,SCHEDULED CASTE,12,6,6,0,12,6,6,0,0,0,0,0
TALL,HANGU,TEHSIL,SIKH,94,48,46,0,9,6,3,0,85,42,43,0
TANGI,CHARSADDA,TEHSIL,QADIANI/AHMADI,1,0,1,0,1,0,1,0,0,0,0,0
TANGI,CHARSADDA,TEHSIL,CHRISTIAN,1254,685,569,0,1087,598,489,0,167,87,80,0
TANGI,CHARSADDA,TEHSIL,HINDU JATI,2,1,1,0,2,1,1,0,0,0,0,0
TANGI,CHARSADDA,TEHSIL,MUSLIM,484261,234358,249899,4,448769,217117,231648,4,35492,17241,18251,0
TANGI,CHARSADDA,TEHSIL,OTHERS,6,1,5,0,6,1,5,0,0,0,0,0
TANGI,CHARSADDA,TEHSIL,PARSI,0,0,0,0,0,0,0,0,0,0,0,0
TANGI,CHARSADDA,TEHSIL,SCHEDULED CASTE,3,1,2,0,3,1,2,0,0,0,0,0
TANGI,CHARSADDA,TEHSIL,SIKH,5,1,4,0,5,1,4,0,0,0,0,0
TANK,TANK,DISTRICT,QADIANI/AHMADI,3,0,3,0,3,0,3,0,0,0,0,0
TANK,TANK,DISTRICT,CHRISTIAN,1164,598,566,0,841,439,402,0,323,159,164,0
TANK,TANK,DISTRICT,HINDU JATI,1,1,0,0,1,1,0,0,0,0,0,0
TANK,TANK,DISTRICT,MUSLIM,469033,228063,240969,1,420235,205121,215113,1,48798,22942,25856,0
TANK,TANK,DISTRICT,OTHERS,85,38,47,0,34,15,19,0,51,23,28,0
TANK,TANK,DISTRICT,PARSI,0,0,0,0,0,0,0,0,0,0,0,0
TANK,TANK,DISTRICT,SCHEDULED CASTE,1,0,1,0,1,0,1,0,0,0,0,0
TANK,TANK,DISTRICT,SIKH,6,3,3,0,6,3,3,0,0,0,0,0
TANK,TANK,TEHSIL,QADIANI/AHMADI,2,0,2,0,2,0,2,0,0,0,0,0
TANK,TANK,TEHSIL,CHRISTIAN,1114,582,532,0,791,423,368,0,323,159,164,0
TANK,TANK,TEHSIL,HINDU JATI,1,1,0,0,1,1,0,0,0,0,0,0
TANK,TANK,TEHSIL,MUSLIM,424291,206223,218067,1,375493,183281,192211,1,48798,22942,25856,0
TANK,TANK,TEHSIL,OTHERS,84,38,46,0,33,15,18,0,51,23,28,0
TANK,TANK,TEHSIL,PARSI,0,0,0,0,0,0,0,0,0,0,0,0
TANK,TANK,TEHSIL,SCHEDULED CASTE,1,0,1,0,1,0,1,0,0,0,0,0
TANK,TANK,TEHSIL,SIKH,6,3,3,0,6,3,3,0,0,0,0,0
TEMERGARA,LOWER DIR,SUB-DIVISION,QADIANI/AHMADI,9,2,7,0,9,2,7,0,0,0,0,0
TEMERGARA,LOWER DIR,SUB-DIVISION,CHRISTIAN,1769,946,823,0,1405,774,631,0,364,172,192,0
TEMERGARA,LOWER DIR,SUB-DIVISION,HINDU JATI,36,15,21,0,2,1,1,0,34,14,20,0
TEMERGARA,LOWER DIR,SUB-DIVISION,MUSLIM,594269,303086,291174,9,546809,279832,266969,8,47460,23254,24205,1
TEMERGARA,LOWER DIR,SUB-DIVISION,OTHERS,26,17,9,0,24,17,7,0,2,0,2,0
TEMERGARA,LOWER DIR,SUB-DIVISION,PARSI,0,0,0,0,0,0,0,0,0,0,0,0
TEMERGARA,LOWER DIR,SUB-DIVISION,SCHEDULED CASTE,11,6,5,0,11,6,5,0,0,0,0,0
TEMERGARA,LOWER DIR,SUB-DIVISION,SIKH,7,1,6,0,7,1,6,0,0,0,0,0
TIARZA,SOUTH WAZIRISTAN,TEHSIL,QADIANI/AHMADI,0,0,0,0,0,0,0,0,0,0,0,0
TIARZA,SOUTH WAZIRISTAN,TEHSIL,CHRISTIAN,123,63,60,0,123,63,60,0,0,0,0,0
TIARZA,SOUTH WAZIRISTAN,TEHSIL,HINDU JATI,1,0,1,0,1,0,1,0,0,0,0,0
TIARZA,SOUTH WAZIRISTAN,TEHSIL,MUSLIM,65666,30834,34832,0,65666,30834,34832,0,0,0,0,0
TIARZA,SOUTH WAZIRISTAN,TEHSIL,OTHERS,2,2,0,0,2,2,0,0,0,0,0,0
TIARZA,SOUTH WAZIRISTAN,TEHSIL,PARSI,0,0,0,0,0,0,0,0,0,0,0,0
TIARZA,SOUTH WAZIRISTAN,TEHSIL,SCHEDULED CASTE,2,1,1,0,2,1,1,0,0,0,0,0
TIARZA,SOUTH WAZIRISTAN,TEHSIL,SIKH,4,2,2,0,4,2,2,0,0,0,0,0
TOI KHULLA,SOUTH WAZIRISTAN,TEHSIL,QADIANI/AHMADI,0,0,0,0,0,0,0,0,0,0,0,0
TOI KHULLA,SOUTH WAZIRISTAN,TEHSIL,CHRISTIAN,130,66,64,0,130,66,64,0,0,0,0,0
TOI KHULLA,SOUTH WAZIRISTAN,TEHSIL,HINDU JATI,0,0,0,0,0,0,0,0,0,0,0,0
TOI KHULLA,SOUTH WAZIRISTAN,TEHSIL,MUSLIM,102696,49056,53638,2,102696,49056,53638,2,0,0,0,0
TOI KHULLA,SOUTH WAZIRISTAN,TEHSIL,OTHERS,1,1,0,0,1,1,0,0,0,0,0,0
TOI KHULLA,SOUTH WAZIRISTAN,TEHSIL,PARSI,0,0,0,0,0,0,0,0,0,0,0,0
TOI KHULLA,SOUTH WAZIRISTAN,TEHSIL,SCHEDULED CASTE,3,0,3,0,3,0,3,0,0,0,0,0
TOI KHULLA,SOUTH WAZIRISTAN,TEHSIL,SIKH,5,4,1,0,5,4,1,0,0,0,0,0
TOPI,SWABI,TEHSIL,QADIANI/AHMADI,11,6,5,0,2,2,0,0,9,4,5,0
TOPI,SWABI,TEHSIL,CHRISTIAN,943,511,432,0,701,381,320,0,242,130,112,0
TOPI,SWABI,TEHSIL,HINDU JATI,27,13,14,0,7,3,4,0,20,10,10,0
TOPI,SWABI,TEHSIL,MUSLIM,379491,187452,192036,3,305101,151490,153608,3,74390,35962,38428,0
TOPI,SWABI,TEHSIL,OTHERS,12,7,5,0,5,2,3,0,7,5,2,0
TOPI,SWABI,TEHSIL,PARSI,0,0,0,0,0,0,0,0,0,0,0,0
TOPI,SWABI,TEHSIL,SCHEDULED CASTE,3,2,1,0,3,2,1,0,0,0,0,0
TOPI,SWABI,TEHSIL,SIKH,41,18,23,0,3,1,2,0,38,17,21,0
TORGHAR,TORGHAR,DISTRICT,QADIANI/AHMADI,1,1,0,0,1,1,0,0,0,0,0,0
TORGHAR,TORGHAR,DISTRICT,CHRISTIAN,280,154,126,0,280,154,126,0,0,0,0,0
TORGHAR,TORGHAR,DISTRICT,HINDU JATI,1,1,0,0,1,1,0,0,0,0,0,0
TORGHAR,TORGHAR,DISTRICT,MUSLIM,200158,98123,102031,4,200158,98123,102031,4,0,0,0,0
TORGHAR,TORGHAR,DISTRICT,OTHERS,2,1,1,0,2,1,1,0,0,0,0,0
TORGHAR,TORGHAR,DISTRICT,PARSI,0,0,0,0,0,0,0,0,0,0,0,0
TORGHAR,TORGHAR,DISTRICT,SCHEDULED CASTE,1,1,0,0,1,1,0,0,0,0,0,0
TORGHAR,TORGHAR,DISTRICT,SIKH,2,0,2,0,2,0,2,0,0,0,0,0
UPPER,ORAKZAI,TEHSIL,QADIANI/AHMADI,1,0,1,0,1,0,1,0,0,0,0,0
UPPER,ORAKZAI,TEHSIL,CHRISTIAN,215,103,112,0,215,103,112,0,0,0,0,0
UPPER,ORAKZAI,TEHSIL,HINDU JATI,2,1,1,0,2,1,1,0,0,0,0,0
UPPER,ORAKZAI,TEHSIL,MUSLIM,129245,59151,70090,4,129245,59151,70090,4,0,0,0,0
UPPER,ORAKZAI,TEHSIL,OTHERS,0,0,0,0,0,0,0,0,0,0,0,0
UPPER,ORAKZAI,TEHSIL,PARSI,0,0,0,0,0,0,0,0,0,0,0,0
UPPER,ORAKZAI,TEHSIL,SCHEDULED CASTE,3,2,1,0,3,2,1,0,0,0,0,0
UPPER,ORAKZAI,TEHSIL,SIKH,4,3,1,0,4,3,1,0,0,0,0,0
UPPER CHITRAL,UPPER CHITRAL,DISTRICT,QADIANI/AHMADI,2,1,1,0,2,1,1,0,0,0,0,0
UPPER CHITRAL,UPPER CHITRAL,DISTRICT,CHRISTIAN,425,232,193,0,425,232,193,0,0,0,0,0
UPPER CHITRAL,UPPER CHITRAL,DISTRICT,HINDU JATI,1,1,0,0,1,1,0,0,0,0,0,0
UPPER CHITRAL,UPPER CHITRAL,DISTRICT,MUSLIM,194379,94409,99970,0,194379,94409,99970,0,0,0,0,0
UPPER CHITRAL,UPPER CHITRAL,DISTRICT,OTHERS,353,198,155,0,353,198,155,0,0,0,0,0
UPPER CHITRAL,UPPER CHITRAL,DISTRICT,PARSI,1,1,0,0,1,1,0,0,0,0,0,0
UPPER CHITRAL,UPPER CHITRAL,DISTRICT,SCHEDULED CASTE,0,0,0,0,0,0,0,0,0,0,0,0
UPPER CHITRAL,UPPER CHITRAL,DISTRICT,SIKH,0,0,0,0,0,0,0,0,0,0,0,0
UPPER DIR,UPPER DIR,DISTRICT,QADIANI/AHMADI,29,13,16,0,29,13,16,0,0,0,0,0
UPPER DIR,UPPER DIR,DISTRICT,CHRISTIAN,2258,1226,1032,0,2200,1195,1005,0,58,31,27,0
UPPER DIR,UPPER DIR,DISTRICT,HINDU JATI,18,11,7,0,16,10,6,0,2,1,1,0
UPPER DIR,UPPER DIR,DISTRICT,MUSLIM,1080001,544364,535625,12,1033226,521385,511830,11,46775,22979,23795,1
UPPER DIR,UPPER DIR,DISTRICT,OTHERS,78,37,41,0,75,37,38,0,3,0,3,0
UPPER DIR,UPPER DIR,DISTRICT,PARSI,0,0,0,0,0,0,0,0,0,0,0,0
UPPER DIR,UPPER DIR,DISTRICT,SCHEDULED CASTE,24,13,11,0,24,13,11,0,0,0,0,0
UPPER DIR,UPPER DIR,DISTRICT,SIKH,8,1,7,0,8,1,7,0,0,0,0,0
UPPER KOHISTAN,UPPER KOHISTAN,DISTRICT,QADIANI/AHMADI,2,0,2,0,2,0,2,0,0,0,0,0
UPPER KOHISTAN,UPPER KOHISTAN,DISTRICT,CHRISTIAN,661,333,328,0,661,333,328,0,0,0,0,0
UPPER KOHISTAN,UPPER KOHISTAN,DISTRICT,HINDU JATI,16,8,8,0,16,8,8,0,0,0,0,0
UPPER KOHISTAN,UPPER KOHISTAN,DISTRICT,MUSLIM,373408,181027,192377,4,373408,181027,192377,4,0,0,0,0
UPPER KOHISTAN,UPPER KOHISTAN,DISTRICT,OTHERS,86,33,53,0,86,33,53,0,0,0,0,0
UPPER KOHISTAN,UPPER KOHISTAN,DISTRICT,PARSI,2,0,2,0,2,0,2,0,0,0,0,0
UPPER KOHISTAN,UPPER KOHISTAN,DISTRICT,SCHEDULED CASTE,4,1,3,0,4,1,3,0,0,0,0,0
UPPER KOHISTAN,UPPER KOHISTAN,DISTRICT,SIKH,4,1,3,0,4,1,3,0,0,0,0,0
UPPER KURRAM,KURRAM,TEHSIL,QADIANI/AHMADI,3,0,3,0,3,0,3,0,0,0,0,0
UPPER KURRAM,KURRAM,TEHSIL,CHRISTIAN,1278,650,628,0,1093,560,533,0,185,90,95,0
UPPER KURRAM,KURRAM,TEHSIL,HINDU JATI,26,14,12,0,17,7,10,0,9,7,2,0
UPPER KURRAM,KURRAM,TEHSIL,MUSLIM,274466,136387,138076,3,269077,133875,135199,3,5389,2512,2877,0
UPPER KURRAM,KURRAM,TEHSIL,OTHERS,22,15,7,0,22,15,7,0,0,0,0,0
UPPER KURRAM,KURRAM,TEHSIL,PARSI,0,0,0,0,0,0,0,0,0,0,0,0
UPPER KURRAM,KURRAM,TEHSIL,SCHEDULED CASTE,13,6,7,0,13,6,7,0,0,0,0,0
UPPER KURRAM,KURRAM,TEHSIL,SIKH,11,7,4,0,11,7,4,0,0,0,0,0
UPPER MOHMAND,MOHMAND,TEHSIL,QADIANI/AHMADI,0,0,0,0,0,0,0,0,0,0,0,0
UPPER MOHMAND,MOHMAND,TEHSIL,CHRISTIAN,112,69,43,0,112,69,43,0,0,0,0,0
UPPER MOHMAND,MOHMAND,TEHSIL,HINDU JATI,0,0,0,0,0,0,0,0,0,0,0,0
UPPER MOHMAND,MOHMAND,TEHSIL,MUSLIM,63542,31684,31858,0,63542,31684,31858,0,0,0,0,0
UPPER MOHMAND,MOHMAND,TEHSIL,OTHERS,0,0,0,0,0,0,0,0,0,0,0,0
UPPER MOHMAND,MOHMAND,TEHSIL,PARSI,0,0,0,0,0,0,0,0,0,0,0,0
UPPER MOHMAND,MOHMAND,TEHSIL,SCHEDULED CASTE,0,0,0,0,0,0,0,0,0,0,0,0
UPPER MOHMAND,MOHMAND,TEHSIL,SIKH,5,0,5,0,5,0,5,0,0,0,0,0
UTMAN KHEL,BAJAUR,TEHSIL,QADIANI/AHMADI,2,1,1,0,2,1,1,0,0,0,0,0
UTMAN KHEL,BAJAUR,TEHSIL,CHRISTIAN,216,122,94,0,216,122,94,0,0,0,0,0
UTMAN KHEL,BAJAUR,TEHSIL,HINDU JATI,0,0,0,0,0,0,0,0,0,0,0,0
UTMAN KHEL,BAJAUR,TEHSIL,MUSLIM,123365,61462,61902,1,123365,61462,61902,1,0,0,0,0
UTMAN KHEL,BAJAUR,TEHSIL,OTHERS,2,1,1,0,2,1,1,0,0,0,0,0
UTMAN KHEL,BAJAUR,TEHSIL,PARSI,0,0,0,0,0,0,0,0,0,0,0,0
UTMAN KHEL,BAJAUR,TEHSIL,SCHEDULED CASTE,1,1,0,0,1,1,0,0,0,0,0,0
UTMAN KHEL,BAJAUR,TEHSIL,SIKH,1,1,0,0,1,1,0,0,0,0,0,0
WANA,SOUTH WAZIRISTAN,TEHSIL,QADIANI/AHMADI,1,0,1,0,1,0,1,0,0,0,0,0
WANA,SOUTH WAZIRISTAN,TEHSIL,CHRISTIAN,458,248,210,0,458,248,210,0,0,0,0,0
WANA,SOUTH WAZIRISTAN,TEHSIL,HINDU JATI,1,1,0,0,1,1,0,0,0,0,0,0
WANA,SOUTH WAZIRISTAN,TEHSIL,MUSLIM,184164,91716,92445,3,184164,91716,92445,3,0,0,0,0
WANA,SOUTH WAZIRISTAN,TEHSIL,OTHERS,16,8,8,0,16,8,8,0,0,0,0,0
WANA,SOUTH WAZIRISTAN,TEHSIL,PARSI,0,0,0,0,0,0,0,0,0,0,0,0
WANA,SOUTH WAZIRISTAN,TEHSIL,SCHEDULED CASTE,3,1,2,0,3,1,2,0,0,0,0,0
WANA,SOUTH WAZIRISTAN,TEHSIL,SIKH,2,0,2,0,2,0,2,0,0,0,0,0
WARI,UPPER DIR,SUB-DIVISION,QADIANI/AHMADI,19,8,11,0,19,8,11,0,0,0,0,0
WARI,UPPER DIR,SUB-DIVISION,CHRISTIAN,1177,647,530,0,1177,647,530,0,0,0,0,0
WARI,UPPER DIR,SUB-DIVISION,HINDU JATI,14,8,6,0,14,8,6,0,0,0,0,0
WARI,UPPER DIR,SUB-DIVISION,MUSLIM,367893,188042,179847,4,367893,188042,179847,4,0,0,0,0
WARI,UPPER DIR,SUB-DIVISION,OTHERS,5,0,5,0,5,0,5,0,0,0,0,0
WARI,UPPER DIR,SUB-DIVISION,PARSI,0,0,0,0,0,0,0,0,0,0,0,0
WARI,UPPER DIR,SUB-DIVISION,SCHEDULED CASTE,11,7,4,0,11,7,4,0,0,0,0,0
WARI,UPPER DIR,SUB-DIVISION,SIKH,4,0,4,0,4,0,4,0,0,0,0,0
WAZIR,BANNU,SUB-DIVISION,QADIANI/AHMADI,0,0,0,0,0,0,0,0,0,0,0,0
WAZIR,BANNU,SUB-DIVISION,CHRISTIAN,145,72,73,0,145,72,73,0,0,0,0,0
WAZIR,BANNU,SUB-DIVISION,HINDU JATI,0,0,0,0,0,0,0,0,0,0,0,0
WAZIR,BANNU,SUB-DIVISION,MUSLIM,37111,17788,19323,0,37111,17788,19323,0,0,0,0,0
WAZIR,BANNU,SUB-DIVISION,OTHERS,4,2,2,0,4,2,2,0,0,0,0,0
WAZIR,BANNU,SUB-DIVISION,PARSI,0,0,0,0,0,0,0,0,0,0,0,0
WAZIR,BANNU,SUB-DIVISION,SCHEDULED CASTE,2,2,0,0,2,2,0,0,0,0,0,0
WAZIR,BANNU,SUB-DIVISION,SIKH,0,0,0,0,0,0,0,0,0,0,0,0
YAKE GHUND,MOHMAND,TEHSIL,QADIANI/AHMADI,2,2,0,0,2,2,0,0,0,0,0,0
YAKE GHUND,MOHMAND,TEHSIL,CHRISTIAN,74,29,45,0,74,29,45,0,0,0,0,0
YAKE GHUND,MOHMAND,TEHSIL,HINDU JATI,0,0,0,0,0,0,0,0,0,0,0,0
YAKE GHUND,MOHMAND,TEHSIL,MUSLIM,63673,31462,32211,0,63673,31462,32211,0,0,0,0,0
YAKE GHUND,MOHMAND,TEHSIL,OTHERS,3,1,2,0,3,1,2,0,0,0,0,0
YAKE GHUND,MOHMAND,TEHSIL,PARSI,0,0,0,0,0,0,0,0,0,0,0,0
YAKE GHUND,MOHMAND,TEHSIL,SCHEDULED CASTE,0,0,0,0,0,0,0,0,0,0,0,0
YAKE GHUND,MOHMAND,TEHSIL,SIKH,5,0,5,0,5,0,5,0,0,0,0,0
