name_admin_unit,admin_unit,age_group,marital_status,all_sexes_overall,female_overall,male_overall,tgend_overall,all_sexes_rural,female_rural,male_rural,tgend_rural,all_sexes_urban,female_urban,male_urban,tgend_urban
AWARAN,DISTRICT,15 &  ABOVE,DIVORCED,131,77,54,0,91,52,39,0,40,25,15,0
AWARAN,DISTRICT,15 &  ABOVE,MARRIED,62026,31200,30826,0,46721,23524,23197,0,15305,7676,7629,0
AWARAN,DISTRICT,15 &  ABOVE,NEVER MARRIED,26602,11270,15317,15,18144,7655,10477,12,8458,3615,4840,3
AWARAN,DISTRICT,15 &  ABOVE,SEPERATION,42,22,20,0,33,17,16,0,9,5,4,0
AWARAN,DISTRICT,15 &  ABOVE,WIDOWED,1838,1478,360,0,1258,1006,252,0,580,472,108,0
AWARAN,DISTRICT,15 - 19,DIVORCED,9,5,4,0,5,4,1,0,4,1,3,0
AWARAN,DISTRICT,15 - 19,MARRIED,2738,1832,906,0,2176,1449,727,0,562,383,179,0
AWARAN,DISTRICT,15 - 19,NEVER MARRIED,15083,6707,8372,4,10683,4767,5914,2,4400,1940,2458,2
AWARAN,DISTRICT,15 - 19,SEPERATION,2,1,1,0,1,0,1,0,1,1,0,0
AWARAN,DISTRICT,15 - 19,WIDOWED,14,6,8,0,8,3,5,0,6,3,3,0
AWARAN,DISTRICT,20 - 24,DIVORCED,18,15,3,0,11,10,1,0,7,5,2,0
AWARAN,DISTRICT,20 - 24,MARRIED,7132,4373,2759,0,5543,3412,2131,0,1589,961,628,0
AWARAN,DISTRICT,20 - 24,NEVER MARRIED,6325,2286,4038,1,4196,1499,2697,0,2129,787,1341,1
AWARAN,DISTRICT,20 - 24,SEPERATION,4,1,3,0,2,1,1,0,2,0,2,0
AWARAN,DISTRICT,20 - 24,WIDOWED,37,30,7,0,24,18,6,0,13,12,1,0
AWARAN,DISTRICT,25 - 29,DIVORCED,23,12,11,0,16,9,7,0,7,3,4,0
AWARAN,DISTRICT,25 - 29,MARRIED,9278,4649,4629,0,7075,3492,3583,0,2203,1157,1046,0
AWARAN,DISTRICT,25 - 29,NEVER MARRIED,2855,1287,1563,5,1797,788,1004,5,1058,499,559,0
AWARAN,DISTRICT,25 - 29,SEPERATION,5,3,2,0,4,2,2,0,1,1,0,0
AWARAN,DISTRICT,25 - 29,WIDOWED,46,29,17,0,36,22,14,0,10,7,3,0
AWARAN,DISTRICT,30 - 34,DIVORCED,26,13,13,0,18,7,11,0,8,6,2,0
AWARAN,DISTRICT,30 - 34,MARRIED,8276,4347,3929,0,6076,3219,2857,0,2200,1128,1072,0
AWARAN,DISTRICT,30 - 34,NEVER MARRIED,1157,506,647,4,706,303,399,4,451,203,248,0
AWARAN,DISTRICT,30 - 34,SEPERATION,3,1,2,0,2,1,1,0,1,0,1,0
AWARAN,DISTRICT,30 - 34,WIDOWED,82,57,25,0,62,43,19,0,20,14,6,0
AWARAN,DISTRICT,35 - 39,DIVORCED,13,6,7,0,9,5,4,0,4,1,3,0
AWARAN,DISTRICT,35 - 39,MARRIED,9062,4554,4508,0,6797,3408,3389,0,2265,1146,1119,0
AWARAN,DISTRICT,35 - 39,NEVER MARRIED,619,272,347,0,401,164,237,0,218,108,110,0
AWARAN,DISTRICT,35 - 39,SEPERATION,4,1,3,0,3,0,3,0,1,1,0,0
AWARAN,DISTRICT,35 - 39,WIDOWED,112,91,21,0,72,56,16,0,40,35,5,0
AWARAN,DISTRICT,40 - 44,DIVORCED,12,7,5,0,9,5,4,0,3,2,1,0
AWARAN,DISTRICT,40 - 44,MARRIED,7368,3681,3687,0,5395,2690,2705,0,1973,991,982,0
AWARAN,DISTRICT,40 - 44,NEVER MARRIED,289,93,195,1,180,55,124,1,109,38,71,0
AWARAN,DISTRICT,40 - 44,SEPERATION,6,4,2,0,4,2,2,0,2,2,0,0
AWARAN,DISTRICT,40 - 44,WIDOWED,121,97,24,0,81,65,16,0,40,32,8,0
AWARAN,DISTRICT,45 - 49,DIVORCED,5,4,1,0,4,3,1,0,1,1,0,0
AWARAN,DISTRICT,45 - 49,MARRIED,4960,2291,2669,0,3759,1756,2003,0,1201,535,666,0
AWARAN,DISTRICT,45 - 49,NEVER MARRIED,107,48,59,0,71,30,41,0,36,18,18,0
AWARAN,DISTRICT,45 - 49,SEPERATION,3,0,3,0,3,0,3,0,0,0,0,0
AWARAN,DISTRICT,45 - 49,WIDOWED,130,107,23,0,95,76,19,0,35,31,4,0
AWARAN,DISTRICT,50 - 54,DIVORCED,4,3,1,0,1,0,1,0,3,3,0,0
AWARAN,DISTRICT,50 - 54,MARRIED,4349,2007,2342,0,3302,1508,1794,0,1047,499,548,0
AWARAN,DISTRICT,50 - 54,NEVER MARRIED,74,30,44,0,45,19,26,0,29,11,18,0
AWARAN,DISTRICT,50 - 54,SEPERATION,5,3,2,0,4,3,1,0,1,0,1,0
AWARAN,DISTRICT,50 - 54,WIDOWED,198,172,26,0,146,129,17,0,52,43,9,0
AWARAN,DISTRICT,55 - 59,DIVORCED,11,5,6,0,9,3,6,0,2,2,0,0
AWARAN,DISTRICT,55 - 59,MARRIED,3025,1299,1726,0,2252,966,1286,0,773,333,440,0
AWARAN,DISTRICT,55 - 59,NEVER MARRIED,38,21,17,0,31,17,14,0,7,4,3,0
AWARAN,DISTRICT,55 - 59,SEPERATION,1,1,0,0,1,1,0,0,0,0,0,0
AWARAN,DISTRICT,55 - 59,WIDOWED,190,161,29,0,139,118,21,0,51,43,8,0
AWARAN,DISTRICT,60 - 64,DIVORCED,2,1,1,0,2,1,1,0,0,0,0,0
AWARAN,DISTRICT,60 - 64,MARRIED,2295,868,1427,0,1745,658,1087,0,550,210,340,0
AWARAN,DISTRICT,60 - 64,NEVER MARRIED,27,10,17,0,17,7,10,0,10,3,7,0
AWARAN,DISTRICT,60 - 64,SEPERATION,5,3,2,0,5,3,2,0,0,0,0,0
AWARAN,DISTRICT,60 - 64,WIDOWED,171,143,28,0,122,101,21,0,49,42,7,0
AWARAN,DISTRICT,65 - 69,DIVORCED,5,4,1,0,4,3,1,0,1,1,0,0
AWARAN,DISTRICT,65 - 69,MARRIED,1559,619,940,0,1151,464,687,0,408,155,253,0
AWARAN,DISTRICT,65 - 69,NEVER MARRIED,13,2,11,0,9,2,7,0,4,0,4,0
AWARAN,DISTRICT,65 - 69,SEPERATION,1,1,0,0,1,1,0,0,0,0,0,0
AWARAN,DISTRICT,65 - 69,WIDOWED,192,166,26,0,123,106,17,0,69,60,9,0
AWARAN,DISTRICT,70 - 74,DIVORCED,0,0,0,0,0,0,0,0,0,0,0,0
AWARAN,DISTRICT,70 - 74,MARRIED,1058,399,659,0,779,293,486,0,279,106,173,0
AWARAN,DISTRICT,70 - 74,NEVER MARRIED,9,5,4,0,4,2,2,0,5,3,2,0
AWARAN,DISTRICT,70 - 74,SEPERATION,2,2,0,0,2,2,0,0,0,0,0,0
AWARAN,DISTRICT,70 - 74,WIDOWED,258,199,59,0,169,133,36,0,89,66,23,0
AWARAN,DISTRICT,75 & ABOVE,DIVORCED,3,2,1,0,3,2,1,0,0,0,0,0
AWARAN,DISTRICT,75 & ABOVE,MARRIED,926,281,645,0,671,209,462,0,255,72,183,0
AWARAN,DISTRICT,75 & ABOVE,NEVER MARRIED,6,3,3,0,4,2,2,0,2,1,1,0
AWARAN,DISTRICT,75 & ABOVE,SEPERATION,1,1,0,0,1,1,0,0,0,0,0,0
AWARAN,DISTRICT,75 & ABOVE,WIDOWED,287,220,67,0,181,136,45,0,106,84,22,0
BALOCHISTAN,PROVINCE,15 &  ABOVE,DIVORCED,7755,4934,2821,0,5284,3342,1942,0,2471,1592,879,0
BALOCHISTAN,PROVINCE,15 &  ABOVE,MARRIED,4988160,2501307,2486853,0,3496967,1761199,1735768,0,1491193,740108,751085,0
BALOCHISTAN,PROVINCE,15 &  ABOVE,NEVER MARRIED,2181322,916026,1264623,673,1391808,575199,816223,386,789514,340827,448400,287
BALOCHISTAN,PROVINCE,15 &  ABOVE,SEPERATION,6024,2712,3312,0,4620,2088,2532,0,1404,624,780,0
BALOCHISTAN,PROVINCE,15 &  ABOVE,WIDOWED,147619,114527,33092,0,97762,74952,22810,0,49857,39575,10282,0
BALOCHISTAN,PROVINCE,15 - 19,DIVORCED,320,161,159,0,236,117,119,0,84,44,40,0
BALOCHISTAN,PROVINCE,15 - 19,MARRIED,326446,200525,125921,0,253191,154524,98667,0,73255,46001,27254,0
BALOCHISTAN,PROVINCE,15 - 19,NEVER MARRIED,1284958,557671,727020,267,862235,368448,493635,152,422723,189223,233385,115
BALOCHISTAN,PROVINCE,15 - 19,SEPERATION,564,160,404,0,431,112,319,0,133,48,85,0
BALOCHISTAN,PROVINCE,15 - 19,WIDOWED,854,309,545,0,663,233,430,0,191,76,115,0
BALOCHISTAN,PROVINCE,20 - 24,DIVORCED,770,512,258,0,548,367,181,0,222,145,77,0
BALOCHISTAN,PROVINCE,20 - 24,MARRIED,682308,398772,283536,0,501978,290277,211701,0,180330,108495,71835,0
BALOCHISTAN,PROVINCE,20 - 24,NEVER MARRIED,529993,210784,319085,124,322903,125800,197038,65,207090,84984,122047,59
BALOCHISTAN,PROVINCE,20 - 24,SEPERATION,588,230,358,0,436,168,268,0,152,62,90,0
BALOCHISTAN,PROVINCE,20 - 24,WIDOWED,1985,1082,903,0,1500,785,715,0,485,297,188,0
BALOCHISTAN,PROVINCE,25 - 29,DIVORCED,1062,684,378,0,703,460,243,0,359,224,135,0
BALOCHISTAN,PROVINCE,25 - 29,MARRIED,755463,397746,357717,0,530951,277412,253539,0,224512,120334,104178,0
BALOCHISTAN,PROVINCE,25 - 29,NEVER MARRIED,204987,81563,123348,76,117023,45471,71503,49,87964,36092,51845,27
BALOCHISTAN,PROVINCE,25 - 29,SEPERATION,656,257,399,0,511,200,311,0,145,57,88,0
BALOCHISTAN,PROVINCE,25 - 29,WIDOWED,3379,2107,1272,0,2480,1524,956,0,899,583,316,0
BALOCHISTAN,PROVINCE,30 - 34,DIVORCED,1203,802,401,0,794,527,267,0,409,275,134,0
BALOCHISTAN,PROVINCE,30 - 34,MARRIED,694373,359580,334793,0,479080,249237,229843,0,215293,110343,104950,0
BALOCHISTAN,PROVINCE,30 - 34,NEVER MARRIED,82408,37769,44589,50,46106,20321,25752,33,36302,17448,18837,17
BALOCHISTAN,PROVINCE,30 - 34,SEPERATION,738,309,429,0,564,230,334,0,174,79,95,0
BALOCHISTAN,PROVINCE,30 - 34,WIDOWED,4925,3416,1509,0,3525,2435,1090,0,1400,981,419,0
BALOCHISTAN,PROVINCE,35 - 39,DIVORCED,1141,761,380,0,753,497,256,0,388,264,124,0
BALOCHISTAN,PROVINCE,35 - 39,MARRIED,637881,314596,323285,0,437503,216631,220872,0,200378,97965,102413,0
BALOCHISTAN,PROVINCE,35 - 39,NEVER MARRIED,38143,13827,24275,41,21312,7555,13740,17,16831,6272,10535,24
BALOCHISTAN,PROVINCE,35 - 39,SEPERATION,758,352,406,0,592,282,310,0,166,70,96,0
BALOCHISTAN,PROVINCE,35 - 39,WIDOWED,7229,5337,1892,0,5130,3751,1379,0,2099,1586,513,0
BALOCHISTAN,PROVINCE,40 - 44,DIVORCED,999,684,315,0,660,452,208,0,339,232,107,0
BALOCHISTAN,PROVINCE,40 - 44,MARRIED,551723,261701,290022,0,377487,180040,197447,0,174236,81661,92575,0
BALOCHISTAN,PROVINCE,40 - 44,NEVER MARRIED,17895,6651,11220,24,9948,3549,6389,10,7947,3102,4831,14
BALOCHISTAN,PROVINCE,40 - 44,SEPERATION,593,299,294,0,463,241,222,0,130,58,72,0
BALOCHISTAN,PROVINCE,40 - 44,WIDOWED,10399,8124,2275,0,7196,5576,1620,0,3203,2548,655,0
BALOCHISTAN,PROVINCE,45 - 49,DIVORCED,723,460,263,0,487,297,190,0,236,163,73,0
BALOCHISTAN,PROVINCE,45 - 49,MARRIED,389254,177406,211848,0,263035,121284,141751,0,126219,56122,70097,0
BALOCHISTAN,PROVINCE,45 - 49,NEVER MARRIED,9286,3247,6021,18,5068,1700,3354,14,4218,1547,2667,4
BALOCHISTAN,PROVINCE,45 - 49,SEPERATION,526,295,231,0,396,231,165,0,130,64,66,0
BALOCHISTAN,PROVINCE,45 - 49,WIDOWED,11581,9280,2301,0,7627,6052,1575,0,3954,3228,726,0
BALOCHISTAN,PROVINCE,50 - 54,DIVORCED,497,324,173,0,331,218,113,0,166,106,60,0
BALOCHISTAN,PROVINCE,50 - 54,MARRIED,310535,142273,168262,0,212058,98258,113800,0,98477,44015,54462,0
BALOCHISTAN,PROVINCE,50 - 54,NEVER MARRIED,5187,1835,3328,24,2665,926,1725,14,2522,909,1603,10
BALOCHISTAN,PROVINCE,50 - 54,SEPERATION,452,250,202,0,340,191,149,0,112,59,53,0
BALOCHISTAN,PROVINCE,50 - 54,WIDOWED,16342,13439,2903,0,10581,8610,1971,0,5761,4829,932,0
BALOCHISTAN,PROVINCE,55 - 59,DIVORCED,369,210,159,0,253,140,113,0,116,70,46,0
BALOCHISTAN,PROVINCE,55 - 59,MARRIED,225199,94996,130203,0,152178,65093,87085,0,73021,29903,43118,0
BALOCHISTAN,PROVINCE,55 - 59,NEVER MARRIED,3425,1145,2263,17,1852,612,1230,10,1573,533,1033,7
BALOCHISTAN,PROVINCE,55 - 59,SEPERATION,316,165,151,0,226,114,112,0,90,51,39,0
BALOCHISTAN,PROVINCE,55 - 59,WIDOWED,16151,13079,3072,0,10072,8062,2010,0,6079,5017,1062,0
BALOCHISTAN,PROVINCE,60 - 64,DIVORCED,275,139,136,0,212,112,100,0,63,27,36,0
BALOCHISTAN,PROVINCE,60 - 64,MARRIED,166595,65624,100971,0,114543,45878,68665,0,52052,19746,32306,0
BALOCHISTAN,PROVINCE,60 - 64,NEVER MARRIED,2180,688,1482,10,1143,360,777,6,1037,328,705,4
BALOCHISTAN,PROVINCE,60 - 64,SEPERATION,267,150,117,0,203,118,85,0,64,32,32,0
BALOCHISTAN,PROVINCE,60 - 64,WIDOWED,19116,15515,3601,0,12258,9835,2423,0,6858,5680,1178,0
BALOCHISTAN,PROVINCE,65 - 69,DIVORCED,170,94,76,0,129,71,58,0,41,23,18,0
BALOCHISTAN,PROVINCE,65 - 69,MARRIED,107338,41170,66168,0,73943,28809,45134,0,33395,12361,21034,0
BALOCHISTAN,PROVINCE,65 - 69,NEVER MARRIED,1404,394,1000,10,739,211,520,8,665,183,480,2
BALOCHISTAN,PROVINCE,65 - 69,SEPERATION,179,94,85,0,133,72,61,0,46,22,24,0
BALOCHISTAN,PROVINCE,65 - 69,WIDOWED,16932,13516,3416,0,10642,8398,2244,0,6290,5118,1172,0
BALOCHISTAN,PROVINCE,70 - 74,DIVORCED,90,49,41,0,68,38,30,0,22,11,11,0
BALOCHISTAN,PROVINCE,70 - 74,MARRIED,73766,26045,47721,0,52405,18818,33587,0,21361,7227,14134,0
BALOCHISTAN,PROVINCE,70 - 74,NEVER MARRIED,657,231,423,3,365,120,243,2,292,111,180,1
BALOCHISTAN,PROVINCE,70 - 74,SEPERATION,147,75,72,0,128,69,59,0,19,6,13,0
BALOCHISTAN,PROVINCE,70 - 74,WIDOWED,17178,13532,3646,0,11363,8925,2438,0,5815,4607,1208,0
BALOCHISTAN,PROVINCE,75 & ABOVE,DIVORCED,136,54,82,0,110,46,64,0,26,8,18,0
BALOCHISTAN,PROVINCE,75 & ABOVE,MARRIED,67279,20873,46406,0,48615,14938,33677,0,18664,5935,12729,0
BALOCHISTAN,PROVINCE,75 & ABOVE,NEVER MARRIED,799,221,569,9,449,126,317,6,350,95,252,3
BALOCHISTAN,PROVINCE,75 & ABOVE,SEPERATION,240,76,164,0,197,60,137,0,43,16,27,0
BALOCHISTAN,PROVINCE,75 & ABOVE,WIDOWED,21548,15791,5757,0,14725,10766,3959,0,6823,5025,1798,0
BARKHAN,DISTRICT,15 &  ABOVE,DIVORCED,45,36,9,0,43,34,9,0,2,2,0,0
BARKHAN,DISTRICT,15 &  ABOVE,MARRIED,66158,33581,32577,0,61336,31131,30205,0,4822,2450,2372,0
BARKHAN,DISTRICT,15 &  ABOVE,NEVER MARRIED,26421,10390,16025,6,23874,9309,14560,5,2547,1081,1465,1
BARKHAN,DISTRICT,15 &  ABOVE,SEPERATION,49,26,23,0,49,26,23,0,0,0,0,0
BARKHAN,DISTRICT,15 &  ABOVE,WIDOWED,2673,2205,468,0,2387,1951,436,0,286,254,32,0
BARKHAN,DISTRICT,15 - 19,DIVORCED,1,1,0,0,1,1,0,0,0,0,0,0
BARKHAN,DISTRICT,15 - 19,MARRIED,2848,1641,1207,0,2728,1559,1169,0,120,82,38,0
BARKHAN,DISTRICT,15 - 19,NEVER MARRIED,15641,6679,8959,3,14248,6077,8168,3,1393,602,791,0
BARKHAN,DISTRICT,15 - 19,SEPERATION,3,0,3,0,3,0,3,0,0,0,0,0
BARKHAN,DISTRICT,15 - 19,WIDOWED,19,10,9,0,19,10,9,0,0,0,0,0
BARKHAN,DISTRICT,20 - 24,DIVORCED,3,1,2,0,3,1,2,0,0,0,0,0
BARKHAN,DISTRICT,20 - 24,MARRIED,8401,5028,3373,0,7834,4662,3172,0,567,366,201,0
BARKHAN,DISTRICT,20 - 24,NEVER MARRIED,6314,2197,4116,1,5702,1944,3757,1,612,253,359,0
BARKHAN,DISTRICT,20 - 24,SEPERATION,5,3,2,0,5,3,2,0,0,0,0,0
BARKHAN,DISTRICT,20 - 24,WIDOWED,27,14,13,0,25,14,11,0,2,0,2,0
BARKHAN,DISTRICT,25 - 29,DIVORCED,10,9,1,0,9,8,1,0,1,1,0,0
BARKHAN,DISTRICT,25 - 29,MARRIED,8771,4564,4207,0,8088,4215,3873,0,683,349,334,0
BARKHAN,DISTRICT,25 - 29,NEVER MARRIED,2521,889,1632,0,2217,758,1459,0,304,131,173,0
BARKHAN,DISTRICT,25 - 29,SEPERATION,4,2,2,0,4,2,2,0,0,0,0,0
BARKHAN,DISTRICT,25 - 29,WIDOWED,50,21,29,0,49,20,29,0,1,1,0,0
BARKHAN,DISTRICT,30 - 34,DIVORCED,2,2,0,0,2,2,0,0,0,0,0,0
BARKHAN,DISTRICT,30 - 34,MARRIED,9487,5147,4340,0,8756,4746,4010,0,731,401,330,0
BARKHAN,DISTRICT,30 - 34,NEVER MARRIED,1076,363,713,0,951,315,636,0,125,48,77,0
BARKHAN,DISTRICT,30 - 34,SEPERATION,6,1,5,0,6,1,5,0,0,0,0,0
BARKHAN,DISTRICT,30 - 34,WIDOWED,48,38,10,0,44,36,8,0,4,2,2,0
BARKHAN,DISTRICT,35 - 39,DIVORCED,10,8,2,0,10,8,2,0,0,0,0,0
BARKHAN,DISTRICT,35 - 39,MARRIED,8342,4207,4135,0,7730,3871,3859,0,612,336,276,0
BARKHAN,DISTRICT,35 - 39,NEVER MARRIED,478,146,331,1,409,113,296,0,69,33,35,1
BARKHAN,DISTRICT,35 - 39,SEPERATION,7,4,3,0,7,4,3,0,0,0,0,0
BARKHAN,DISTRICT,35 - 39,WIDOWED,116,90,26,0,108,84,24,0,8,6,2,0
BARKHAN,DISTRICT,40 - 44,DIVORCED,3,3,0,0,2,2,0,0,1,1,0,0
BARKHAN,DISTRICT,40 - 44,MARRIED,7615,3632,3983,0,7018,3358,3660,0,597,274,323,0
BARKHAN,DISTRICT,40 - 44,NEVER MARRIED,189,56,133,0,164,47,117,0,25,9,16,0
BARKHAN,DISTRICT,40 - 44,SEPERATION,7,5,2,0,7,5,2,0,0,0,0,0
BARKHAN,DISTRICT,40 - 44,WIDOWED,123,92,31,0,111,80,31,0,12,12,0,0
BARKHAN,DISTRICT,45 - 49,DIVORCED,1,1,0,0,1,1,0,0,0,0,0,0
BARKHAN,DISTRICT,45 - 49,MARRIED,5337,2528,2809,0,4951,2356,2595,0,386,172,214,0
BARKHAN,DISTRICT,45 - 49,NEVER MARRIED,88,25,63,0,78,22,56,0,10,3,7,0
BARKHAN,DISTRICT,45 - 49,SEPERATION,3,1,2,0,3,1,2,0,0,0,0,0
BARKHAN,DISTRICT,45 - 49,WIDOWED,147,123,24,0,133,110,23,0,14,13,1,0
BARKHAN,DISTRICT,50 - 54,DIVORCED,4,4,0,0,4,4,0,0,0,0,0,0
BARKHAN,DISTRICT,50 - 54,MARRIED,5037,2497,2540,0,4658,2317,2341,0,379,180,199,0
BARKHAN,DISTRICT,50 - 54,NEVER MARRIED,43,11,31,1,39,11,27,1,4,0,4,0
BARKHAN,DISTRICT,50 - 54,SEPERATION,3,1,2,0,3,1,2,0,0,0,0,0
BARKHAN,DISTRICT,50 - 54,WIDOWED,285,252,33,0,242,210,32,0,43,42,1,0
BARKHAN,DISTRICT,55 - 59,DIVORCED,2,2,0,0,2,2,0,0,0,0,0,0
BARKHAN,DISTRICT,55 - 59,MARRIED,3144,1416,1728,0,2848,1286,1562,0,296,130,166,0
BARKHAN,DISTRICT,55 - 59,NEVER MARRIED,24,8,16,0,22,8,14,0,2,0,2,0
BARKHAN,DISTRICT,55 - 59,SEPERATION,1,1,0,0,1,1,0,0,0,0,0,0
BARKHAN,DISTRICT,55 - 59,WIDOWED,236,200,36,0,204,173,31,0,32,27,5,0
BARKHAN,DISTRICT,60 - 64,DIVORCED,2,2,0,0,2,2,0,0,0,0,0,0
BARKHAN,DISTRICT,60 - 64,MARRIED,2654,1109,1545,0,2459,1036,1423,0,195,73,122,0
BARKHAN,DISTRICT,60 - 64,NEVER MARRIED,26,8,18,0,25,7,18,0,1,1,0,0
BARKHAN,DISTRICT,60 - 64,SEPERATION,3,2,1,0,3,2,1,0,0,0,0,0
BARKHAN,DISTRICT,60 - 64,WIDOWED,336,297,39,0,294,261,33,0,42,36,6,0
BARKHAN,DISTRICT,65 - 69,DIVORCED,1,1,0,0,1,1,0,0,0,0,0,0
BARKHAN,DISTRICT,65 - 69,MARRIED,1762,772,990,0,1646,733,913,0,116,39,77,0
BARKHAN,DISTRICT,65 - 69,NEVER MARRIED,7,3,4,0,6,3,3,0,1,0,1,0
BARKHAN,DISTRICT,65 - 69,SEPERATION,3,3,0,0,3,3,0,0,0,0,0,0
BARKHAN,DISTRICT,65 - 69,WIDOWED,333,285,48,0,290,245,45,0,43,40,3,0
BARKHAN,DISTRICT,70 - 74,DIVORCED,1,1,0,0,1,1,0,0,0,0,0,0
BARKHAN,DISTRICT,70 - 74,MARRIED,1465,563,902,0,1391,541,850,0,74,22,52,0
BARKHAN,DISTRICT,70 - 74,NEVER MARRIED,9,4,5,0,8,3,5,0,1,1,0,0
BARKHAN,DISTRICT,70 - 74,SEPERATION,2,2,0,0,2,2,0,0,0,0,0,0
BARKHAN,DISTRICT,70 - 74,WIDOWED,378,315,63,0,336,279,57,0,42,36,6,0
BARKHAN,DISTRICT,75 & ABOVE,DIVORCED,5,1,4,0,5,1,4,0,0,0,0,0
BARKHAN,DISTRICT,75 & ABOVE,MARRIED,1295,477,818,0,1229,451,778,0,66,26,40,0
BARKHAN,DISTRICT,75 & ABOVE,NEVER MARRIED,5,1,4,0,5,1,4,0,0,0,0,0
BARKHAN,DISTRICT,75 & ABOVE,SEPERATION,2,1,1,0,2,1,1,0,0,0,0,0
BARKHAN,DISTRICT,75 & ABOVE,WIDOWED,575,468,107,0,532,429,103,0,43,39,4,0
CHAGAI,DISTRICT,15 &  ABOVE,DIVORCED,110,81,29,0,94,74,20,0,16,7,9,0
CHAGAI,DISTRICT,15 &  ABOVE,MARRIED,82086,40984,41102,0,76250,38084,38166,0,5836,2900,2936,0
CHAGAI,DISTRICT,15 &  ABOVE,NEVER MARRIED,43409,17771,25634,4,38870,15727,23139,4,4539,2044,2495,0
CHAGAI,DISTRICT,15 &  ABOVE,SEPERATION,47,27,20,0,42,26,16,0,5,1,4,0
CHAGAI,DISTRICT,15 &  ABOVE,WIDOWED,2817,2386,431,0,2464,2074,390,0,353,312,41,0
CHAGAI,DISTRICT,15 - 19,DIVORCED,7,7,0,0,7,7,0,0,0,0,0,0
CHAGAI,DISTRICT,15 - 19,MARRIED,3787,2845,942,0,3653,2748,905,0,134,97,37,0
CHAGAI,DISTRICT,15 - 19,NEVER MARRIED,25167,10831,14333,3,22890,9733,13154,3,2277,1098,1179,0
CHAGAI,DISTRICT,15 - 19,SEPERATION,1,1,0,0,1,1,0,0,0,0,0,0
CHAGAI,DISTRICT,15 - 19,WIDOWED,10,6,4,0,7,4,3,0,3,2,1,0
CHAGAI,DISTRICT,20 - 24,DIVORCED,15,10,5,0,13,9,4,0,2,1,1,0
CHAGAI,DISTRICT,20 - 24,MARRIED,10541,6488,4053,0,10047,6153,3894,0,494,335,159,0
CHAGAI,DISTRICT,20 - 24,NEVER MARRIED,11366,4336,7030,0,10186,3817,6369,0,1180,519,661,0
CHAGAI,DISTRICT,20 - 24,SEPERATION,5,2,3,0,5,2,3,0,0,0,0,0
CHAGAI,DISTRICT,20 - 24,WIDOWED,50,37,13,0,48,35,13,0,2,2,0,0
CHAGAI,DISTRICT,25 - 29,DIVORCED,19,12,7,0,16,12,4,0,3,0,3,0
CHAGAI,DISTRICT,25 - 29,MARRIED,11986,6611,5375,0,11170,6091,5079,0,816,520,296,0
CHAGAI,DISTRICT,25 - 29,NEVER MARRIED,3978,1475,2502,1,3404,1250,2153,1,574,225,349,0
CHAGAI,DISTRICT,25 - 29,SEPERATION,8,6,2,0,7,5,2,0,1,1,0,0
CHAGAI,DISTRICT,25 - 29,WIDOWED,69,55,14,0,60,48,12,0,9,7,2,0
CHAGAI,DISTRICT,30 - 34,DIVORCED,19,15,4,0,18,14,4,0,1,1,0,0
CHAGAI,DISTRICT,30 - 34,MARRIED,11607,6048,5559,0,10780,5612,5168,0,827,436,391,0
CHAGAI,DISTRICT,30 - 34,NEVER MARRIED,1586,588,998,0,1309,486,823,0,277,102,175,0
CHAGAI,DISTRICT,30 - 34,SEPERATION,1,1,0,0,1,1,0,0,0,0,0,0
CHAGAI,DISTRICT,30 - 34,WIDOWED,116,92,24,0,105,83,22,0,11,9,2,0
CHAGAI,DISTRICT,35 - 39,DIVORCED,21,14,7,0,18,13,5,0,3,1,2,0
CHAGAI,DISTRICT,35 - 39,MARRIED,11398,5655,5743,0,10527,5190,5337,0,871,465,406,0
CHAGAI,DISTRICT,35 - 39,NEVER MARRIED,713,299,414,0,609,254,355,0,104,45,59,0
CHAGAI,DISTRICT,35 - 39,SEPERATION,9,2,7,0,6,2,4,0,3,0,3,0
CHAGAI,DISTRICT,35 - 39,WIDOWED,147,118,29,0,131,103,28,0,16,15,1,0
CHAGAI,DISTRICT,40 - 44,DIVORCED,13,9,4,0,10,8,2,0,3,1,2,0
CHAGAI,DISTRICT,40 - 44,MARRIED,10219,4500,5719,0,9332,4135,5197,0,887,365,522,0
CHAGAI,DISTRICT,40 - 44,NEVER MARRIED,360,159,201,0,284,124,160,0,76,35,41,0
CHAGAI,DISTRICT,40 - 44,SEPERATION,4,2,2,0,4,2,2,0,0,0,0,0
CHAGAI,DISTRICT,40 - 44,WIDOWED,220,183,37,0,198,166,32,0,22,17,5,0
CHAGAI,DISTRICT,45 - 49,DIVORCED,3,1,2,0,2,1,1,0,1,0,1,0
CHAGAI,DISTRICT,45 - 49,MARRIED,6508,2813,3695,0,5969,2593,3376,0,539,220,319,0
CHAGAI,DISTRICT,45 - 49,NEVER MARRIED,121,39,82,0,95,30,65,0,26,9,17,0
CHAGAI,DISTRICT,45 - 49,SEPERATION,4,2,2,0,4,2,2,0,0,0,0,0
CHAGAI,DISTRICT,45 - 49,WIDOWED,216,185,31,0,183,159,24,0,33,26,7,0
CHAGAI,DISTRICT,50 - 54,DIVORCED,7,7,0,0,6,6,0,0,1,1,0,0
CHAGAI,DISTRICT,50 - 54,MARRIED,5438,2373,3065,0,5004,2177,2827,0,434,196,238,0
CHAGAI,DISTRICT,50 - 54,NEVER MARRIED,54,22,32,0,41,16,25,0,13,6,7,0
CHAGAI,DISTRICT,50 - 54,SEPERATION,3,2,1,0,3,2,1,0,0,0,0,0
CHAGAI,DISTRICT,50 - 54,WIDOWED,287,245,42,0,249,209,40,0,38,36,2,0
CHAGAI,DISTRICT,55 - 59,DIVORCED,2,2,0,0,1,1,0,0,1,1,0,0
CHAGAI,DISTRICT,55 - 59,MARRIED,3815,1425,2390,0,3508,1326,2182,0,307,99,208,0
CHAGAI,DISTRICT,55 - 59,NEVER MARRIED,29,11,18,0,26,8,18,0,3,3,0,0
CHAGAI,DISTRICT,55 - 59,SEPERATION,1,1,0,0,1,1,0,0,0,0,0,0
CHAGAI,DISTRICT,55 - 59,WIDOWED,321,276,45,0,260,222,38,0,61,54,7,0
CHAGAI,DISTRICT,60 - 64,DIVORCED,1,1,0,0,1,1,0,0,0,0,0,0
CHAGAI,DISTRICT,60 - 64,MARRIED,2576,895,1681,0,2363,823,1540,0,213,72,141,0
CHAGAI,DISTRICT,60 - 64,NEVER MARRIED,14,4,10,0,12,4,8,0,2,0,2,0
CHAGAI,DISTRICT,60 - 64,SEPERATION,5,4,1,0,5,4,1,0,0,0,0,0
CHAGAI,DISTRICT,60 - 64,WIDOWED,305,274,31,0,269,242,27,0,36,32,4,0
CHAGAI,DISTRICT,65 - 69,DIVORCED,1,1,0,0,1,1,0,0,0,0,0,0
CHAGAI,DISTRICT,65 - 69,MARRIED,1811,659,1152,0,1654,609,1045,0,157,50,107,0
CHAGAI,DISTRICT,65 - 69,NEVER MARRIED,9,3,6,0,6,2,4,0,3,1,2,0
CHAGAI,DISTRICT,65 - 69,SEPERATION,2,1,1,0,2,1,1,0,0,0,0,0
CHAGAI,DISTRICT,65 - 69,WIDOWED,328,302,26,0,269,246,23,0,59,56,3,0
CHAGAI,DISTRICT,70 - 74,DIVORCED,2,2,0,0,1,1,0,0,1,1,0,0
CHAGAI,DISTRICT,70 - 74,MARRIED,1235,389,846,0,1138,358,780,0,97,31,66,0
CHAGAI,DISTRICT,70 - 74,NEVER MARRIED,4,1,3,0,1,0,1,0,3,1,2,0
CHAGAI,DISTRICT,70 - 74,SEPERATION,2,2,0,0,2,2,0,0,0,0,0,0
CHAGAI,DISTRICT,70 - 74,WIDOWED,310,270,40,0,276,238,38,0,34,32,2,0
CHAGAI,DISTRICT,75 & ABOVE,DIVORCED,0,0,0,0,0,0,0,0,0,0,0,0
CHAGAI,DISTRICT,75 & ABOVE,MARRIED,1165,283,882,0,1105,269,836,0,60,14,46,0
CHAGAI,DISTRICT,75 & ABOVE,NEVER MARRIED,8,3,5,0,7,3,4,0,1,0,1,0
CHAGAI,DISTRICT,75 & ABOVE,SEPERATION,2,1,1,0,1,1,0,0,1,0,1,0
CHAGAI,DISTRICT,75 & ABOVE,WIDOWED,438,343,95,0,409,319,90,0,29,24,5,0
CHAMAN,DISTRICT,15 &  ABOVE,DIVORCED,9,6,3,0,3,3,0,0,6,3,3,0
CHAMAN,DISTRICT,15 &  ABOVE,MARRIED,137922,69851,68071,0,96051,48679,47372,0,41871,21172,20699,0
CHAMAN,DISTRICT,15 &  ABOVE,NEVER MARRIED,74820,28480,46332,8,51691,19283,32401,7,23129,9197,13931,1
CHAMAN,DISTRICT,15 &  ABOVE,SEPERATION,41,22,19,0,19,10,9,0,22,12,10,0
CHAMAN,DISTRICT,15 &  ABOVE,WIDOWED,1511,1320,191,0,974,853,121,0,537,467,70,0
CHAMAN,DISTRICT,15 - 19,DIVORCED,0,0,0,0,0,0,0,0,0,0,0,0
CHAMAN,DISTRICT,15 - 19,MARRIED,7499,5141,2358,0,5779,3918,1861,0,1720,1223,497,0
CHAMAN,DISTRICT,15 - 19,NEVER MARRIED,46425,18966,27456,3,32446,12910,19534,2,13979,6056,7922,1
CHAMAN,DISTRICT,15 - 19,SEPERATION,16,8,8,0,6,2,4,0,10,6,4,0
CHAMAN,DISTRICT,15 - 19,WIDOWED,4,1,3,0,4,1,3,0,0,0,0,0
CHAMAN,DISTRICT,20 - 24,DIVORCED,2,1,1,0,0,0,0,0,2,1,1,0
CHAMAN,DISTRICT,20 - 24,MARRIED,22544,13411,9133,0,16145,9494,6651,0,6399,3917,2482,0
CHAMAN,DISTRICT,20 - 24,NEVER MARRIED,20163,6774,13388,1,13553,4498,9054,1,6610,2276,4334,0
CHAMAN,DISTRICT,20 - 24,SEPERATION,4,1,3,0,1,1,0,0,3,0,3,0
CHAMAN,DISTRICT,20 - 24,WIDOWED,16,7,9,0,13,6,7,0,3,1,2,0
CHAMAN,DISTRICT,25 - 29,DIVORCED,1,1,0,0,1,1,0,0,0,0,0,0
CHAMAN,DISTRICT,25 - 29,MARRIED,23425,12244,11181,0,16260,8458,7802,0,7165,3786,3379,0
CHAMAN,DISTRICT,25 - 29,NEVER MARRIED,5253,1597,3656,0,3497,1037,2460,0,1756,560,1196,0
CHAMAN,DISTRICT,25 - 29,SEPERATION,4,2,2,0,2,1,1,0,2,1,1,0
CHAMAN,DISTRICT,25 - 29,WIDOWED,31,21,10,0,18,14,4,0,13,7,6,0
CHAMAN,DISTRICT,30 - 34,DIVORCED,1,0,1,0,0,0,0,0,1,0,1,0
CHAMAN,DISTRICT,30 - 34,MARRIED,19478,9617,9861,0,13478,6647,6831,0,6000,2970,3030,0
CHAMAN,DISTRICT,30 - 34,NEVER MARRIED,1574,552,1021,1,1089,367,721,1,485,185,300,0
CHAMAN,DISTRICT,30 - 34,SEPERATION,1,0,1,0,0,0,0,0,1,0,1,0
CHAMAN,DISTRICT,30 - 34,WIDOWED,23,23,0,0,12,12,0,0,11,11,0,0
CHAMAN,DISTRICT,35 - 39,DIVORCED,3,2,1,0,1,1,0,0,2,1,1,0
CHAMAN,DISTRICT,35 - 39,MARRIED,17190,8332,8858,0,12032,5819,6213,0,5158,2513,2645,0
CHAMAN,DISTRICT,35 - 39,NEVER MARRIED,665,238,424,3,511,175,333,3,154,63,91,0
CHAMAN,DISTRICT,35 - 39,SEPERATION,2,1,1,0,1,0,1,0,1,1,0,0
CHAMAN,DISTRICT,35 - 39,WIDOWED,64,55,9,0,40,35,5,0,24,20,4,0
CHAMAN,DISTRICT,40 - 44,DIVORCED,0,0,0,0,0,0,0,0,0,0,0,0
CHAMAN,DISTRICT,40 - 44,MARRIED,13996,6662,7334,0,9578,4564,5014,0,4418,2098,2320,0
CHAMAN,DISTRICT,40 - 44,NEVER MARRIED,271,116,155,0,204,90,114,0,67,26,41,0
CHAMAN,DISTRICT,40 - 44,SEPERATION,2,0,2,0,2,0,2,0,0,0,0,0
CHAMAN,DISTRICT,40 - 44,WIDOWED,109,98,11,0,78,71,7,0,31,27,4,0
CHAMAN,DISTRICT,45 - 49,DIVORCED,0,0,0,0,0,0,0,0,0,0,0,0
CHAMAN,DISTRICT,45 - 49,MARRIED,9794,4423,5371,0,6584,3004,3580,0,3210,1419,1791,0
CHAMAN,DISTRICT,45 - 49,NEVER MARRIED,152,64,88,0,113,48,65,0,39,16,23,0
CHAMAN,DISTRICT,45 - 49,SEPERATION,4,4,0,0,3,3,0,0,1,1,0,0
CHAMAN,DISTRICT,45 - 49,WIDOWED,117,109,8,0,68,63,5,0,49,46,3,0
CHAMAN,DISTRICT,50 - 54,DIVORCED,0,0,0,0,0,0,0,0,0,0,0,0
CHAMAN,DISTRICT,50 - 54,MARRIED,7348,3448,3900,0,4916,2307,2609,0,2432,1141,1291,0
CHAMAN,DISTRICT,50 - 54,NEVER MARRIED,80,41,39,0,63,33,30,0,17,8,9,0
CHAMAN,DISTRICT,50 - 54,SEPERATION,0,0,0,0,0,0,0,0,0,0,0,0
CHAMAN,DISTRICT,50 - 54,WIDOWED,157,139,18,0,93,83,10,0,64,56,8,0
CHAMAN,DISTRICT,55 - 59,DIVORCED,1,1,0,0,0,0,0,0,1,1,0,0
CHAMAN,DISTRICT,55 - 59,MARRIED,5819,2381,3438,0,3945,1627,2318,0,1874,754,1120,0
CHAMAN,DISTRICT,55 - 59,NEVER MARRIED,73,41,32,0,67,39,28,0,6,2,4,0
CHAMAN,DISTRICT,55 - 59,SEPERATION,2,2,0,0,0,0,0,0,2,2,0,0
CHAMAN,DISTRICT,55 - 59,WIDOWED,178,162,16,0,109,100,9,0,69,62,7,0
CHAMAN,DISTRICT,60 - 64,DIVORCED,0,0,0,0,0,0,0,0,0,0,0,0
CHAMAN,DISTRICT,60 - 64,MARRIED,4029,1637,2392,0,2755,1094,1661,0,1274,543,731,0
CHAMAN,DISTRICT,60 - 64,NEVER MARRIED,59,33,26,0,53,33,20,0,6,0,6,0
CHAMAN,DISTRICT,60 - 64,SEPERATION,1,1,0,0,0,0,0,0,1,1,0,0
CHAMAN,DISTRICT,60 - 64,WIDOWED,213,187,26,0,141,123,18,0,72,64,8,0
CHAMAN,DISTRICT,65 - 69,DIVORCED,0,0,0,0,0,0,0,0,0,0,0,0
CHAMAN,DISTRICT,65 - 69,MARRIED,2560,1034,1526,0,1712,727,985,0,848,307,541,0
CHAMAN,DISTRICT,65 - 69,NEVER MARRIED,36,18,18,0,35,17,18,0,1,1,0,0
CHAMAN,DISTRICT,65 - 69,SEPERATION,3,2,1,0,2,2,0,0,1,0,1,0
CHAMAN,DISTRICT,65 - 69,WIDOWED,159,140,19,0,105,91,14,0,54,49,5,0
CHAMAN,DISTRICT,70 - 74,DIVORCED,1,1,0,0,1,1,0,0,0,0,0,0
CHAMAN,DISTRICT,70 - 74,MARRIED,1942,768,1174,0,1362,534,828,0,580,234,346,0
CHAMAN,DISTRICT,70 - 74,NEVER MARRIED,25,18,7,0,22,16,6,0,3,2,1,0
CHAMAN,DISTRICT,70 - 74,SEPERATION,1,0,1,0,1,0,1,0,0,0,0,0
CHAMAN,DISTRICT,70 - 74,WIDOWED,173,158,15,0,113,103,10,0,60,55,5,0
CHAMAN,DISTRICT,75 & ABOVE,DIVORCED,0,0,0,0,0,0,0,0,0,0,0,0
CHAMAN,DISTRICT,75 & ABOVE,MARRIED,2298,753,1545,0,1505,486,1019,0,793,267,526,0
CHAMAN,DISTRICT,75 & ABOVE,NEVER MARRIED,44,22,22,0,38,20,18,0,6,2,4,0
CHAMAN,DISTRICT,75 & ABOVE,SEPERATION,1,1,0,0,1,1,0,0,0,0,0,0
CHAMAN,DISTRICT,75 & ABOVE,WIDOWED,267,220,47,0,180,151,29,0,87,69,18,0
DERA BUGTI,DISTRICT,15 &  ABOVE,DIVORCED,113,51,62,0,62,32,30,0,51,19,32,0
DERA BUGTI,DISTRICT,15 &  ABOVE,MARRIED,130374,67930,62444,0,89966,47035,42931,0,40408,20895,19513,0
DERA BUGTI,DISTRICT,15 &  ABOVE,NEVER MARRIED,23680,6123,17554,3,14375,2868,11505,2,9305,3255,6049,1
DERA BUGTI,DISTRICT,15 &  ABOVE,SEPERATION,97,33,64,0,79,25,54,0,18,8,10,0
DERA BUGTI,DISTRICT,15 &  ABOVE,WIDOWED,2608,2036,572,0,1350,1025,325,0,1258,1011,247,0
DERA BUGTI,DISTRICT,15 - 19,DIVORCED,27,6,21,0,14,4,10,0,13,2,11,0
DERA BUGTI,DISTRICT,15 - 19,MARRIED,11991,7250,4741,0,8083,4834,3249,0,3908,2416,1492,0
DERA BUGTI,DISTRICT,15 - 19,NEVER MARRIED,18911,5079,13830,2,11935,2528,9406,1,6976,2551,4424,1
DERA BUGTI,DISTRICT,15 - 19,SEPERATION,12,1,11,0,9,1,8,0,3,0,3,0
DERA BUGTI,DISTRICT,15 - 19,WIDOWED,21,5,16,0,9,4,5,0,12,1,11,0
DERA BUGTI,DISTRICT,20 - 24,DIVORCED,19,6,13,0,8,3,5,0,11,3,8,0
DERA BUGTI,DISTRICT,20 - 24,MARRIED,23646,13595,10051,0,16001,9162,6839,0,7645,4433,3212,0
DERA BUGTI,DISTRICT,20 - 24,NEVER MARRIED,3325,773,2552,0,1629,236,1393,0,1696,537,1159,0
DERA BUGTI,DISTRICT,20 - 24,SEPERATION,16,7,9,0,12,6,6,0,4,1,3,0
DERA BUGTI,DISTRICT,20 - 24,WIDOWED,55,28,27,0,30,17,13,0,25,11,14,0
DERA BUGTI,DISTRICT,25 - 29,DIVORCED,13,3,10,0,6,3,3,0,7,0,7,0
DERA BUGTI,DISTRICT,25 - 29,MARRIED,21242,11305,9937,0,14779,8044,6735,0,6463,3261,3202,0
DERA BUGTI,DISTRICT,25 - 29,NEVER MARRIED,824,148,675,1,413,47,365,1,411,101,310,0
DERA BUGTI,DISTRICT,25 - 29,SEPERATION,8,1,7,0,8,1,7,0,0,0,0,0
DERA BUGTI,DISTRICT,25 - 29,WIDOWED,72,33,39,0,37,18,19,0,35,15,20,0
DERA BUGTI,DISTRICT,30 - 34,DIVORCED,10,7,3,0,3,3,0,0,7,4,3,0
DERA BUGTI,DISTRICT,30 - 34,MARRIED,17723,9266,8457,0,12109,6433,5676,0,5614,2833,2781,0
DERA BUGTI,DISTRICT,30 - 34,NEVER MARRIED,296,58,238,0,170,17,153,0,126,41,85,0
DERA BUGTI,DISTRICT,30 - 34,SEPERATION,10,1,9,0,8,0,8,0,2,1,1,0
DERA BUGTI,DISTRICT,30 - 34,WIDOWED,99,61,38,0,49,29,20,0,50,32,18,0
DERA BUGTI,DISTRICT,35 - 39,DIVORCED,10,8,2,0,5,4,1,0,5,4,1,0
DERA BUGTI,DISTRICT,35 - 39,MARRIED,14457,7270,7187,0,9918,5023,4895,0,4539,2247,2292,0
DERA BUGTI,DISTRICT,35 - 39,NEVER MARRIED,138,27,111,0,90,16,74,0,48,11,37,0
DERA BUGTI,DISTRICT,35 - 39,SEPERATION,5,1,4,0,4,0,4,0,1,1,0,0
DERA BUGTI,DISTRICT,35 - 39,WIDOWED,143,99,44,0,81,58,23,0,62,41,21,0
DERA BUGTI,DISTRICT,40 - 44,DIVORCED,12,8,4,0,8,6,2,0,4,2,2,0
DERA BUGTI,DISTRICT,40 - 44,MARRIED,12032,5971,6061,0,8499,4237,4262,0,3533,1734,1799,0
DERA BUGTI,DISTRICT,40 - 44,NEVER MARRIED,52,14,38,0,33,10,23,0,19,4,15,0
DERA BUGTI,DISTRICT,40 - 44,SEPERATION,4,1,3,0,4,1,3,0,0,0,0,0
DERA BUGTI,DISTRICT,40 - 44,WIDOWED,167,133,34,0,90,67,23,0,77,66,11,0
DERA BUGTI,DISTRICT,45 - 49,DIVORCED,2,0,2,0,2,0,2,0,0,0,0,0
DERA BUGTI,DISTRICT,45 - 49,MARRIED,7595,3670,3925,0,5356,2597,2759,0,2239,1073,1166,0
DERA BUGTI,DISTRICT,45 - 49,NEVER MARRIED,41,7,34,0,32,4,28,0,9,3,6,0
DERA BUGTI,DISTRICT,45 - 49,SEPERATION,6,3,3,0,6,3,3,0,0,0,0,0
DERA BUGTI,DISTRICT,45 - 49,WIDOWED,182,149,33,0,100,81,19,0,82,68,14,0
DERA BUGTI,DISTRICT,50 - 54,DIVORCED,4,2,2,0,3,1,2,0,1,1,0,0
DERA BUGTI,DISTRICT,50 - 54,MARRIED,6895,3428,3467,0,4744,2337,2407,0,2151,1091,1060,0
DERA BUGTI,DISTRICT,50 - 54,NEVER MARRIED,22,4,18,0,16,2,14,0,6,2,4,0
DERA BUGTI,DISTRICT,50 - 54,SEPERATION,6,4,2,0,6,4,2,0,0,0,0,0
DERA BUGTI,DISTRICT,50 - 54,WIDOWED,257,215,42,0,141,115,26,0,116,100,16,0
DERA BUGTI,DISTRICT,55 - 59,DIVORCED,4,4,0,0,4,4,0,0,0,0,0,0
DERA BUGTI,DISTRICT,55 - 59,MARRIED,5289,2442,2847,0,3551,1685,1866,0,1738,757,981,0
DERA BUGTI,DISTRICT,55 - 59,NEVER MARRIED,24,5,19,0,16,2,14,0,8,3,5,0
DERA BUGTI,DISTRICT,55 - 59,SEPERATION,9,7,2,0,6,4,2,0,3,3,0,0
DERA BUGTI,DISTRICT,55 - 59,WIDOWED,278,234,44,0,126,100,26,0,152,134,18,0
DERA BUGTI,DISTRICT,60 - 64,DIVORCED,3,2,1,0,2,1,1,0,1,1,0,0
DERA BUGTI,DISTRICT,60 - 64,MARRIED,4200,1751,2449,0,2997,1242,1755,0,1203,509,694,0
DERA BUGTI,DISTRICT,60 - 64,NEVER MARRIED,20,6,14,0,15,4,11,0,5,2,3,0
DERA BUGTI,DISTRICT,60 - 64,SEPERATION,7,2,5,0,4,1,3,0,3,1,2,0
DERA BUGTI,DISTRICT,60 - 64,WIDOWED,360,300,60,0,190,154,36,0,170,146,24,0
DERA BUGTI,DISTRICT,65 - 69,DIVORCED,2,0,2,0,2,0,2,0,0,0,0,0
DERA BUGTI,DISTRICT,65 - 69,MARRIED,2371,968,1403,0,1702,692,1010,0,669,276,393,0
DERA BUGTI,DISTRICT,65 - 69,NEVER MARRIED,9,1,8,0,8,1,7,0,1,0,1,0
DERA BUGTI,DISTRICT,65 - 69,SEPERATION,4,3,1,0,3,3,0,0,1,0,1,0
DERA BUGTI,DISTRICT,65 - 69,WIDOWED,260,215,45,0,112,91,21,0,148,124,24,0
DERA BUGTI,DISTRICT,70 - 74,DIVORCED,0,0,0,0,0,0,0,0,0,0,0,0
DERA BUGTI,DISTRICT,70 - 74,MARRIED,1678,623,1055,0,1267,464,803,0,411,159,252,0
DERA BUGTI,DISTRICT,70 - 74,NEVER MARRIED,10,0,10,0,10,0,10,0,0,0,0,0
DERA BUGTI,DISTRICT,70 - 74,SEPERATION,3,0,3,0,3,0,3,0,0,0,0,0
DERA BUGTI,DISTRICT,70 - 74,WIDOWED,325,263,62,0,170,131,39,0,155,132,23,0
DERA BUGTI,DISTRICT,75 & ABOVE,DIVORCED,7,5,2,0,5,3,2,0,2,2,0,0
DERA BUGTI,DISTRICT,75 & ABOVE,MARRIED,1255,391,864,0,960,285,675,0,295,106,189,0
DERA BUGTI,DISTRICT,75 & ABOVE,NEVER MARRIED,8,1,7,0,8,1,7,0,0,0,0,0
DERA BUGTI,DISTRICT,75 & ABOVE,SEPERATION,7,2,5,0,6,1,5,0,1,1,0,0
DERA BUGTI,DISTRICT,75 & ABOVE,WIDOWED,389,301,88,0,215,160,55,0,174,141,33,0
DUKI,DISTRICT,15 &  ABOVE,DIVORCED,63,35,28,0,59,32,27,0,4,3,1,0
DUKI,DISTRICT,15 &  ABOVE,MARRIED,80405,39513,40892,0,75848,37311,38537,0,4557,2202,2355,0
DUKI,DISTRICT,15 &  ABOVE,NEVER MARRIED,30687,12778,17863,46,28451,12010,16398,43,2236,768,1465,3
DUKI,DISTRICT,15 &  ABOVE,SEPERATION,87,12,75,0,85,12,73,0,2,0,2,0
DUKI,DISTRICT,15 &  ABOVE,WIDOWED,1460,948,512,0,1366,885,481,0,94,63,31,0
DUKI,DISTRICT,15 - 19,DIVORCED,9,5,4,0,9,5,4,0,0,0,0,0
DUKI,DISTRICT,15 - 19,MARRIED,3993,2231,1762,0,3884,2165,1719,0,109,66,43,0
DUKI,DISTRICT,15 - 19,NEVER MARRIED,17169,7730,9427,12,16167,7345,8810,12,1002,385,617,0
DUKI,DISTRICT,15 - 19,SEPERATION,18,6,12,0,18,6,12,0,0,0,0,0
DUKI,DISTRICT,15 - 19,WIDOWED,12,2,10,0,11,2,9,0,1,0,1,0
DUKI,DISTRICT,20 - 24,DIVORCED,3,2,1,0,3,2,1,0,0,0,0,0
DUKI,DISTRICT,20 - 24,MARRIED,11005,6112,4893,0,10394,5725,4669,0,611,387,224,0
DUKI,DISTRICT,20 - 24,NEVER MARRIED,7682,3010,4665,7,7010,2773,4230,7,672,237,435,0
DUKI,DISTRICT,20 - 24,SEPERATION,7,1,6,0,7,1,6,0,0,0,0,0
DUKI,DISTRICT,20 - 24,WIDOWED,32,7,25,0,32,7,25,0,0,0,0,0
DUKI,DISTRICT,25 - 29,DIVORCED,7,3,4,0,7,3,4,0,0,0,0,0
DUKI,DISTRICT,25 - 29,MARRIED,13894,7266,6628,0,13128,6876,6252,0,766,390,376,0
DUKI,DISTRICT,25 - 29,NEVER MARRIED,3275,1313,1954,8,2993,1215,1770,8,282,98,184,0
DUKI,DISTRICT,25 - 29,SEPERATION,18,1,17,0,18,1,17,0,0,0,0,0
DUKI,DISTRICT,25 - 29,WIDOWED,47,17,30,0,44,15,29,0,3,2,1,0
DUKI,DISTRICT,30 - 34,DIVORCED,9,4,5,0,8,3,5,0,1,1,0,0
DUKI,DISTRICT,30 - 34,MARRIED,12475,6565,5910,0,11895,6275,5620,0,580,290,290,0
DUKI,DISTRICT,30 - 34,NEVER MARRIED,1346,487,850,9,1194,458,727,9,152,29,123,0
DUKI,DISTRICT,30 - 34,SEPERATION,22,1,21,0,22,1,21,0,0,0,0,0
DUKI,DISTRICT,30 - 34,WIDOWED,65,28,37,0,63,26,37,0,2,2,0,0
DUKI,DISTRICT,35 - 39,DIVORCED,12,3,9,0,11,3,8,0,1,0,1,0
DUKI,DISTRICT,35 - 39,MARRIED,11702,5560,6142,0,11071,5248,5823,0,631,312,319,0
DUKI,DISTRICT,35 - 39,NEVER MARRIED,763,160,597,6,699,150,546,3,64,10,51,3
DUKI,DISTRICT,35 - 39,SEPERATION,13,0,13,0,12,0,12,0,1,0,1,0
DUKI,DISTRICT,35 - 39,WIDOWED,94,44,50,0,87,41,46,0,7,3,4,0
DUKI,DISTRICT,40 - 44,DIVORCED,11,10,1,0,9,8,1,0,2,2,0,0
DUKI,DISTRICT,40 - 44,MARRIED,8484,3936,4548,0,7946,3701,4245,0,538,235,303,0
DUKI,DISTRICT,40 - 44,NEVER MARRIED,218,41,175,2,192,37,153,2,26,4,22,0
DUKI,DISTRICT,40 - 44,SEPERATION,3,1,2,0,3,1,2,0,0,0,0,0
DUKI,DISTRICT,40 - 44,WIDOWED,138,77,61,0,124,72,52,0,14,5,9,0
DUKI,DISTRICT,45 - 49,DIVORCED,3,2,1,0,3,2,1,0,0,0,0,0
DUKI,DISTRICT,45 - 49,MARRIED,6033,2759,3274,0,5549,2533,3016,0,484,226,258,0
DUKI,DISTRICT,45 - 49,NEVER MARRIED,98,16,82,0,76,13,63,0,22,3,19,0
DUKI,DISTRICT,45 - 49,SEPERATION,3,1,2,0,2,1,1,0,1,0,1,0
DUKI,DISTRICT,45 - 49,WIDOWED,115,83,32,0,108,81,27,0,7,2,5,0
DUKI,DISTRICT,50 - 54,DIVORCED,2,2,0,0,2,2,0,0,0,0,0,0
DUKI,DISTRICT,50 - 54,MARRIED,4286,1867,2419,0,3951,1745,2206,0,335,122,213,0
DUKI,DISTRICT,50 - 54,NEVER MARRIED,56,8,47,1,45,8,36,1,11,0,11,0
DUKI,DISTRICT,50 - 54,SEPERATION,1,1,0,0,1,1,0,0,0,0,0,0
DUKI,DISTRICT,50 - 54,WIDOWED,165,111,54,0,155,105,50,0,10,6,4,0
DUKI,DISTRICT,55 - 59,DIVORCED,1,1,0,0,1,1,0,0,0,0,0,0
DUKI,DISTRICT,55 - 59,MARRIED,3275,1276,1999,0,3068,1204,1864,0,207,72,135,0
DUKI,DISTRICT,55 - 59,NEVER MARRIED,29,4,24,1,27,3,23,1,2,1,1,0
DUKI,DISTRICT,55 - 59,SEPERATION,0,0,0,0,0,0,0,0,0,0,0,0
DUKI,DISTRICT,55 - 59,WIDOWED,142,117,25,0,135,111,24,0,7,6,1,0
DUKI,DISTRICT,60 - 64,DIVORCED,2,1,1,0,2,1,1,0,0,0,0,0
DUKI,DISTRICT,60 - 64,MARRIED,2140,809,1331,0,2009,771,1238,0,131,38,93,0
DUKI,DISTRICT,60 - 64,NEVER MARRIED,14,3,11,0,11,2,9,0,3,1,2,0
DUKI,DISTRICT,60 - 64,SEPERATION,0,0,0,0,0,0,0,0,0,0,0,0
DUKI,DISTRICT,60 - 64,WIDOWED,187,139,48,0,176,131,45,0,11,8,3,0
DUKI,DISTRICT,65 - 69,DIVORCED,1,0,1,0,1,0,1,0,0,0,0,0
DUKI,DISTRICT,65 - 69,MARRIED,1275,502,773,0,1205,471,734,0,70,31,39,0
DUKI,DISTRICT,65 - 69,NEVER MARRIED,19,4,15,0,19,4,15,0,0,0,0,0
DUKI,DISTRICT,65 - 69,SEPERATION,2,0,2,0,2,0,2,0,0,0,0,0
DUKI,DISTRICT,65 - 69,WIDOWED,138,112,26,0,121,96,25,0,17,16,1,0
DUKI,DISTRICT,70 - 74,DIVORCED,0,0,0,0,0,0,0,0,0,0,0,0
DUKI,DISTRICT,70 - 74,MARRIED,945,342,603,0,894,325,569,0,51,17,34,0
DUKI,DISTRICT,70 - 74,NEVER MARRIED,3,0,3,0,3,0,3,0,0,0,0,0
DUKI,DISTRICT,70 - 74,SEPERATION,0,0,0,0,0,0,0,0,0,0,0,0
DUKI,DISTRICT,70 - 74,WIDOWED,147,91,56,0,141,85,56,0,6,6,0,0
DUKI,DISTRICT,75 & ABOVE,DIVORCED,3,2,1,0,3,2,1,0,0,0,0,0
DUKI,DISTRICT,75 & ABOVE,MARRIED,898,288,610,0,854,272,582,0,44,16,28,0
DUKI,DISTRICT,75 & ABOVE,NEVER MARRIED,15,2,13,0,15,2,13,0,0,0,0,0
DUKI,DISTRICT,75 & ABOVE,SEPERATION,0,0,0,0,0,0,0,0,0,0,0,0
DUKI,DISTRICT,75 & ABOVE,WIDOWED,178,120,58,0,169,113,56,0,9,7,2,0
GWADAR,DISTRICT,15 &  ABOVE,DIVORCED,495,366,129,0,213,176,37,0,282,190,92,0
GWADAR,DISTRICT,15 &  ABOVE,MARRIED,106205,52959,53246,0,48525,24523,24002,0,57680,28436,29244,0
GWADAR,DISTRICT,15 &  ABOVE,NEVER MARRIED,61084,25419,35636,29,27210,11316,15882,12,33874,14103,19754,17
GWADAR,DISTRICT,15 &  ABOVE,SEPERATION,171,99,72,0,81,52,29,0,90,47,43,0
GWADAR,DISTRICT,15 &  ABOVE,WIDOWED,4886,4033,853,0,2069,1712,357,0,2817,2321,496,0
GWADAR,DISTRICT,15 - 19,DIVORCED,16,10,6,0,9,5,4,0,7,5,2,0
GWADAR,DISTRICT,15 - 19,MARRIED,3610,2651,959,0,2008,1392,616,0,1602,1259,343,0
GWADAR,DISTRICT,15 - 19,NEVER MARRIED,32070,13556,18506,8,15711,6562,9145,4,16359,6994,9361,4
GWADAR,DISTRICT,15 - 19,SEPERATION,7,3,4,0,5,2,3,0,2,1,1,0
GWADAR,DISTRICT,15 - 19,WIDOWED,14,9,5,0,6,3,3,0,8,6,2,0
GWADAR,DISTRICT,20 - 24,DIVORCED,52,41,11,0,26,23,3,0,26,18,8,0
GWADAR,DISTRICT,20 - 24,MARRIED,11439,7310,4129,0,5602,3376,2226,0,5837,3934,1903,0
GWADAR,DISTRICT,20 - 24,NEVER MARRIED,15127,6120,9004,3,6408,2636,3770,2,8719,3484,5234,1
GWADAR,DISTRICT,20 - 24,SEPERATION,19,13,6,0,7,4,3,0,12,9,3,0
GWADAR,DISTRICT,20 - 24,WIDOWED,50,40,10,0,23,17,6,0,27,23,4,0
GWADAR,DISTRICT,25 - 29,DIVORCED,74,58,16,0,34,31,3,0,40,27,13,0
GWADAR,DISTRICT,25 - 29,MARRIED,15503,8391,7112,0,6944,3688,3256,0,8559,4703,3856,0
GWADAR,DISTRICT,25 - 29,NEVER MARRIED,7251,2866,4381,4,2843,1137,1703,3,4408,1729,2678,1
GWADAR,DISTRICT,25 - 29,SEPERATION,21,12,9,0,10,8,2,0,11,4,7,0
GWADAR,DISTRICT,25 - 29,WIDOWED,94,61,33,0,29,18,11,0,65,43,22,0
GWADAR,DISTRICT,30 - 34,DIVORCED,64,51,13,0,24,22,2,0,40,29,11,0
GWADAR,DISTRICT,30 - 34,MARRIED,14539,7621,6918,0,6427,3434,2993,0,8112,4187,3925,0
GWADAR,DISTRICT,30 - 34,NEVER MARRIED,3143,1428,1712,3,1122,503,617,2,2021,925,1095,1
GWADAR,DISTRICT,30 - 34,SEPERATION,19,14,5,0,10,8,2,0,9,6,3,0
GWADAR,DISTRICT,30 - 34,WIDOWED,180,148,32,0,71,60,11,0,109,88,21,0
GWADAR,DISTRICT,35 - 39,DIVORCED,89,71,18,0,45,35,10,0,44,36,8,0
GWADAR,DISTRICT,35 - 39,MARRIED,14656,7200,7456,0,6248,3213,3035,0,8408,3987,4421,0
GWADAR,DISTRICT,35 - 39,NEVER MARRIED,1706,752,954,0,562,257,305,0,1144,495,649,0
GWADAR,DISTRICT,35 - 39,SEPERATION,24,14,10,0,11,6,5,0,13,8,5,0
GWADAR,DISTRICT,35 - 39,WIDOWED,254,203,51,0,91,74,17,0,163,129,34,0
GWADAR,DISTRICT,40 - 44,DIVORCED,75,58,17,0,28,25,3,0,47,33,14,0
GWADAR,DISTRICT,40 - 44,MARRIED,12962,6142,6820,0,6010,2997,3013,0,6952,3145,3807,0
GWADAR,DISTRICT,40 - 44,NEVER MARRIED,824,358,463,3,313,135,178,0,511,223,285,3
GWADAR,DISTRICT,40 - 44,SEPERATION,17,9,8,0,9,5,4,0,8,4,4,0
GWADAR,DISTRICT,40 - 44,WIDOWED,352,298,54,0,151,132,19,0,201,166,35,0
GWADAR,DISTRICT,45 - 49,DIVORCED,35,26,9,0,13,10,3,0,22,16,6,0
GWADAR,DISTRICT,45 - 49,MARRIED,9824,4359,5465,0,4332,1990,2342,0,5492,2369,3123,0
GWADAR,DISTRICT,45 - 49,NEVER MARRIED,432,156,274,2,140,45,95,0,292,111,179,2
GWADAR,DISTRICT,45 - 49,SEPERATION,18,10,8,0,9,7,2,0,9,3,6,0
GWADAR,DISTRICT,45 - 49,WIDOWED,386,315,71,0,163,138,25,0,223,177,46,0
GWADAR,DISTRICT,50 - 54,DIVORCED,28,17,11,0,9,9,0,0,19,8,11,0
GWADAR,DISTRICT,50 - 54,MARRIED,7563,3310,4253,0,3371,1538,1833,0,4192,1772,2420,0
GWADAR,DISTRICT,50 - 54,NEVER MARRIED,203,81,121,1,47,19,27,1,156,62,94,0
GWADAR,DISTRICT,50 - 54,SEPERATION,15,8,7,0,5,5,0,0,10,3,7,0
GWADAR,DISTRICT,50 - 54,WIDOWED,489,401,88,0,181,139,42,0,308,262,46,0
GWADAR,DISTRICT,55 - 59,DIVORCED,26,13,13,0,10,5,5,0,16,8,8,0
GWADAR,DISTRICT,55 - 59,MARRIED,5192,2054,3138,0,2285,943,1342,0,2907,1111,1796,0
GWADAR,DISTRICT,55 - 59,NEVER MARRIED,108,41,65,2,23,8,15,0,85,33,50,2
GWADAR,DISTRICT,55 - 59,SEPERATION,7,1,6,0,5,1,4,0,2,0,2,0
GWADAR,DISTRICT,55 - 59,WIDOWED,464,383,81,0,152,127,25,0,312,256,56,0
GWADAR,DISTRICT,60 - 64,DIVORCED,18,9,9,0,9,7,2,0,9,2,7,0
GWADAR,DISTRICT,60 - 64,MARRIED,4202,1612,2590,0,1871,735,1136,0,2331,877,1454,0
GWADAR,DISTRICT,60 - 64,NEVER MARRIED,90,26,62,2,19,8,11,0,71,18,51,2
GWADAR,DISTRICT,60 - 64,SEPERATION,8,4,4,0,2,0,2,0,6,4,2,0
GWADAR,DISTRICT,60 - 64,WIDOWED,609,515,94,0,230,192,38,0,379,323,56,0
GWADAR,DISTRICT,65 - 69,DIVORCED,12,8,4,0,4,3,1,0,8,5,3,0
GWADAR,DISTRICT,65 - 69,MARRIED,2844,1088,1756,0,1287,525,762,0,1557,563,994,0
GWADAR,DISTRICT,65 - 69,NEVER MARRIED,51,17,33,1,15,5,10,0,36,12,23,1
GWADAR,DISTRICT,65 - 69,SEPERATION,7,5,2,0,3,2,1,0,4,3,1,0
GWADAR,DISTRICT,65 - 69,WIDOWED,623,528,95,0,248,214,34,0,375,314,61,0
GWADAR,DISTRICT,70 - 74,DIVORCED,5,4,1,0,1,1,0,0,4,3,1,0
GWADAR,DISTRICT,70 - 74,MARRIED,1980,671,1309,0,1024,364,660,0,956,307,649,0
GWADAR,DISTRICT,70 - 74,NEVER MARRIED,30,8,22,0,6,1,5,0,24,7,17,0
GWADAR,DISTRICT,70 - 74,SEPERATION,4,2,2,0,3,2,1,0,1,0,1,0
GWADAR,DISTRICT,70 - 74,WIDOWED,603,515,88,0,280,241,39,0,323,274,49,0
GWADAR,DISTRICT,75 & ABOVE,DIVORCED,1,0,1,0,1,0,1,0,0,0,0,0
GWADAR,DISTRICT,75 & ABOVE,MARRIED,1891,550,1341,0,1116,328,788,0,775,222,553,0
GWADAR,DISTRICT,75 & ABOVE,NEVER MARRIED,49,10,39,0,1,0,1,0,48,10,38,0
GWADAR,DISTRICT,75 & ABOVE,SEPERATION,5,4,1,0,2,2,0,0,3,2,1,0
GWADAR,DISTRICT,75 & ABOVE,WIDOWED,768,617,151,0,444,357,87,0,324,260,64,0
HARNAI,DISTRICT,15 &  ABOVE,DIVORCED,30,22,8,0,24,18,6,0,6,4,2,0
HARNAI,DISTRICT,15 &  ABOVE,MARRIED,37274,18314,18960,0,27243,13465,13778,0,10031,4849,5182,0
HARNAI,DISTRICT,15 &  ABOVE,NEVER MARRIED,16994,7108,9883,3,12301,5211,7088,2,4693,1897,2795,1
HARNAI,DISTRICT,15 &  ABOVE,SEPERATION,26,12,14,0,20,11,9,0,6,1,5,0
HARNAI,DISTRICT,15 &  ABOVE,WIDOWED,867,719,148,0,654,548,106,0,213,171,42,0
HARNAI,DISTRICT,15 - 19,DIVORCED,1,1,0,0,1,1,0,0,0,0,0,0
HARNAI,DISTRICT,15 - 19,MARRIED,1624,993,631,0,1250,771,479,0,374,222,152,0
HARNAI,DISTRICT,15 - 19,NEVER MARRIED,9806,4265,5540,1,7355,3249,4106,0,2451,1016,1434,1
HARNAI,DISTRICT,15 - 19,SEPERATION,2,0,2,0,1,0,1,0,1,0,1,0
HARNAI,DISTRICT,15 - 19,WIDOWED,2,0,2,0,2,0,2,0,0,0,0,0
HARNAI,DISTRICT,20 - 24,DIVORCED,3,2,1,0,3,2,1,0,0,0,0,0
HARNAI,DISTRICT,20 - 24,MARRIED,4249,2326,1923,0,2969,1628,1341,0,1280,698,582,0
HARNAI,DISTRICT,20 - 24,NEVER MARRIED,3987,1640,2346,1,2807,1168,1638,1,1180,472,708,0
HARNAI,DISTRICT,20 - 24,SEPERATION,4,1,3,0,4,1,3,0,0,0,0,0
HARNAI,DISTRICT,20 - 24,WIDOWED,10,6,4,0,6,3,3,0,4,3,1,0
HARNAI,DISTRICT,25 - 29,DIVORCED,2,2,0,0,2,2,0,0,0,0,0,0
HARNAI,DISTRICT,25 - 29,MARRIED,5088,2542,2546,0,3568,1788,1780,0,1520,754,766,0
HARNAI,DISTRICT,25 - 29,NEVER MARRIED,1562,588,974,0,1015,372,643,0,547,216,331,0
HARNAI,DISTRICT,25 - 29,SEPERATION,3,2,1,0,3,2,1,0,0,0,0,0
HARNAI,DISTRICT,25 - 29,WIDOWED,8,6,2,0,7,5,2,0,1,1,0,0
HARNAI,DISTRICT,30 - 34,DIVORCED,8,6,2,0,7,5,2,0,1,1,0,0
HARNAI,DISTRICT,30 - 34,MARRIED,5538,2940,2598,0,4012,2122,1890,0,1526,818,708,0
HARNAI,DISTRICT,30 - 34,NEVER MARRIED,796,348,448,0,538,241,297,0,258,107,151,0
HARNAI,DISTRICT,30 - 34,SEPERATION,2,2,0,0,2,2,0,0,0,0,0,0
HARNAI,DISTRICT,30 - 34,WIDOWED,22,19,3,0,17,15,2,0,5,4,1,0
HARNAI,DISTRICT,35 - 39,DIVORCED,4,4,0,0,4,4,0,0,0,0,0,0
HARNAI,DISTRICT,35 - 39,MARRIED,5233,2622,2611,0,3819,1948,1871,0,1414,674,740,0
HARNAI,DISTRICT,35 - 39,NEVER MARRIED,390,129,261,0,257,83,174,0,133,46,87,0
HARNAI,DISTRICT,35 - 39,SEPERATION,4,2,2,0,2,2,0,0,2,0,2,0
HARNAI,DISTRICT,35 - 39,WIDOWED,29,25,4,0,23,21,2,0,6,4,2,0
HARNAI,DISTRICT,40 - 44,DIVORCED,6,2,4,0,3,1,2,0,3,1,2,0
HARNAI,DISTRICT,40 - 44,MARRIED,4439,2030,2409,0,3251,1508,1743,0,1188,522,666,0
HARNAI,DISTRICT,40 - 44,NEVER MARRIED,213,74,139,0,155,54,101,0,58,20,38,0
HARNAI,DISTRICT,40 - 44,SEPERATION,5,4,1,0,3,3,0,0,2,1,1,0
HARNAI,DISTRICT,40 - 44,WIDOWED,48,36,12,0,30,21,9,0,18,15,3,0
HARNAI,DISTRICT,45 - 49,DIVORCED,2,2,0,0,1,1,0,0,1,1,0,0
HARNAI,DISTRICT,45 - 49,MARRIED,3033,1444,1589,0,2236,1096,1140,0,797,348,449,0
HARNAI,DISTRICT,45 - 49,NEVER MARRIED,129,39,89,1,101,28,72,1,28,11,17,0
HARNAI,DISTRICT,45 - 49,SEPERATION,2,1,1,0,2,1,1,0,0,0,0,0
HARNAI,DISTRICT,45 - 49,WIDOWED,50,40,10,0,37,30,7,0,13,10,3,0
HARNAI,DISTRICT,50 - 54,DIVORCED,0,0,0,0,0,0,0,0,0,0,0,0
HARNAI,DISTRICT,50 - 54,MARRIED,2661,1209,1452,0,2001,917,1084,0,660,292,368,0
HARNAI,DISTRICT,50 - 54,NEVER MARRIED,48,13,35,0,38,10,28,0,10,3,7,0
HARNAI,DISTRICT,50 - 54,SEPERATION,2,0,2,0,2,0,2,0,0,0,0,0
HARNAI,DISTRICT,50 - 54,WIDOWED,81,72,9,0,63,56,7,0,18,16,2,0
HARNAI,DISTRICT,55 - 59,DIVORCED,1,1,0,0,0,0,0,0,1,1,0,0
HARNAI,DISTRICT,55 - 59,MARRIED,1762,772,990,0,1343,585,758,0,419,187,232,0
HARNAI,DISTRICT,55 - 59,NEVER MARRIED,20,5,15,0,13,2,11,0,7,3,4,0
HARNAI,DISTRICT,55 - 59,SEPERATION,0,0,0,0,0,0,0,0,0,0,0,0
HARNAI,DISTRICT,55 - 59,WIDOWED,98,80,18,0,70,59,11,0,28,21,7,0
HARNAI,DISTRICT,60 - 64,DIVORCED,2,2,0,0,2,2,0,0,0,0,0,0
HARNAI,DISTRICT,60 - 64,MARRIED,1455,599,856,0,1110,459,651,0,345,140,205,0
HARNAI,DISTRICT,60 - 64,NEVER MARRIED,22,3,19,0,10,2,8,0,12,1,11,0
HARNAI,DISTRICT,60 - 64,SEPERATION,0,0,0,0,0,0,0,0,0,0,0,0
HARNAI,DISTRICT,60 - 64,WIDOWED,117,96,21,0,90,73,17,0,27,23,4,0
HARNAI,DISTRICT,65 - 69,DIVORCED,0,0,0,0,0,0,0,0,0,0,0,0
HARNAI,DISTRICT,65 - 69,MARRIED,981,384,597,0,749,298,451,0,232,86,146,0
HARNAI,DISTRICT,65 - 69,NEVER MARRIED,6,2,4,0,4,1,3,0,2,1,1,0
HARNAI,DISTRICT,65 - 69,SEPERATION,0,0,0,0,0,0,0,0,0,0,0,0
HARNAI,DISTRICT,65 - 69,WIDOWED,119,105,14,0,94,85,9,0,25,20,5,0
HARNAI,DISTRICT,70 - 74,DIVORCED,1,0,1,0,1,0,1,0,0,0,0,0
HARNAI,DISTRICT,70 - 74,MARRIED,630,230,400,0,486,178,308,0,144,52,92,0
HARNAI,DISTRICT,70 - 74,NEVER MARRIED,6,1,5,0,2,0,2,0,4,1,3,0
HARNAI,DISTRICT,70 - 74,SEPERATION,2,0,2,0,1,0,1,0,1,0,1,0
HARNAI,DISTRICT,70 - 74,WIDOWED,137,119,18,0,105,92,13,0,32,27,5,0
HARNAI,DISTRICT,75 & ABOVE,DIVORCED,0,0,0,0,0,0,0,0,0,0,0,0
HARNAI,DISTRICT,75 & ABOVE,MARRIED,581,223,358,0,449,167,282,0,132,56,76,0
HARNAI,DISTRICT,75 & ABOVE,NEVER MARRIED,9,1,8,0,6,1,5,0,3,0,3,0
HARNAI,DISTRICT,75 & ABOVE,SEPERATION,0,0,0,0,0,0,0,0,0,0,0,0
HARNAI,DISTRICT,75 & ABOVE,WIDOWED,146,115,31,0,110,88,22,0,36,27,9,0
JAFFARABAD,DISTRICT,15 &  ABOVE,DIVORCED,213,161,52,0,137,106,31,0,76,55,21,0
JAFFARABAD,DISTRICT,15 &  ABOVE,MARRIED,196322,99086,97236,0,143301,72743,70558,0,53021,26343,26678,0
JAFFARABAD,DISTRICT,15 &  ABOVE,NEVER MARRIED,81540,35188,46342,10,52967,22337,30628,2,28573,12851,15714,8
JAFFARABAD,DISTRICT,15 &  ABOVE,SEPERATION,267,114,153,0,214,86,128,0,53,28,25,0
JAFFARABAD,DISTRICT,15 &  ABOVE,WIDOWED,10276,8149,2127,0,7037,5456,1581,0,3239,2693,546,0
JAFFARABAD,DISTRICT,15 - 19,DIVORCED,9,5,4,0,9,5,4,0,0,0,0,0
JAFFARABAD,DISTRICT,15 - 19,MARRIED,10941,6545,4396,0,8492,5100,3392,0,2449,1445,1004,0
JAFFARABAD,DISTRICT,15 - 19,NEVER MARRIED,50769,23104,27663,2,34496,15585,18910,1,16273,7519,8753,1
JAFFARABAD,DISTRICT,15 - 19,SEPERATION,32,5,27,0,29,3,26,0,3,2,1,0
JAFFARABAD,DISTRICT,15 - 19,WIDOWED,38,22,16,0,28,16,12,0,10,6,4,0
JAFFARABAD,DISTRICT,20 - 24,DIVORCED,22,15,7,0,12,8,4,0,10,7,3,0
JAFFARABAD,DISTRICT,20 - 24,MARRIED,29327,16908,12419,0,22195,12738,9457,0,7132,4170,2962,0
JAFFARABAD,DISTRICT,20 - 24,NEVER MARRIED,18335,6925,11409,1,11194,3998,7195,1,7141,2927,4214,0
JAFFARABAD,DISTRICT,20 - 24,SEPERATION,28,8,20,0,24,5,19,0,4,3,1,0
JAFFARABAD,DISTRICT,20 - 24,WIDOWED,106,55,51,0,82,38,44,0,24,17,7,0
JAFFARABAD,DISTRICT,25 - 29,DIVORCED,33,24,9,0,19,13,6,0,14,11,3,0
JAFFARABAD,DISTRICT,25 - 29,MARRIED,26895,13743,13152,0,19612,10075,9537,0,7283,3668,3615,0
JAFFARABAD,DISTRICT,25 - 29,NEVER MARRIED,6742,2918,3823,1,3760,1495,2265,0,2982,1423,1558,1
JAFFARABAD,DISTRICT,25 - 29,SEPERATION,34,10,24,0,26,7,19,0,8,3,5,0
JAFFARABAD,DISTRICT,25 - 29,WIDOWED,219,137,82,0,152,94,58,0,67,43,24,0
JAFFARABAD,DISTRICT,30 - 34,DIVORCED,42,32,10,0,26,22,4,0,16,10,6,0
JAFFARABAD,DISTRICT,30 - 34,MARRIED,26387,13646,12741,0,18899,9859,9040,0,7488,3787,3701,0
JAFFARABAD,DISTRICT,30 - 34,NEVER MARRIED,2815,1249,1566,0,1599,647,952,0,1216,602,614,0
JAFFARABAD,DISTRICT,30 - 34,SEPERATION,28,9,19,0,21,8,13,0,7,1,6,0
JAFFARABAD,DISTRICT,30 - 34,WIDOWED,331,224,107,0,240,160,80,0,91,64,27,0
JAFFARABAD,DISTRICT,35 - 39,DIVORCED,31,26,5,0,18,17,1,0,13,9,4,0
JAFFARABAD,DISTRICT,35 - 39,MARRIED,25316,12962,12354,0,18089,9373,8716,0,7227,3589,3638,0
JAFFARABAD,DISTRICT,35 - 39,NEVER MARRIED,1369,481,885,3,847,276,571,0,522,205,314,3
JAFFARABAD,DISTRICT,35 - 39,SEPERATION,29,16,13,0,21,11,10,0,8,5,3,0
JAFFARABAD,DISTRICT,35 - 39,WIDOWED,588,443,145,0,431,321,110,0,157,122,35,0
JAFFARABAD,DISTRICT,40 - 44,DIVORCED,21,19,2,0,15,13,2,0,6,6,0,0
JAFFARABAD,DISTRICT,40 - 44,MARRIED,25010,12158,12852,0,17984,8701,9283,0,7026,3457,3569,0
JAFFARABAD,DISTRICT,40 - 44,NEVER MARRIED,664,248,415,1,457,146,311,0,207,102,104,1
JAFFARABAD,DISTRICT,40 - 44,SEPERATION,24,17,7,0,20,14,6,0,4,3,1,0
JAFFARABAD,DISTRICT,40 - 44,WIDOWED,804,638,166,0,549,424,125,0,255,214,41,0
JAFFARABAD,DISTRICT,45 - 49,DIVORCED,21,16,5,0,15,10,5,0,6,6,0,0
JAFFARABAD,DISTRICT,45 - 49,MARRIED,15944,7122,8822,0,11362,5049,6313,0,4582,2073,2509,0
JAFFARABAD,DISTRICT,45 - 49,NEVER MARRIED,392,119,273,0,280,85,195,0,112,34,78,0
JAFFARABAD,DISTRICT,45 - 49,SEPERATION,29,14,15,0,22,10,12,0,7,4,3,0
JAFFARABAD,DISTRICT,45 - 49,WIDOWED,885,703,182,0,588,461,127,0,297,242,55,0
JAFFARABAD,DISTRICT,50 - 54,DIVORCED,13,7,6,0,8,4,4,0,5,3,2,0
JAFFARABAD,DISTRICT,50 - 54,MARRIED,12619,6091,6528,0,9033,4407,4626,0,3586,1684,1902,0
JAFFARABAD,DISTRICT,50 - 54,NEVER MARRIED,186,64,122,0,134,45,89,0,52,19,33,0
JAFFARABAD,DISTRICT,50 - 54,SEPERATION,20,13,7,0,17,10,7,0,3,3,0,0
JAFFARABAD,DISTRICT,50 - 54,WIDOWED,1156,942,214,0,795,637,158,0,361,305,56,0
JAFFARABAD,DISTRICT,55 - 59,DIVORCED,9,8,1,0,7,7,0,0,2,1,1,0
JAFFARABAD,DISTRICT,55 - 59,MARRIED,8434,3607,4827,0,6094,2655,3439,0,2340,952,1388,0
JAFFARABAD,DISTRICT,55 - 59,NEVER MARRIED,104,34,69,1,83,25,58,0,21,9,11,1
JAFFARABAD,DISTRICT,55 - 59,SEPERATION,15,8,7,0,11,5,6,0,4,3,1,0
JAFFARABAD,DISTRICT,55 - 59,WIDOWED,1182,927,255,0,796,608,188,0,386,319,67,0
JAFFARABAD,DISTRICT,60 - 64,DIVORCED,6,5,1,0,5,4,1,0,1,1,0,0
JAFFARABAD,DISTRICT,60 - 64,MARRIED,6676,2938,3738,0,4916,2199,2717,0,1760,739,1021,0
JAFFARABAD,DISTRICT,60 - 64,NEVER MARRIED,64,19,45,0,52,16,36,0,12,3,9,0
JAFFARABAD,DISTRICT,60 - 64,SEPERATION,11,5,6,0,8,4,4,0,3,1,2,0
JAFFARABAD,DISTRICT,60 - 64,WIDOWED,1340,1126,214,0,907,739,168,0,433,387,46,0
JAFFARABAD,DISTRICT,65 - 69,DIVORCED,3,2,1,0,2,2,0,0,1,0,1,0
JAFFARABAD,DISTRICT,65 - 69,MARRIED,4060,1679,2381,0,2992,1267,1725,0,1068,412,656,0
JAFFARABAD,DISTRICT,65 - 69,NEVER MARRIED,57,11,46,0,36,8,28,0,21,3,18,0
JAFFARABAD,DISTRICT,65 - 69,SEPERATION,7,2,5,0,6,2,4,0,1,0,1,0
JAFFARABAD,DISTRICT,65 - 69,WIDOWED,1145,920,225,0,745,586,159,0,400,334,66,0
JAFFARABAD,DISTRICT,70 - 74,DIVORCED,1,1,0,0,1,1,0,0,0,0,0,0
JAFFARABAD,DISTRICT,70 - 74,MARRIED,2687,1029,1658,0,2080,808,1272,0,607,221,386,0
JAFFARABAD,DISTRICT,70 - 74,NEVER MARRIED,24,7,17,0,17,6,11,0,7,1,6,0
JAFFARABAD,DISTRICT,70 - 74,SEPERATION,6,4,2,0,6,4,2,0,0,0,0,0
JAFFARABAD,DISTRICT,70 - 74,WIDOWED,1183,981,202,0,801,654,147,0,382,327,55,0
JAFFARABAD,DISTRICT,75 & ABOVE,DIVORCED,2,1,1,0,0,0,0,0,2,1,1,0
JAFFARABAD,DISTRICT,75 & ABOVE,MARRIED,2026,658,1368,0,1553,512,1041,0,473,146,327,0
JAFFARABAD,DISTRICT,75 & ABOVE,NEVER MARRIED,19,9,9,1,12,5,7,0,7,4,2,1
JAFFARABAD,DISTRICT,75 & ABOVE,SEPERATION,4,3,1,0,3,3,0,0,1,0,1,0
JAFFARABAD,DISTRICT,75 & ABOVE,WIDOWED,1299,1031,268,0,923,718,205,0,376,313,63,0
JHAL MAGSI,DISTRICT,15 &  ABOVE,DIVORCED,44,34,10,0,36,28,8,0,8,6,2,0
JHAL MAGSI,DISTRICT,15 &  ABOVE,MARRIED,71200,36130,35070,0,62031,31498,30533,0,9169,4632,4537,0
JHAL MAGSI,DISTRICT,15 &  ABOVE,NEVER MARRIED,27123,11471,15639,13,22992,9304,13677,11,4131,2167,1962,2
JHAL MAGSI,DISTRICT,15 &  ABOVE,SEPERATION,88,48,40,0,76,41,35,0,12,7,5,0
JHAL MAGSI,DISTRICT,15 &  ABOVE,WIDOWED,2414,1904,510,0,2024,1588,436,0,390,316,74,0
JHAL MAGSI,DISTRICT,15 - 19,DIVORCED,2,1,1,0,2,1,1,0,0,0,0,0
JHAL MAGSI,DISTRICT,15 - 19,MARRIED,4445,2613,1832,0,3956,2308,1648,0,489,305,184,0
JHAL MAGSI,DISTRICT,15 - 19,NEVER MARRIED,17491,7836,9650,5,15219,6587,8627,5,2272,1249,1023,0
JHAL MAGSI,DISTRICT,15 - 19,SEPERATION,4,1,3,0,2,1,1,0,2,0,2,0
JHAL MAGSI,DISTRICT,15 - 19,WIDOWED,13,4,9,0,13,4,9,0,0,0,0,0
JHAL MAGSI,DISTRICT,20 - 24,DIVORCED,6,6,0,0,4,4,0,0,2,2,0,0
JHAL MAGSI,DISTRICT,20 - 24,MARRIED,10465,5954,4511,0,9184,5212,3972,0,1281,742,539,0
JHAL MAGSI,DISTRICT,20 - 24,NEVER MARRIED,6017,2245,3767,5,4934,1698,3231,5,1083,547,536,0
JHAL MAGSI,DISTRICT,20 - 24,SEPERATION,7,4,3,0,6,3,3,0,1,1,0,0
JHAL MAGSI,DISTRICT,20 - 24,WIDOWED,43,26,17,0,38,22,16,0,5,4,1,0
JHAL MAGSI,DISTRICT,25 - 29,DIVORCED,11,7,4,0,7,4,3,0,4,3,1,0
JHAL MAGSI,DISTRICT,25 - 29,MARRIED,10257,5409,4848,0,8735,4566,4169,0,1522,843,679,0
JHAL MAGSI,DISTRICT,25 - 29,NEVER MARRIED,2030,749,1281,0,1598,546,1052,0,432,203,229,0
JHAL MAGSI,DISTRICT,25 - 29,SEPERATION,12,6,6,0,10,6,4,0,2,0,2,0
JHAL MAGSI,DISTRICT,25 - 29,WIDOWED,60,36,24,0,53,31,22,0,7,5,2,0
JHAL MAGSI,DISTRICT,30 - 34,DIVORCED,4,4,0,0,4,4,0,0,0,0,0,0
JHAL MAGSI,DISTRICT,30 - 34,MARRIED,8985,4667,4318,0,7743,4075,3668,0,1242,592,650,0
JHAL MAGSI,DISTRICT,30 - 34,NEVER MARRIED,680,259,421,0,509,184,325,0,171,75,96,0
JHAL MAGSI,DISTRICT,30 - 34,SEPERATION,8,3,5,0,7,2,5,0,1,1,0,0
JHAL MAGSI,DISTRICT,30 - 34,WIDOWED,95,68,27,0,79,54,25,0,16,14,2,0
JHAL MAGSI,DISTRICT,35 - 39,DIVORCED,7,6,1,0,6,5,1,0,1,1,0,0
JHAL MAGSI,DISTRICT,35 - 39,MARRIED,8972,4628,4344,0,7847,4064,3783,0,1125,564,561,0
JHAL MAGSI,DISTRICT,35 - 39,NEVER MARRIED,490,212,277,1,401,168,232,1,89,44,45,0
JHAL MAGSI,DISTRICT,35 - 39,SEPERATION,13,5,8,0,12,4,8,0,1,1,0,0
JHAL MAGSI,DISTRICT,35 - 39,WIDOWED,131,95,36,0,116,84,32,0,15,11,4,0
JHAL MAGSI,DISTRICT,40 - 44,DIVORCED,5,3,2,0,5,3,2,0,0,0,0,0
JHAL MAGSI,DISTRICT,40 - 44,MARRIED,8122,4104,4018,0,7163,3620,3543,0,959,484,475,0
JHAL MAGSI,DISTRICT,40 - 44,NEVER MARRIED,187,80,105,2,151,62,89,0,36,18,16,2
JHAL MAGSI,DISTRICT,40 - 44,SEPERATION,8,4,4,0,8,4,4,0,0,0,0,0
JHAL MAGSI,DISTRICT,40 - 44,WIDOWED,167,129,38,0,146,110,36,0,21,19,2,0
JHAL MAGSI,DISTRICT,45 - 49,DIVORCED,2,1,1,0,1,1,0,0,1,0,1,0
JHAL MAGSI,DISTRICT,45 - 49,MARRIED,6298,2962,3336,0,5539,2591,2948,0,759,371,388,0
JHAL MAGSI,DISTRICT,45 - 49,NEVER MARRIED,84,36,48,0,64,24,40,0,20,12,8,0
JHAL MAGSI,DISTRICT,45 - 49,SEPERATION,14,11,3,0,12,9,3,0,2,2,0,0
JHAL MAGSI,DISTRICT,45 - 49,WIDOWED,216,171,45,0,184,144,40,0,32,27,5,0
JHAL MAGSI,DISTRICT,50 - 54,DIVORCED,3,3,0,0,3,3,0,0,0,0,0,0
JHAL MAGSI,DISTRICT,50 - 54,MARRIED,4878,2276,2602,0,4220,1971,2249,0,658,305,353,0
JHAL MAGSI,DISTRICT,50 - 54,NEVER MARRIED,39,18,21,0,27,12,15,0,12,6,6,0
JHAL MAGSI,DISTRICT,50 - 54,SEPERATION,6,4,2,0,6,4,2,0,0,0,0,0
JHAL MAGSI,DISTRICT,50 - 54,WIDOWED,274,220,54,0,227,186,41,0,47,34,13,0
JHAL MAGSI,DISTRICT,55 - 59,DIVORCED,2,2,0,0,2,2,0,0,0,0,0,0
JHAL MAGSI,DISTRICT,55 - 59,MARRIED,3221,1384,1837,0,2738,1206,1532,0,483,178,305,0
JHAL MAGSI,DISTRICT,55 - 59,NEVER MARRIED,32,15,17,0,24,9,15,0,8,6,2,0
JHAL MAGSI,DISTRICT,55 - 59,SEPERATION,4,2,2,0,4,2,2,0,0,0,0,0
JHAL MAGSI,DISTRICT,55 - 59,WIDOWED,235,199,36,0,186,157,29,0,49,42,7,0
JHAL MAGSI,DISTRICT,60 - 64,DIVORCED,1,0,1,0,1,0,1,0,0,0,0,0
JHAL MAGSI,DISTRICT,60 - 64,MARRIED,2410,976,1434,0,2137,872,1265,0,273,104,169,0
JHAL MAGSI,DISTRICT,60 - 64,NEVER MARRIED,52,11,41,0,47,7,40,0,5,4,1,0
JHAL MAGSI,DISTRICT,60 - 64,SEPERATION,2,2,0,0,1,1,0,0,1,1,0,0
JHAL MAGSI,DISTRICT,60 - 64,WIDOWED,304,250,54,0,255,211,44,0,49,39,10,0
JHAL MAGSI,DISTRICT,65 - 69,DIVORCED,1,1,0,0,1,1,0,0,0,0,0,0
JHAL MAGSI,DISTRICT,65 - 69,MARRIED,1461,604,857,0,1284,530,754,0,177,74,103,0
JHAL MAGSI,DISTRICT,65 - 69,NEVER MARRIED,14,7,7,0,12,5,7,0,2,2,0,0
JHAL MAGSI,DISTRICT,65 - 69,SEPERATION,2,1,1,0,1,0,1,0,1,1,0,0
JHAL MAGSI,DISTRICT,65 - 69,WIDOWED,244,191,53,0,206,160,46,0,38,31,7,0
JHAL MAGSI,DISTRICT,70 - 74,DIVORCED,0,0,0,0,0,0,0,0,0,0,0,0
JHAL MAGSI,DISTRICT,70 - 74,MARRIED,959,331,628,0,833,286,547,0,126,45,81,0
JHAL MAGSI,DISTRICT,70 - 74,NEVER MARRIED,5,3,2,0,4,2,2,0,1,1,0,0
JHAL MAGSI,DISTRICT,70 - 74,SEPERATION,4,3,1,0,3,3,0,0,1,0,1,0
JHAL MAGSI,DISTRICT,70 - 74,WIDOWED,266,217,49,0,225,183,42,0,41,34,7,0
JHAL MAGSI,DISTRICT,75 & ABOVE,DIVORCED,0,0,0,0,0,0,0,0,0,0,0,0
JHAL MAGSI,DISTRICT,75 & ABOVE,MARRIED,727,222,505,0,652,197,455,0,75,25,50,0
JHAL MAGSI,DISTRICT,75 & ABOVE,NEVER MARRIED,2,0,2,0,2,0,2,0,0,0,0,0
JHAL MAGSI,DISTRICT,75 & ABOVE,SEPERATION,4,2,2,0,4,2,2,0,0,0,0,0
JHAL MAGSI,DISTRICT,75 & ABOVE,WIDOWED,366,298,68,0,296,242,54,0,70,56,14,0
KACHHI,DISTRICT,15 &  ABOVE,DIVORCED,218,168,50,0,194,149,45,0,24,19,5,0
KACHHI,DISTRICT,15 &  ABOVE,MARRIED,121147,62092,59055,0,100912,51865,49047,0,20235,10227,10008,0
KACHHI,DISTRICT,15 &  ABOVE,NEVER MARRIED,76297,31710,44561,26,59914,24634,35260,20,16383,7076,9301,6
KACHHI,DISTRICT,15 &  ABOVE,SEPERATION,180,127,53,0,166,119,47,0,14,8,6,0
KACHHI,DISTRICT,15 &  ABOVE,WIDOWED,4766,3850,916,0,3714,2977,737,0,1052,873,179,0
KACHHI,DISTRICT,15 - 19,DIVORCED,9,4,5,0,8,3,5,0,1,1,0,0
KACHHI,DISTRICT,15 - 19,MARRIED,5000,3020,1980,0,4270,2550,1720,0,730,470,260,0
KACHHI,DISTRICT,15 - 19,NEVER MARRIED,49994,21582,28397,15,40537,17241,23285,11,9457,4341,5112,4
KACHHI,DISTRICT,15 - 19,SEPERATION,11,4,7,0,10,3,7,0,1,1,0,0
KACHHI,DISTRICT,15 - 19,WIDOWED,19,6,13,0,19,6,13,0,0,0,0,0
KACHHI,DISTRICT,20 - 24,DIVORCED,17,10,7,0,16,9,7,0,1,1,0,0
KACHHI,DISTRICT,20 - 24,MARRIED,12471,7207,5264,0,10672,6100,4572,0,1799,1107,692,0
KACHHI,DISTRICT,20 - 24,NEVER MARRIED,14353,5796,8553,4,10669,4271,6394,4,3684,1525,2159,0
KACHHI,DISTRICT,20 - 24,SEPERATION,11,10,1,0,9,8,1,0,2,2,0,0
KACHHI,DISTRICT,20 - 24,WIDOWED,63,39,24,0,56,34,22,0,7,5,2,0
KACHHI,DISTRICT,25 - 29,DIVORCED,24,17,7,0,21,14,7,0,3,3,0,0
KACHHI,DISTRICT,25 - 29,MARRIED,16098,8774,7324,0,13460,7273,6187,0,2638,1501,1137,0
KACHHI,DISTRICT,25 - 29,NEVER MARRIED,5741,2130,3610,1,4013,1472,2541,0,1728,658,1069,1
KACHHI,DISTRICT,25 - 29,SEPERATION,9,5,4,0,9,5,4,0,0,0,0,0
KACHHI,DISTRICT,25 - 29,WIDOWED,151,114,37,0,143,109,34,0,8,5,3,0
KACHHI,DISTRICT,30 - 34,DIVORCED,46,37,9,0,41,33,8,0,5,4,1,0
KACHHI,DISTRICT,30 - 34,MARRIED,16841,9200,7641,0,13930,7597,6333,0,2911,1603,1308,0
KACHHI,DISTRICT,30 - 34,NEVER MARRIED,2641,934,1706,1,1905,664,1241,0,736,270,465,1
KACHHI,DISTRICT,30 - 34,SEPERATION,35,23,12,0,33,22,11,0,2,1,1,0
KACHHI,DISTRICT,30 - 34,WIDOWED,275,233,42,0,257,219,38,0,18,14,4,0
KACHHI,DISTRICT,35 - 39,DIVORCED,32,26,6,0,28,25,3,0,4,1,3,0
KACHHI,DISTRICT,35 - 39,MARRIED,16935,8794,8141,0,14013,7267,6746,0,2922,1527,1395,0
KACHHI,DISTRICT,35 - 39,NEVER MARRIED,1679,583,1096,0,1277,431,846,0,402,152,250,0
KACHHI,DISTRICT,35 - 39,SEPERATION,31,28,3,0,30,27,3,0,1,1,0,0
KACHHI,DISTRICT,35 - 39,WIDOWED,431,368,63,0,391,334,57,0,40,34,6,0
KACHHI,DISTRICT,40 - 44,DIVORCED,28,26,2,0,26,24,2,0,2,2,0,0
KACHHI,DISTRICT,40 - 44,MARRIED,15685,7989,7696,0,12832,6619,6213,0,2853,1370,1483,0
KACHHI,DISTRICT,40 - 44,NEVER MARRIED,904,327,577,0,729,272,457,0,175,55,120,0
KACHHI,DISTRICT,40 - 44,SEPERATION,21,13,8,0,21,13,8,0,0,0,0,0
KACHHI,DISTRICT,40 - 44,WIDOWED,503,424,79,0,428,366,62,0,75,58,17,0
KACHHI,DISTRICT,45 - 49,DIVORCED,27,23,4,0,23,19,4,0,4,4,0,0
KACHHI,DISTRICT,45 - 49,MARRIED,11279,5558,5721,0,9226,4623,4603,0,2053,935,1118,0
KACHHI,DISTRICT,45 - 49,NEVER MARRIED,476,162,312,2,379,132,245,2,97,30,67,0
KACHHI,DISTRICT,45 - 49,SEPERATION,19,12,7,0,16,12,4,0,3,0,3,0
KACHHI,DISTRICT,45 - 49,WIDOWED,402,328,74,0,324,261,63,0,78,67,11,0
KACHHI,DISTRICT,50 - 54,DIVORCED,10,5,5,0,9,5,4,0,1,0,1,0
KACHHI,DISTRICT,50 - 54,MARRIED,9286,4360,4926,0,7706,3661,4045,0,1580,699,881,0
KACHHI,DISTRICT,50 - 54,NEVER MARRIED,204,91,113,0,155,71,84,0,49,20,29,0
KACHHI,DISTRICT,50 - 54,SEPERATION,17,12,5,0,14,10,4,0,3,2,1,0
KACHHI,DISTRICT,50 - 54,WIDOWED,484,389,95,0,360,282,78,0,124,107,17,0
KACHHI,DISTRICT,55 - 59,DIVORCED,13,11,2,0,11,9,2,0,2,2,0,0
KACHHI,DISTRICT,55 - 59,MARRIED,6304,2730,3574,0,5197,2306,2891,0,1107,424,683,0
KACHHI,DISTRICT,55 - 59,NEVER MARRIED,119,44,75,0,90,32,58,0,29,12,17,0
KACHHI,DISTRICT,55 - 59,SEPERATION,8,6,2,0,8,6,2,0,0,0,0,0
KACHHI,DISTRICT,55 - 59,WIDOWED,406,324,82,0,287,221,66,0,119,103,16,0
KACHHI,DISTRICT,60 - 64,DIVORCED,7,6,1,0,6,5,1,0,1,1,0,0
KACHHI,DISTRICT,60 - 64,MARRIED,4607,1888,2719,0,3874,1625,2249,0,733,263,470,0
KACHHI,DISTRICT,60 - 64,NEVER MARRIED,79,24,54,1,67,18,48,1,12,6,6,0
KACHHI,DISTRICT,60 - 64,SEPERATION,4,3,1,0,4,3,1,0,0,0,0,0
KACHHI,DISTRICT,60 - 64,WIDOWED,541,432,109,0,397,311,86,0,144,121,23,0
KACHHI,DISTRICT,65 - 69,DIVORCED,1,0,1,0,1,0,1,0,0,0,0,0
KACHHI,DISTRICT,65 - 69,MARRIED,2914,1176,1738,0,2483,1014,1469,0,431,162,269,0
KACHHI,DISTRICT,65 - 69,NEVER MARRIED,65,22,43,0,56,18,38,0,9,4,5,0
KACHHI,DISTRICT,65 - 69,SEPERATION,6,6,0,0,6,6,0,0,0,0,0,0
KACHHI,DISTRICT,65 - 69,WIDOWED,457,375,82,0,311,247,64,0,146,128,18,0
KACHHI,DISTRICT,70 - 74,DIVORCED,2,1,1,0,2,1,1,0,0,0,0,0
KACHHI,DISTRICT,70 - 74,MARRIED,1921,731,1190,0,1639,636,1003,0,282,95,187,0
KACHHI,DISTRICT,70 - 74,NEVER MARRIED,23,8,15,0,19,6,13,0,4,2,2,0
KACHHI,DISTRICT,70 - 74,SEPERATION,5,4,1,0,3,3,0,0,2,1,1,0
KACHHI,DISTRICT,70 - 74,WIDOWED,476,386,90,0,336,276,60,0,140,110,30,0
KACHHI,DISTRICT,75 & ABOVE,DIVORCED,2,2,0,0,2,2,0,0,0,0,0,0
KACHHI,DISTRICT,75 & ABOVE,MARRIED,1806,665,1141,0,1610,594,1016,0,196,71,125,0
KACHHI,DISTRICT,75 & ABOVE,NEVER MARRIED,19,7,10,2,18,6,10,2,1,1,0,0
KACHHI,DISTRICT,75 & ABOVE,SEPERATION,3,1,2,0,3,1,2,0,0,0,0,0
KACHHI,DISTRICT,75 & ABOVE,WIDOWED,558,432,126,0,405,311,94,0,153,121,32,0
KALAT,DISTRICT,15 &  ABOVE,DIVORCED,71,55,16,0,62,46,16,0,9,9,0,0
KALAT,DISTRICT,15 &  ABOVE,MARRIED,83612,42596,41016,0,70970,36148,34822,0,12642,6448,6194,0
KALAT,DISTRICT,15 &  ABOVE,NEVER MARRIED,43747,18996,24747,4,35055,14982,20070,3,8692,4014,4677,1
KALAT,DISTRICT,15 &  ABOVE,SEPERATION,58,20,38,0,57,20,37,0,1,0,1,0
KALAT,DISTRICT,15 &  ABOVE,WIDOWED,2635,2047,588,0,2065,1569,496,0,570,478,92,0
KALAT,DISTRICT,15 - 19,DIVORCED,3,3,0,0,2,2,0,0,1,1,0,0
KALAT,DISTRICT,15 - 19,MARRIED,3093,1911,1182,0,2855,1761,1094,0,238,150,88,0
KALAT,DISTRICT,15 - 19,NEVER MARRIED,25924,12001,13922,1,21502,9870,11631,1,4422,2131,2291,0
KALAT,DISTRICT,15 - 19,SEPERATION,8,2,6,0,8,2,6,0,0,0,0,0
KALAT,DISTRICT,15 - 19,WIDOWED,10,5,5,0,8,4,4,0,2,1,1,0
KALAT,DISTRICT,20 - 24,DIVORCED,4,3,1,0,4,3,1,0,0,0,0,0
KALAT,DISTRICT,20 - 24,MARRIED,9375,5646,3729,0,8217,4884,3333,0,1158,762,396,0
KALAT,DISTRICT,20 - 24,NEVER MARRIED,10539,4216,6322,1,8263,3210,5052,1,2276,1006,1270,0
KALAT,DISTRICT,20 - 24,SEPERATION,4,1,3,0,4,1,3,0,0,0,0,0
KALAT,DISTRICT,20 - 24,WIDOWED,32,24,8,0,29,21,8,0,3,3,0,0
KALAT,DISTRICT,25 - 29,DIVORCED,10,9,1,0,9,8,1,0,1,1,0,0
KALAT,DISTRICT,25 - 29,MARRIED,12078,6571,5507,0,10418,5598,4820,0,1660,973,687,0
KALAT,DISTRICT,25 - 29,NEVER MARRIED,4258,1574,2684,0,3185,1109,2076,0,1073,465,608,0
KALAT,DISTRICT,25 - 29,SEPERATION,3,2,1,0,3,2,1,0,0,0,0,0
KALAT,DISTRICT,25 - 29,WIDOWED,62,39,23,0,50,29,21,0,12,10,2,0
KALAT,DISTRICT,30 - 34,DIVORCED,11,7,4,0,9,5,4,0,2,2,0,0
KALAT,DISTRICT,30 - 34,MARRIED,11414,6105,5309,0,9593,5123,4470,0,1821,982,839,0
KALAT,DISTRICT,30 - 34,NEVER MARRIED,1646,672,974,0,1144,444,700,0,502,228,274,0
KALAT,DISTRICT,30 - 34,SEPERATION,6,3,3,0,6,3,3,0,0,0,0,0
KALAT,DISTRICT,30 - 34,WIDOWED,85,63,22,0,69,50,19,0,16,13,3,0
KALAT,DISTRICT,35 - 39,DIVORCED,9,5,4,0,6,2,4,0,3,3,0,0
KALAT,DISTRICT,35 - 39,MARRIED,11353,5774,5579,0,9613,4901,4712,0,1740,873,867,0
KALAT,DISTRICT,35 - 39,NEVER MARRIED,728,270,458,0,538,191,347,0,190,79,111,0
KALAT,DISTRICT,35 - 39,SEPERATION,10,4,6,0,10,4,6,0,0,0,0,0
KALAT,DISTRICT,35 - 39,WIDOWED,144,116,28,0,120,95,25,0,24,21,3,0
KALAT,DISTRICT,40 - 44,DIVORCED,8,8,0,0,6,6,0,0,2,2,0,0
KALAT,DISTRICT,40 - 44,MARRIED,10174,5025,5149,0,8448,4165,4283,0,1726,860,866,0
KALAT,DISTRICT,40 - 44,NEVER MARRIED,326,140,186,0,198,79,119,0,128,61,67,0
KALAT,DISTRICT,40 - 44,SEPERATION,5,1,4,0,5,1,4,0,0,0,0,0
KALAT,DISTRICT,40 - 44,WIDOWED,209,169,40,0,162,127,35,0,47,42,5,0
KALAT,DISTRICT,45 - 49,DIVORCED,6,6,0,0,6,6,0,0,0,0,0,0
KALAT,DISTRICT,45 - 49,MARRIED,7185,3327,3858,0,6032,2817,3215,0,1153,510,643,0
KALAT,DISTRICT,45 - 49,NEVER MARRIED,140,56,84,0,90,30,60,0,50,26,24,0
KALAT,DISTRICT,45 - 49,SEPERATION,3,1,2,0,3,1,2,0,0,0,0,0
KALAT,DISTRICT,45 - 49,WIDOWED,187,144,43,0,155,121,34,0,32,23,9,0
KALAT,DISTRICT,50 - 54,DIVORCED,8,7,1,0,8,7,1,0,0,0,0,0
KALAT,DISTRICT,50 - 54,MARRIED,6296,3032,3264,0,5281,2574,2707,0,1015,458,557,0
KALAT,DISTRICT,50 - 54,NEVER MARRIED,60,23,37,0,42,16,26,0,18,7,11,0
KALAT,DISTRICT,50 - 54,SEPERATION,6,2,4,0,5,2,3,0,1,0,1,0
KALAT,DISTRICT,50 - 54,WIDOWED,311,258,53,0,232,188,44,0,79,70,9,0
KALAT,DISTRICT,55 - 59,DIVORCED,4,3,1,0,4,3,1,0,0,0,0,0
KALAT,DISTRICT,55 - 59,MARRIED,4530,2033,2497,0,3742,1698,2044,0,788,335,453,0
KALAT,DISTRICT,55 - 59,NEVER MARRIED,53,16,36,1,35,10,25,0,18,6,11,1
KALAT,DISTRICT,55 - 59,SEPERATION,2,0,2,0,2,0,2,0,0,0,0,0
KALAT,DISTRICT,55 - 59,WIDOWED,327,262,65,0,253,197,56,0,74,65,9,0
KALAT,DISTRICT,60 - 64,DIVORCED,4,3,1,0,4,3,1,0,0,0,0,0
KALAT,DISTRICT,60 - 64,MARRIED,3403,1409,1994,0,2821,1167,1654,0,582,242,340,0
KALAT,DISTRICT,60 - 64,NEVER MARRIED,32,11,21,0,24,8,16,0,8,3,5,0
KALAT,DISTRICT,60 - 64,SEPERATION,4,1,3,0,4,1,3,0,0,0,0,0
KALAT,DISTRICT,60 - 64,WIDOWED,329,267,62,0,264,209,55,0,65,58,7,0
KALAT,DISTRICT,65 - 69,DIVORCED,2,1,1,0,2,1,1,0,0,0,0,0
KALAT,DISTRICT,65 - 69,MARRIED,2018,831,1187,0,1659,677,982,0,359,154,205,0
KALAT,DISTRICT,65 - 69,NEVER MARRIED,24,9,14,1,19,9,9,1,5,0,5,0
KALAT,DISTRICT,65 - 69,SEPERATION,1,1,0,0,1,1,0,0,0,0,0,0
KALAT,DISTRICT,65 - 69,WIDOWED,318,253,65,0,244,192,52,0,74,61,13,0
KALAT,DISTRICT,70 - 74,DIVORCED,1,0,1,0,1,0,1,0,0,0,0,0
KALAT,DISTRICT,70 - 74,MARRIED,1395,462,933,0,1166,385,781,0,229,77,152,0
KALAT,DISTRICT,70 - 74,NEVER MARRIED,9,4,5,0,7,2,5,0,2,2,0,0
KALAT,DISTRICT,70 - 74,SEPERATION,3,1,2,0,3,1,2,0,0,0,0,0
KALAT,DISTRICT,70 - 74,WIDOWED,277,222,55,0,212,168,44,0,65,54,11,0
KALAT,DISTRICT,75 & ABOVE,DIVORCED,1,0,1,0,1,0,1,0,0,0,0,0
KALAT,DISTRICT,75 & ABOVE,MARRIED,1298,470,828,0,1125,398,727,0,173,72,101,0
KALAT,DISTRICT,75 & ABOVE,NEVER MARRIED,8,4,4,0,8,4,4,0,0,0,0,0
KALAT,DISTRICT,75 & ABOVE,SEPERATION,3,1,2,0,3,1,2,0,0,0,0,0
KALAT,DISTRICT,75 & ABOVE,WIDOWED,344,225,119,0,267,168,99,0,77,57,20,0
KECH,DISTRICT,15 &  ABOVE,DIVORCED,2042,1047,995,0,1494,826,668,0,548,221,327,0
KECH,DISTRICT,15 &  ABOVE,MARRIED,454138,222871,231267,0,296263,146035,150228,0,157875,76836,81039,0
KECH,DISTRICT,15 &  ABOVE,NEVER MARRIED,142587,57266,85207,114,88039,35643,52353,43,54548,21623,32854,71
KECH,DISTRICT,15 &  ABOVE,SEPERATION,1151,402,749,0,843,336,507,0,308,66,242,0
KECH,DISTRICT,15 &  ABOVE,WIDOWED,11985,7468,4517,0,8993,5803,3190,0,2992,1665,1327,0
KECH,DISTRICT,15 - 19,DIVORCED,71,29,42,0,53,21,32,0,18,8,10,0
KECH,DISTRICT,15 - 19,MARRIED,49979,29727,20252,0,35700,21002,14698,0,14279,8725,5554,0
KECH,DISTRICT,15 - 19,NEVER MARRIED,87388,36251,51096,41,53788,22625,31157,6,33600,13626,19939,35
KECH,DISTRICT,15 - 19,SEPERATION,101,17,84,0,64,15,49,0,37,2,35,0
KECH,DISTRICT,15 - 19,WIDOWED,113,47,66,0,84,39,45,0,29,8,21,0
KECH,DISTRICT,20 - 24,DIVORCED,160,91,69,0,120,76,44,0,40,15,25,0
KECH,DISTRICT,20 - 24,MARRIED,65253,36979,28274,0,44090,24974,19116,0,21163,12005,9158,0
KECH,DISTRICT,20 - 24,NEVER MARRIED,29514,10595,18891,28,18430,6627,11794,9,11084,3968,7097,19
KECH,DISTRICT,20 - 24,SEPERATION,104,39,65,0,72,34,38,0,32,5,27,0
KECH,DISTRICT,20 - 24,WIDOWED,237,116,121,0,190,97,93,0,47,19,28,0
KECH,DISTRICT,25 - 29,DIVORCED,260,126,134,0,181,101,80,0,79,25,54,0
KECH,DISTRICT,25 - 29,MARRIED,71186,36360,34826,0,47159,23696,23463,0,24027,12664,11363,0
KECH,DISTRICT,25 - 29,NEVER MARRIED,13474,5496,7968,10,8088,3279,4806,3,5386,2217,3162,7
KECH,DISTRICT,25 - 29,SEPERATION,142,55,87,0,105,45,60,0,37,10,27,0
KECH,DISTRICT,25 - 29,WIDOWED,444,233,211,0,354,199,155,0,90,34,56,0
KECH,DISTRICT,30 - 34,DIVORCED,271,151,120,0,190,115,75,0,81,36,45,0
KECH,DISTRICT,30 - 34,MARRIED,63170,31675,31495,0,40320,19984,20336,0,22850,11691,11159,0
KECH,DISTRICT,30 - 34,NEVER MARRIED,6237,3274,2954,9,3841,1996,1840,5,2396,1278,1114,4
KECH,DISTRICT,30 - 34,SEPERATION,158,60,98,0,109,43,66,0,49,17,32,0
KECH,DISTRICT,30 - 34,WIDOWED,553,346,207,0,396,267,129,0,157,79,78,0
KECH,DISTRICT,35 - 39,DIVORCED,301,180,121,0,220,145,75,0,81,35,46,0
KECH,DISTRICT,35 - 39,MARRIED,57030,26229,30801,0,35051,16086,18965,0,21979,10143,11836,0
KECH,DISTRICT,35 - 39,NEVER MARRIED,3109,901,2205,3,1970,570,1397,3,1139,331,808,0
KECH,DISTRICT,35 - 39,SEPERATION,163,70,93,0,123,60,63,0,40,10,30,0
KECH,DISTRICT,35 - 39,WIDOWED,785,518,267,0,598,412,186,0,187,106,81,0
KECH,DISTRICT,40 - 44,DIVORCED,275,143,132,0,216,117,99,0,59,26,33,0
KECH,DISTRICT,40 - 44,MARRIED,42926,19519,23407,0,26645,12124,14521,0,16281,7395,8886,0
KECH,DISTRICT,40 - 44,NEVER MARRIED,1232,350,878,4,849,248,599,2,383,102,279,2
KECH,DISTRICT,40 - 44,SEPERATION,116,45,71,0,90,37,53,0,26,8,18,0
KECH,DISTRICT,40 - 44,WIDOWED,903,576,327,0,730,487,243,0,173,89,84,0
KECH,DISTRICT,45 - 49,DIVORCED,237,115,122,0,174,87,87,0,63,28,35,0
KECH,DISTRICT,45 - 49,MARRIED,32113,13570,18543,0,19591,8633,10958,0,12522,4937,7585,0
KECH,DISTRICT,45 - 49,NEVER MARRIED,656,180,474,2,442,125,315,2,214,55,159,0
KECH,DISTRICT,45 - 49,SEPERATION,93,28,65,0,69,24,45,0,24,4,20,0
KECH,DISTRICT,45 - 49,WIDOWED,1004,643,361,0,784,499,285,0,220,144,76,0
KECH,DISTRICT,50 - 54,DIVORCED,139,72,67,0,99,54,45,0,40,18,22,0
KECH,DISTRICT,50 - 54,MARRIED,23382,10268,13114,0,14900,6743,8157,0,8482,3525,4957,0
KECH,DISTRICT,50 - 54,NEVER MARRIED,344,85,254,5,230,60,168,2,114,25,86,3
KECH,DISTRICT,50 - 54,SEPERATION,68,20,48,0,48,17,31,0,20,3,17,0
KECH,DISTRICT,50 - 54,WIDOWED,1254,868,386,0,931,664,267,0,323,204,119,0
KECH,DISTRICT,55 - 59,DIVORCED,118,55,63,0,83,39,44,0,35,16,19,0
KECH,DISTRICT,55 - 59,MARRIED,17219,7104,10115,0,10894,4677,6217,0,6325,2427,3898,0
KECH,DISTRICT,55 - 59,NEVER MARRIED,223,49,170,4,161,42,115,4,62,7,55,0
KECH,DISTRICT,55 - 59,SEPERATION,58,17,41,0,46,15,31,0,12,2,10,0
KECH,DISTRICT,55 - 59,WIDOWED,1213,795,418,0,862,589,273,0,351,206,145,0
KECH,DISTRICT,60 - 64,DIVORCED,78,36,42,0,58,30,28,0,20,6,14,0
KECH,DISTRICT,60 - 64,MARRIED,12470,4754,7716,0,8437,3360,5077,0,4033,1394,2639,0
KECH,DISTRICT,60 - 64,NEVER MARRIED,166,41,121,4,99,37,59,3,67,4,62,1
KECH,DISTRICT,60 - 64,SEPERATION,46,20,26,0,36,19,17,0,10,1,9,0
KECH,DISTRICT,60 - 64,WIDOWED,1249,825,424,0,944,629,315,0,305,196,109,0
KECH,DISTRICT,65 - 69,DIVORCED,53,20,33,0,41,16,25,0,12,4,8,0
KECH,DISTRICT,65 - 69,MARRIED,8501,3176,5325,0,5753,2240,3513,0,2748,936,1812,0
KECH,DISTRICT,65 - 69,NEVER MARRIED,123,21,99,3,53,16,34,3,70,5,65,0
KECH,DISTRICT,65 - 69,SEPERATION,29,13,16,0,22,11,11,0,7,2,5,0
KECH,DISTRICT,65 - 69,WIDOWED,1237,758,479,0,900,554,346,0,337,204,133,0
KECH,DISTRICT,70 - 74,DIVORCED,28,14,14,0,21,11,10,0,7,3,4,0
KECH,DISTRICT,70 - 74,MARRIED,5324,1816,3508,0,3739,1303,2436,0,1585,513,1072,0
KECH,DISTRICT,70 - 74,NEVER MARRIED,48,7,40,1,35,5,29,1,13,2,11,0
KECH,DISTRICT,70 - 74,SEPERATION,19,4,15,0,17,4,13,0,2,0,2,0
KECH,DISTRICT,70 - 74,WIDOWED,1108,726,382,0,856,579,277,0,252,147,105,0
KECH,DISTRICT,75 & ABOVE,DIVORCED,51,15,36,0,38,14,24,0,13,1,12,0
KECH,DISTRICT,75 & ABOVE,MARRIED,5585,1694,3891,0,3984,1213,2771,0,1601,481,1120,0
KECH,DISTRICT,75 & ABOVE,NEVER MARRIED,73,16,57,0,53,13,40,0,20,3,17,0
KECH,DISTRICT,75 & ABOVE,SEPERATION,54,14,40,0,42,12,30,0,12,2,10,0
KECH,DISTRICT,75 & ABOVE,WIDOWED,1885,1017,868,0,1364,788,576,0,521,229,292,0
KHARAN,DISTRICT,15 &  ABOVE,DIVORCED,145,114,31,0,117,89,28,0,28,25,3,0
KHARAN,DISTRICT,15 &  ABOVE,MARRIED,76578,38851,37727,0,51776,26453,25323,0,24802,12398,12404,0
KHARAN,DISTRICT,15 &  ABOVE,NEVER MARRIED,35470,15388,20073,9,22464,9959,12502,3,13006,5429,7571,6
KHARAN,DISTRICT,15 &  ABOVE,SEPERATION,141,104,37,0,107,84,23,0,34,20,14,0
KHARAN,DISTRICT,15 &  ABOVE,WIDOWED,1692,1378,314,0,1349,1097,252,0,343,281,62,0
KHARAN,DISTRICT,15 - 19,DIVORCED,3,2,1,0,2,2,0,0,1,0,1,0
KHARAN,DISTRICT,15 - 19,MARRIED,5957,3624,2333,0,4484,2731,1753,0,1473,893,580,0
KHARAN,DISTRICT,15 - 19,NEVER MARRIED,23393,9864,13524,5,15831,6745,9083,3,7562,3119,4441,2
KHARAN,DISTRICT,15 - 19,SEPERATION,11,5,6,0,5,2,3,0,6,3,3,0
KHARAN,DISTRICT,15 - 19,WIDOWED,9,5,4,0,7,5,2,0,2,0,2,0
KHARAN,DISTRICT,20 - 24,DIVORCED,14,12,2,0,12,10,2,0,2,2,0,0
KHARAN,DISTRICT,20 - 24,MARRIED,11070,6380,4690,0,7654,4383,3271,0,3416,1997,1419,0
KHARAN,DISTRICT,20 - 24,NEVER MARRIED,7083,3185,3896,2,4065,1936,2129,0,3018,1249,1767,2
KHARAN,DISTRICT,20 - 24,SEPERATION,11,8,3,0,7,5,2,0,4,3,1,0
KHARAN,DISTRICT,20 - 24,WIDOWED,30,22,8,0,24,17,7,0,6,5,1,0
KHARAN,DISTRICT,25 - 29,DIVORCED,20,17,3,0,16,14,2,0,4,3,1,0
KHARAN,DISTRICT,25 - 29,MARRIED,11964,6378,5586,0,7960,4234,3726,0,4004,2144,1860,0
KHARAN,DISTRICT,25 - 29,NEVER MARRIED,2824,1264,1559,1,1448,681,767,0,1376,583,792,1
KHARAN,DISTRICT,25 - 29,SEPERATION,12,7,5,0,10,5,5,0,2,2,0,0
KHARAN,DISTRICT,25 - 29,WIDOWED,68,53,15,0,53,38,15,0,15,15,0,0
KHARAN,DISTRICT,30 - 34,DIVORCED,25,17,8,0,20,12,8,0,5,5,0,0
KHARAN,DISTRICT,30 - 34,MARRIED,10690,5632,5058,0,6983,3719,3264,0,3707,1913,1794,0
KHARAN,DISTRICT,30 - 34,NEVER MARRIED,1207,592,615,0,599,321,278,0,608,271,337,0
KHARAN,DISTRICT,30 - 34,SEPERATION,28,19,9,0,22,17,5,0,6,2,4,0
KHARAN,DISTRICT,30 - 34,WIDOWED,72,54,18,0,61,46,15,0,11,8,3,0
KHARAN,DISTRICT,35 - 39,DIVORCED,23,17,6,0,19,14,5,0,4,3,1,0
KHARAN,DISTRICT,35 - 39,MARRIED,9511,4700,4811,0,6412,3196,3216,0,3099,1504,1595,0
KHARAN,DISTRICT,35 - 39,NEVER MARRIED,514,267,246,1,276,158,118,0,238,109,128,1
KHARAN,DISTRICT,35 - 39,SEPERATION,17,14,3,0,13,11,2,0,4,3,1,0
KHARAN,DISTRICT,35 - 39,WIDOWED,112,93,19,0,90,74,16,0,22,19,3,0
KHARAN,DISTRICT,40 - 44,DIVORCED,15,13,2,0,10,8,2,0,5,5,0,0
KHARAN,DISTRICT,40 - 44,MARRIED,7814,3714,4100,0,5241,2514,2727,0,2573,1200,1373,0
KHARAN,DISTRICT,40 - 44,NEVER MARRIED,211,111,100,0,113,59,54,0,98,52,46,0
KHARAN,DISTRICT,40 - 44,SEPERATION,12,8,4,0,11,8,3,0,1,0,1,0
KHARAN,DISTRICT,40 - 44,WIDOWED,139,119,20,0,109,93,16,0,30,26,4,0
KHARAN,DISTRICT,45 - 49,DIVORCED,11,11,0,0,9,9,0,0,2,2,0,0
KHARAN,DISTRICT,45 - 49,MARRIED,5833,2660,3173,0,3846,1776,2070,0,1987,884,1103,0
KHARAN,DISTRICT,45 - 49,NEVER MARRIED,99,53,46,0,56,27,29,0,43,26,17,0
KHARAN,DISTRICT,45 - 49,SEPERATION,16,14,2,0,14,13,1,0,2,1,1,0
KHARAN,DISTRICT,45 - 49,WIDOWED,153,138,15,0,130,122,8,0,23,16,7,0
KHARAN,DISTRICT,50 - 54,DIVORCED,13,11,2,0,10,8,2,0,3,3,0,0
KHARAN,DISTRICT,50 - 54,MARRIED,4574,2142,2432,0,3062,1444,1618,0,1512,698,814,0
KHARAN,DISTRICT,50 - 54,NEVER MARRIED,64,33,31,0,35,21,14,0,29,12,17,0
KHARAN,DISTRICT,50 - 54,SEPERATION,7,7,0,0,5,5,0,0,2,2,0,0
KHARAN,DISTRICT,50 - 54,WIDOWED,185,156,29,0,144,122,22,0,41,34,7,0
KHARAN,DISTRICT,55 - 59,DIVORCED,6,4,2,0,5,3,2,0,1,1,0,0
KHARAN,DISTRICT,55 - 59,MARRIED,3213,1435,1778,0,2094,947,1147,0,1119,488,631,0
KHARAN,DISTRICT,55 - 59,NEVER MARRIED,33,12,21,0,17,7,10,0,16,5,11,0
KHARAN,DISTRICT,55 - 59,SEPERATION,10,9,1,0,7,6,1,0,3,3,0,0
KHARAN,DISTRICT,55 - 59,WIDOWED,171,150,21,0,126,111,15,0,45,39,6,0
KHARAN,DISTRICT,60 - 64,DIVORCED,5,3,2,0,4,2,2,0,1,1,0,0
KHARAN,DISTRICT,60 - 64,MARRIED,2494,965,1529,0,1678,658,1020,0,816,307,509,0
KHARAN,DISTRICT,60 - 64,NEVER MARRIED,15,6,9,0,6,3,3,0,9,3,6,0
KHARAN,DISTRICT,60 - 64,SEPERATION,3,3,0,0,3,3,0,0,0,0,0,0
KHARAN,DISTRICT,60 - 64,WIDOWED,201,168,33,0,157,130,27,0,44,38,6,0
KHARAN,DISTRICT,65 - 69,DIVORCED,6,6,0,0,6,6,0,0,0,0,0,0
KHARAN,DISTRICT,65 - 69,MARRIED,1469,536,933,0,961,358,603,0,508,178,330,0
KHARAN,DISTRICT,65 - 69,NEVER MARRIED,17,0,17,0,10,0,10,0,7,0,7,0
KHARAN,DISTRICT,65 - 69,SEPERATION,6,4,2,0,4,3,1,0,2,1,1,0
KHARAN,DISTRICT,65 - 69,WIDOWED,154,123,31,0,125,101,24,0,29,22,7,0
KHARAN,DISTRICT,70 - 74,DIVORCED,2,1,1,0,2,1,1,0,0,0,0,0
KHARAN,DISTRICT,70 - 74,MARRIED,1016,357,659,0,729,261,468,0,287,96,191,0
KHARAN,DISTRICT,70 - 74,NEVER MARRIED,2,1,1,0,2,1,1,0,0,0,0,0
KHARAN,DISTRICT,70 - 74,SEPERATION,5,4,1,0,4,4,0,0,1,0,1,0
KHARAN,DISTRICT,70 - 74,WIDOWED,192,153,39,0,156,124,32,0,36,29,7,0
KHARAN,DISTRICT,75 & ABOVE,DIVORCED,2,0,2,0,2,0,2,0,0,0,0,0
KHARAN,DISTRICT,75 & ABOVE,MARRIED,973,328,645,0,672,232,440,0,301,96,205,0
KHARAN,DISTRICT,75 & ABOVE,NEVER MARRIED,8,0,8,0,6,0,6,0,2,0,2,0
KHARAN,DISTRICT,75 & ABOVE,SEPERATION,3,2,1,0,2,2,0,0,1,0,1,0
KHARAN,DISTRICT,75 & ABOVE,WIDOWED,206,144,62,0,167,114,53,0,39,30,9,0
KHUZDAR,DISTRICT,15 &  ABOVE,DIVORCED,516,382,134,0,357,268,89,0,159,114,45,0
KHUZDAR,DISTRICT,15 &  ABOVE,MARRIED,343016,173164,169852,0,230922,116698,114224,0,112094,56466,55628,0
KHUZDAR,DISTRICT,15 &  ABOVE,NEVER MARRIED,128152,50448,77673,31,68133,26120,41989,24,60019,24328,35684,7
KHUZDAR,DISTRICT,15 &  ABOVE,SEPERATION,474,150,324,0,352,99,253,0,122,51,71,0
KHUZDAR,DISTRICT,15 &  ABOVE,WIDOWED,8557,6712,1845,0,5771,4461,1310,0,2786,2251,535,0
KHUZDAR,DISTRICT,15 - 19,DIVORCED,24,16,8,0,15,10,5,0,9,6,3,0
KHUZDAR,DISTRICT,15 - 19,MARRIED,25122,15630,9492,0,17959,11192,6767,0,7163,4438,2725,0
KHUZDAR,DISTRICT,15 - 19,NEVER MARRIED,81729,32749,48968,12,46031,17953,28070,8,35698,14796,20898,4
KHUZDAR,DISTRICT,15 - 19,SEPERATION,38,13,25,0,26,6,20,0,12,7,5,0
KHUZDAR,DISTRICT,15 - 19,WIDOWED,47,28,19,0,27,18,9,0,20,10,10,0
KHUZDAR,DISTRICT,20 - 24,DIVORCED,73,54,19,0,45,35,10,0,28,19,9,0
KHUZDAR,DISTRICT,20 - 24,MARRIED,52417,29281,23136,0,36359,20239,16120,0,16058,9042,7016,0
KHUZDAR,DISTRICT,20 - 24,NEVER MARRIED,28736,11034,17693,9,14380,5372,9002,6,14356,5662,8691,3
KHUZDAR,DISTRICT,20 - 24,SEPERATION,52,19,33,0,37,12,25,0,15,7,8,0
KHUZDAR,DISTRICT,20 - 24,WIDOWED,139,94,45,0,88,63,25,0,51,31,20,0
KHUZDAR,DISTRICT,25 - 29,DIVORCED,91,69,22,0,62,49,13,0,29,20,9,0
KHUZDAR,DISTRICT,25 - 29,MARRIED,53946,27939,26007,0,36131,18632,17499,0,17815,9307,8508,0
KHUZDAR,DISTRICT,25 - 29,NEVER MARRIED,9828,3639,6186,3,4583,1641,2939,3,5245,1998,3247,0
KHUZDAR,DISTRICT,25 - 29,SEPERATION,52,13,39,0,42,12,30,0,10,1,9,0
KHUZDAR,DISTRICT,25 - 29,WIDOWED,267,187,80,0,187,130,57,0,80,57,23,0
KHUZDAR,DISTRICT,30 - 34,DIVORCED,82,61,21,0,53,40,13,0,29,21,8,0
KHUZDAR,DISTRICT,30 - 34,MARRIED,45852,24360,21492,0,30070,16091,13979,0,15782,8269,7513,0
KHUZDAR,DISTRICT,30 - 34,NEVER MARRIED,3802,1535,2266,1,1604,617,986,1,2198,918,1280,0
KHUZDAR,DISTRICT,30 - 34,SEPERATION,45,12,33,0,33,8,25,0,12,4,8,0
KHUZDAR,DISTRICT,30 - 34,WIDOWED,333,250,83,0,235,175,60,0,98,75,23,0
KHUZDAR,DISTRICT,35 - 39,DIVORCED,62,43,19,0,48,35,13,0,14,8,6,0
KHUZDAR,DISTRICT,35 - 39,MARRIED,42345,21307,21038,0,27812,13914,13898,0,14533,7393,7140,0
KHUZDAR,DISTRICT,35 - 39,NEVER MARRIED,1798,675,1122,1,704,278,425,1,1094,397,697,0
KHUZDAR,DISTRICT,35 - 39,SEPERATION,52,10,42,0,39,6,33,0,13,4,9,0
KHUZDAR,DISTRICT,35 - 39,WIDOWED,426,300,126,0,299,208,91,0,127,92,35,0
KHUZDAR,DISTRICT,40 - 44,DIVORCED,37,31,6,0,23,21,2,0,14,10,4,0
KHUZDAR,DISTRICT,40 - 44,MARRIED,35922,17206,18716,0,23208,11075,12133,0,12714,6131,6583,0
KHUZDAR,DISTRICT,40 - 44,NEVER MARRIED,884,351,533,0,350,115,235,0,534,236,298,0
KHUZDAR,DISTRICT,40 - 44,SEPERATION,29,12,17,0,21,9,12,0,8,3,5,0
KHUZDAR,DISTRICT,40 - 44,WIDOWED,580,444,136,0,412,301,111,0,168,143,25,0
KHUZDAR,DISTRICT,45 - 49,DIVORCED,44,37,7,0,30,24,6,0,14,13,1,0
KHUZDAR,DISTRICT,45 - 49,MARRIED,24919,11431,13488,0,16203,7501,8702,0,8716,3930,4786,0
KHUZDAR,DISTRICT,45 - 49,NEVER MARRIED,469,182,286,1,175,63,111,1,294,119,175,0
KHUZDAR,DISTRICT,45 - 49,SEPERATION,26,13,13,0,12,3,9,0,14,10,4,0
KHUZDAR,DISTRICT,45 - 49,WIDOWED,695,552,143,0,432,338,94,0,263,214,49,0
KHUZDAR,DISTRICT,50 - 54,DIVORCED,25,22,3,0,17,14,3,0,8,8,0,0
KHUZDAR,DISTRICT,50 - 54,MARRIED,19970,8965,11005,0,13630,6176,7454,0,6340,2789,3551,0
KHUZDAR,DISTRICT,50 - 54,NEVER MARRIED,316,117,198,1,106,29,76,1,210,88,122,0
KHUZDAR,DISTRICT,50 - 54,SEPERATION,32,14,18,0,26,11,15,0,6,3,3,0
KHUZDAR,DISTRICT,50 - 54,WIDOWED,890,729,161,0,564,459,105,0,326,270,56,0
KHUZDAR,DISTRICT,55 - 59,DIVORCED,22,14,8,0,17,11,6,0,5,3,2,0
KHUZDAR,DISTRICT,55 - 59,MARRIED,13854,6177,7677,0,9305,4215,5090,0,4549,1962,2587,0
KHUZDAR,DISTRICT,55 - 59,NEVER MARRIED,196,68,127,1,65,19,45,1,131,49,82,0
KHUZDAR,DISTRICT,55 - 59,SEPERATION,32,11,21,0,20,6,14,0,12,5,7,0
KHUZDAR,DISTRICT,55 - 59,WIDOWED,870,711,159,0,542,432,110,0,328,279,49,0
KHUZDAR,DISTRICT,60 - 64,DIVORCED,25,16,9,0,20,12,8,0,5,4,1,0
KHUZDAR,DISTRICT,60 - 64,MARRIED,11276,4425,6851,0,7815,3109,4706,0,3461,1316,2145,0
KHUZDAR,DISTRICT,60 - 64,NEVER MARRIED,163,43,119,1,45,10,34,1,118,33,85,0
KHUZDAR,DISTRICT,60 - 64,SEPERATION,24,15,9,0,20,13,7,0,4,2,2,0
KHUZDAR,DISTRICT,60 - 64,WIDOWED,1125,928,197,0,753,616,137,0,372,312,60,0
KHUZDAR,DISTRICT,65 - 69,DIVORCED,7,5,2,0,6,5,1,0,1,0,1,0
KHUZDAR,DISTRICT,65 - 69,MARRIED,7154,2913,4241,0,5005,2012,2993,0,2149,901,1248,0
KHUZDAR,DISTRICT,65 - 69,NEVER MARRIED,115,24,91,0,34,10,24,0,81,14,67,0
KHUZDAR,DISTRICT,65 - 69,SEPERATION,23,5,18,0,19,4,15,0,4,1,3,0
KHUZDAR,DISTRICT,65 - 69,WIDOWED,931,755,176,0,595,482,113,0,336,273,63,0
KHUZDAR,DISTRICT,70 - 74,DIVORCED,9,5,4,0,8,4,4,0,1,1,0,0
KHUZDAR,DISTRICT,70 - 74,MARRIED,5303,1921,3382,0,3820,1395,2425,0,1483,526,957,0
KHUZDAR,DISTRICT,70 - 74,NEVER MARRIED,45,15,30,0,24,5,19,0,21,10,11,0
KHUZDAR,DISTRICT,70 - 74,SEPERATION,15,4,11,0,13,3,10,0,2,1,1,0
KHUZDAR,DISTRICT,70 - 74,WIDOWED,938,749,189,0,673,528,145,0,265,221,44,0
KHUZDAR,DISTRICT,75 & ABOVE,DIVORCED,15,9,6,0,13,8,5,0,2,1,1,0
KHUZDAR,DISTRICT,75 & ABOVE,MARRIED,4936,1609,3327,0,3605,1147,2458,0,1331,462,869,0
KHUZDAR,DISTRICT,75 & ABOVE,NEVER MARRIED,71,16,54,1,32,8,23,1,39,8,31,0
KHUZDAR,DISTRICT,75 & ABOVE,SEPERATION,54,9,45,0,44,6,38,0,10,3,7,0
KHUZDAR,DISTRICT,75 & ABOVE,WIDOWED,1316,985,331,0,964,711,253,0,352,274,78,0
KILLA ABDULLAH,DISTRICT,15 &  ABOVE,DIVORCED,37,22,15,0,34,22,12,0,3,0,3,0
KILLA ABDULLAH,DISTRICT,15 &  ABOVE,MARRIED,133527,66571,66956,0,120756,60281,60475,0,12771,6290,6481,0
KILLA ABDULLAH,DISTRICT,15 &  ABOVE,NEVER MARRIED,47866,20690,27162,14,42267,18581,23674,12,5599,2109,3488,2
KILLA ABDULLAH,DISTRICT,15 &  ABOVE,SEPERATION,69,28,41,0,66,26,40,0,3,2,1,0
KILLA ABDULLAH,DISTRICT,15 &  ABOVE,WIDOWED,1681,1323,358,0,1532,1188,344,0,149,135,14,0
KILLA ABDULLAH,DISTRICT,15 - 19,DIVORCED,0,0,0,0,0,0,0,0,0,0,0,0
KILLA ABDULLAH,DISTRICT,15 - 19,MARRIED,10114,6514,3600,0,9165,5927,3238,0,949,587,362,0
KILLA ABDULLAH,DISTRICT,15 - 19,NEVER MARRIED,30052,13158,16885,9,26538,11837,14692,9,3514,1321,2193,0
KILLA ABDULLAH,DISTRICT,15 - 19,SEPERATION,13,2,11,0,13,2,11,0,0,0,0,0
KILLA ABDULLAH,DISTRICT,15 - 19,WIDOWED,9,6,3,0,9,6,3,0,0,0,0,0
KILLA ABDULLAH,DISTRICT,20 - 24,DIVORCED,5,4,1,0,5,4,1,0,0,0,0,0
KILLA ABDULLAH,DISTRICT,20 - 24,MARRIED,24123,13615,10508,0,21521,12185,9336,0,2602,1430,1172,0
KILLA ABDULLAH,DISTRICT,20 - 24,NEVER MARRIED,12461,5168,7290,3,10999,4649,6348,2,1462,519,942,1
KILLA ABDULLAH,DISTRICT,20 - 24,SEPERATION,19,11,8,0,19,11,8,0,0,0,0,0
KILLA ABDULLAH,DISTRICT,20 - 24,WIDOWED,23,8,15,0,18,7,11,0,5,1,4,0
KILLA ABDULLAH,DISTRICT,25 - 29,DIVORCED,5,3,2,0,5,3,2,0,0,0,0,0
KILLA ABDULLAH,DISTRICT,25 - 29,MARRIED,22013,10974,11039,0,20000,9975,10025,0,2013,999,1014,0
KILLA ABDULLAH,DISTRICT,25 - 29,NEVER MARRIED,3570,1626,1943,1,3140,1446,1693,1,430,180,250,0
KILLA ABDULLAH,DISTRICT,25 - 29,SEPERATION,9,2,7,0,9,2,7,0,0,0,0,0
KILLA ABDULLAH,DISTRICT,25 - 29,WIDOWED,35,16,19,0,34,15,19,0,1,1,0,0
KILLA ABDULLAH,DISTRICT,30 - 34,DIVORCED,6,1,5,0,6,1,5,0,0,0,0,0
KILLA ABDULLAH,DISTRICT,30 - 34,MARRIED,18116,8904,9212,0,16583,8178,8405,0,1533,726,807,0
KILLA ABDULLAH,DISTRICT,30 - 34,NEVER MARRIED,1126,490,636,0,1014,445,569,0,112,45,67,0
KILLA ABDULLAH,DISTRICT,30 - 34,SEPERATION,7,3,4,0,6,2,4,0,1,1,0,0
KILLA ABDULLAH,DISTRICT,30 - 34,WIDOWED,56,29,27,0,52,26,26,0,4,3,1,0
KILLA ABDULLAH,DISTRICT,35 - 39,DIVORCED,2,1,1,0,2,1,1,0,0,0,0,0
KILLA ABDULLAH,DISTRICT,35 - 39,MARRIED,16139,7752,8387,0,14784,7088,7696,0,1355,664,691,0
KILLA ABDULLAH,DISTRICT,35 - 39,NEVER MARRIED,362,141,221,0,326,120,206,0,36,21,15,0
KILLA ABDULLAH,DISTRICT,35 - 39,SEPERATION,2,2,0,0,2,2,0,0,0,0,0,0
KILLA ABDULLAH,DISTRICT,35 - 39,WIDOWED,69,41,28,0,66,39,27,0,3,2,1,0
KILLA ABDULLAH,DISTRICT,40 - 44,DIVORCED,7,3,4,0,5,3,2,0,2,0,2,0
KILLA ABDULLAH,DISTRICT,40 - 44,MARRIED,13106,6073,7033,0,11794,5474,6320,0,1312,599,713,0
KILLA ABDULLAH,DISTRICT,40 - 44,NEVER MARRIED,162,70,91,1,135,56,79,0,27,14,12,1
KILLA ABDULLAH,DISTRICT,40 - 44,SEPERATION,5,2,3,0,5,2,3,0,0,0,0,0
KILLA ABDULLAH,DISTRICT,40 - 44,WIDOWED,134,103,31,0,125,94,31,0,9,9,0,0
KILLA ABDULLAH,DISTRICT,45 - 49,DIVORCED,8,7,1,0,8,7,1,0,0,0,0,0
KILLA ABDULLAH,DISTRICT,45 - 49,MARRIED,8404,3837,4567,0,7609,3487,4122,0,795,350,445,0
KILLA ABDULLAH,DISTRICT,45 - 49,NEVER MARRIED,61,17,44,0,56,13,43,0,5,4,1,0
KILLA ABDULLAH,DISTRICT,45 - 49,SEPERATION,4,3,1,0,3,2,1,0,1,1,0,0
KILLA ABDULLAH,DISTRICT,45 - 49,WIDOWED,133,116,17,0,124,107,17,0,9,9,0,0
KILLA ABDULLAH,DISTRICT,50 - 54,DIVORCED,1,1,0,0,1,1,0,0,0,0,0,0
KILLA ABDULLAH,DISTRICT,50 - 54,MARRIED,6549,3072,3477,0,5833,2717,3116,0,716,355,361,0
KILLA ABDULLAH,DISTRICT,50 - 54,NEVER MARRIED,20,6,14,0,16,3,13,0,4,3,1,0
KILLA ABDULLAH,DISTRICT,50 - 54,SEPERATION,6,2,4,0,6,2,4,0,0,0,0,0
KILLA ABDULLAH,DISTRICT,50 - 54,WIDOWED,184,157,27,0,163,139,24,0,21,18,3,0
KILLA ABDULLAH,DISTRICT,55 - 59,DIVORCED,1,0,1,0,0,0,0,0,1,0,1,0
KILLA ABDULLAH,DISTRICT,55 - 59,MARRIED,5137,2128,3009,0,4605,1926,2679,0,532,202,330,0
KILLA ABDULLAH,DISTRICT,55 - 59,NEVER MARRIED,13,3,10,0,11,2,9,0,2,1,1,0
KILLA ABDULLAH,DISTRICT,55 - 59,SEPERATION,2,1,1,0,2,1,1,0,0,0,0,0
KILLA ABDULLAH,DISTRICT,55 - 59,WIDOWED,171,147,24,0,155,132,23,0,16,15,1,0
KILLA ABDULLAH,DISTRICT,60 - 64,DIVORCED,0,0,0,0,0,0,0,0,0,0,0,0
KILLA ABDULLAH,DISTRICT,60 - 64,MARRIED,3663,1541,2122,0,3323,1401,1922,0,340,140,200,0
KILLA ABDULLAH,DISTRICT,60 - 64,NEVER MARRIED,12,2,10,0,10,2,8,0,2,0,2,0
KILLA ABDULLAH,DISTRICT,60 - 64,SEPERATION,1,0,1,0,0,0,0,0,1,0,1,0
KILLA ABDULLAH,DISTRICT,60 - 64,WIDOWED,215,183,32,0,196,166,30,0,19,17,2,0
KILLA ABDULLAH,DISTRICT,65 - 69,DIVORCED,2,2,0,0,2,2,0,0,0,0,0,0
KILLA ABDULLAH,DISTRICT,65 - 69,MARRIED,2620,1013,1607,0,2389,915,1474,0,231,98,133,0
KILLA ABDULLAH,DISTRICT,65 - 69,NEVER MARRIED,11,4,7,0,9,4,5,0,2,0,2,0
KILLA ABDULLAH,DISTRICT,65 - 69,SEPERATION,0,0,0,0,0,0,0,0,0,0,0,0
KILLA ABDULLAH,DISTRICT,65 - 69,WIDOWED,200,168,32,0,183,151,32,0,17,17,0,0
KILLA ABDULLAH,DISTRICT,70 - 74,DIVORCED,0,0,0,0,0,0,0,0,0,0,0,0
KILLA ABDULLAH,DISTRICT,70 - 74,MARRIED,1873,706,1167,0,1689,631,1058,0,184,75,109,0
KILLA ABDULLAH,DISTRICT,70 - 74,NEVER MARRIED,5,2,3,0,5,2,3,0,0,0,0,0
KILLA ABDULLAH,DISTRICT,70 - 74,SEPERATION,1,0,1,0,1,0,1,0,0,0,0,0
KILLA ABDULLAH,DISTRICT,70 - 74,WIDOWED,208,167,41,0,189,148,41,0,19,19,0,0
KILLA ABDULLAH,DISTRICT,75 & ABOVE,DIVORCED,0,0,0,0,0,0,0,0,0,0,0,0
KILLA ABDULLAH,DISTRICT,75 & ABOVE,MARRIED,1670,442,1228,0,1461,377,1084,0,209,65,144,0
KILLA ABDULLAH,DISTRICT,75 & ABOVE,NEVER MARRIED,11,3,8,0,8,2,6,0,3,1,2,0
KILLA ABDULLAH,DISTRICT,75 & ABOVE,SEPERATION,0,0,0,0,0,0,0,0,0,0,0,0
KILLA ABDULLAH,DISTRICT,75 & ABOVE,WIDOWED,244,182,62,0,218,158,60,0,26,24,2,0
KILLA SAIFULLAH,DISTRICT,15 &  ABOVE,DIVORCED,57,23,34,0,48,20,28,0,9,3,6,0
KILLA SAIFULLAH,DISTRICT,15 &  ABOVE,MARRIED,131865,66545,65320,0,109823,55580,54243,0,22042,10965,11077,0
KILLA SAIFULLAH,DISTRICT,15 &  ABOVE,NEVER MARRIED,41077,17412,23665,0,31433,12788,18645,0,9644,4624,5020,0
KILLA SAIFULLAH,DISTRICT,15 &  ABOVE,SEPERATION,68,18,50,0,61,17,44,0,7,1,6,0
KILLA SAIFULLAH,DISTRICT,15 &  ABOVE,WIDOWED,2937,2387,550,0,2360,1924,436,0,577,463,114,0
KILLA SAIFULLAH,DISTRICT,15 - 19,DIVORCED,5,4,1,0,5,4,1,0,0,0,0,0
KILLA SAIFULLAH,DISTRICT,15 - 19,MARRIED,11866,7319,4547,0,10600,6589,4011,0,1266,730,536,0
KILLA SAIFULLAH,DISTRICT,15 - 19,NEVER MARRIED,26878,11391,15487,0,21391,8897,12494,0,5487,2494,2993,0
KILLA SAIFULLAH,DISTRICT,15 - 19,SEPERATION,11,5,6,0,10,5,5,0,1,0,1,0
KILLA SAIFULLAH,DISTRICT,15 - 19,WIDOWED,14,8,6,0,13,7,6,0,1,1,0,0
KILLA SAIFULLAH,DISTRICT,20 - 24,DIVORCED,6,2,4,0,5,2,3,0,1,0,1,0
KILLA SAIFULLAH,DISTRICT,20 - 24,MARRIED,21153,12258,8895,0,17473,10123,7350,0,3680,2135,1545,0
KILLA SAIFULLAH,DISTRICT,20 - 24,NEVER MARRIED,9406,3882,5524,0,6945,2686,4259,0,2461,1196,1265,0
KILLA SAIFULLAH,DISTRICT,20 - 24,SEPERATION,8,2,6,0,5,2,3,0,3,0,3,0
KILLA SAIFULLAH,DISTRICT,20 - 24,WIDOWED,20,9,11,0,19,9,10,0,1,0,1,0
KILLA SAIFULLAH,DISTRICT,25 - 29,DIVORCED,5,0,5,0,3,0,3,0,2,0,2,0
KILLA SAIFULLAH,DISTRICT,25 - 29,MARRIED,20135,10473,9662,0,16730,8704,8026,0,3405,1769,1636,0
KILLA SAIFULLAH,DISTRICT,25 - 29,NEVER MARRIED,3007,1225,1782,0,2011,702,1309,0,996,523,473,0
KILLA SAIFULLAH,DISTRICT,25 - 29,SEPERATION,6,0,6,0,4,0,4,0,2,0,2,0
KILLA SAIFULLAH,DISTRICT,25 - 29,WIDOWED,46,30,16,0,37,22,15,0,9,8,1,0
KILLA SAIFULLAH,DISTRICT,30 - 34,DIVORCED,5,1,4,0,4,1,3,0,1,0,1,0
KILLA SAIFULLAH,DISTRICT,30 - 34,MARRIED,18000,9223,8777,0,14837,7602,7235,0,3163,1621,1542,0
KILLA SAIFULLAH,DISTRICT,30 - 34,NEVER MARRIED,1023,530,493,0,643,312,331,0,380,218,162,0
KILLA SAIFULLAH,DISTRICT,30 - 34,SEPERATION,5,1,4,0,5,1,4,0,0,0,0,0
KILLA SAIFULLAH,DISTRICT,30 - 34,WIDOWED,48,34,14,0,38,26,12,0,10,8,2,0
KILLA SAIFULLAH,DISTRICT,35 - 39,DIVORCED,5,0,5,0,4,0,4,0,1,0,1,0
KILLA SAIFULLAH,DISTRICT,35 - 39,MARRIED,15857,7914,7943,0,13228,6574,6654,0,2629,1340,1289,0
KILLA SAIFULLAH,DISTRICT,35 - 39,NEVER MARRIED,395,212,183,0,231,104,127,0,164,108,56,0
KILLA SAIFULLAH,DISTRICT,35 - 39,SEPERATION,10,4,6,0,10,4,6,0,0,0,0,0
KILLA SAIFULLAH,DISTRICT,35 - 39,WIDOWED,130,105,25,0,105,84,21,0,25,21,4,0
KILLA SAIFULLAH,DISTRICT,40 - 44,DIVORCED,11,8,3,0,9,6,3,0,2,2,0,0
KILLA SAIFULLAH,DISTRICT,40 - 44,MARRIED,13043,6062,6981,0,10677,4957,5720,0,2366,1105,1261,0
KILLA SAIFULLAH,DISTRICT,40 - 44,NEVER MARRIED,164,78,86,0,99,40,59,0,65,38,27,0
KILLA SAIFULLAH,DISTRICT,40 - 44,SEPERATION,4,1,3,0,4,1,3,0,0,0,0,0
KILLA SAIFULLAH,DISTRICT,40 - 44,WIDOWED,189,159,30,0,150,128,22,0,39,31,8,0
KILLA SAIFULLAH,DISTRICT,45 - 49,DIVORCED,4,2,2,0,3,2,1,0,1,0,1,0
KILLA SAIFULLAH,DISTRICT,45 - 49,MARRIED,8358,3872,4486,0,6802,3199,3603,0,1556,673,883,0
KILLA SAIFULLAH,DISTRICT,45 - 49,NEVER MARRIED,70,33,37,0,37,16,21,0,33,17,16,0
KILLA SAIFULLAH,DISTRICT,45 - 49,SEPERATION,2,0,2,0,2,0,2,0,0,0,0,0
KILLA SAIFULLAH,DISTRICT,45 - 49,WIDOWED,222,197,25,0,170,150,20,0,52,47,5,0
KILLA SAIFULLAH,DISTRICT,50 - 54,DIVORCED,7,1,6,0,7,1,6,0,0,0,0,0
KILLA SAIFULLAH,DISTRICT,50 - 54,MARRIED,7135,3249,3886,0,5856,2679,3177,0,1279,570,709,0
KILLA SAIFULLAH,DISTRICT,50 - 54,NEVER MARRIED,36,13,23,0,16,3,13,0,20,10,10,0
KILLA SAIFULLAH,DISTRICT,50 - 54,SEPERATION,3,0,3,0,3,0,3,0,0,0,0,0
KILLA SAIFULLAH,DISTRICT,50 - 54,WIDOWED,334,285,49,0,256,222,34,0,78,63,15,0
KILLA SAIFULLAH,DISTRICT,55 - 59,DIVORCED,2,2,0,0,1,1,0,0,1,1,0,0
KILLA SAIFULLAH,DISTRICT,55 - 59,MARRIED,5056,2079,2977,0,4156,1720,2436,0,900,359,541,0
KILLA SAIFULLAH,DISTRICT,55 - 59,NEVER MARRIED,40,23,17,0,19,13,6,0,21,10,11,0
KILLA SAIFULLAH,DISTRICT,55 - 59,SEPERATION,2,2,0,0,1,1,0,0,1,1,0,0
KILLA SAIFULLAH,DISTRICT,55 - 59,WIDOWED,316,262,54,0,248,207,41,0,68,55,13,0
KILLA SAIFULLAH,DISTRICT,60 - 64,DIVORCED,5,1,4,0,5,1,4,0,0,0,0,0
KILLA SAIFULLAH,DISTRICT,60 - 64,MARRIED,4128,1603,2525,0,3380,1322,2058,0,748,281,467,0
KILLA SAIFULLAH,DISTRICT,60 - 64,NEVER MARRIED,30,12,18,0,21,7,14,0,9,5,4,0
KILLA SAIFULLAH,DISTRICT,60 - 64,SEPERATION,5,2,3,0,5,2,3,0,0,0,0,0
KILLA SAIFULLAH,DISTRICT,60 - 64,WIDOWED,390,327,63,0,313,263,50,0,77,64,13,0
KILLA SAIFULLAH,DISTRICT,65 - 69,DIVORCED,0,0,0,0,0,0,0,0,0,0,0,0
KILLA SAIFULLAH,DISTRICT,65 - 69,MARRIED,2753,1071,1682,0,2309,882,1427,0,444,189,255,0
KILLA SAIFULLAH,DISTRICT,65 - 69,NEVER MARRIED,11,9,2,0,9,7,2,0,2,2,0,0
KILLA SAIFULLAH,DISTRICT,65 - 69,SEPERATION,2,1,1,0,2,1,1,0,0,0,0,0
KILLA SAIFULLAH,DISTRICT,65 - 69,WIDOWED,352,294,58,0,286,241,45,0,66,53,13,0
KILLA SAIFULLAH,DISTRICT,70 - 74,DIVORCED,2,2,0,0,2,2,0,0,0,0,0,0
KILLA SAIFULLAH,DISTRICT,70 - 74,MARRIED,2078,764,1314,0,1766,660,1106,0,312,104,208,0
KILLA SAIFULLAH,DISTRICT,70 - 74,NEVER MARRIED,8,3,5,0,3,1,2,0,5,2,3,0
KILLA SAIFULLAH,DISTRICT,70 - 74,SEPERATION,3,0,3,0,3,0,3,0,0,0,0,0
KILLA SAIFULLAH,DISTRICT,70 - 74,WIDOWED,396,316,80,0,324,260,64,0,72,56,16,0
KILLA SAIFULLAH,DISTRICT,75 & ABOVE,DIVORCED,0,0,0,0,0,0,0,0,0,0,0,0
KILLA SAIFULLAH,DISTRICT,75 & ABOVE,MARRIED,2303,658,1645,0,2009,569,1440,0,294,89,205,0
KILLA SAIFULLAH,DISTRICT,75 & ABOVE,NEVER MARRIED,9,1,8,0,8,0,8,0,1,1,0,0
KILLA SAIFULLAH,DISTRICT,75 & ABOVE,SEPERATION,7,0,7,0,7,0,7,0,0,0,0,0
KILLA SAIFULLAH,DISTRICT,75 & ABOVE,WIDOWED,480,361,119,0,401,305,96,0,79,56,23,0
KOHLU,DISTRICT,15 &  ABOVE,DIVORCED,133,58,75,0,124,51,73,0,9,7,2,0
KOHLU,DISTRICT,15 &  ABOVE,MARRIED,92394,45168,47226,0,85997,41943,44054,0,6397,3225,3172,0
KOHLU,DISTRICT,15 &  ABOVE,NEVER MARRIED,31575,12889,18673,13,28878,11541,17324,13,2697,1348,1349,0
KOHLU,DISTRICT,15 &  ABOVE,SEPERATION,135,39,96,0,134,39,95,0,1,0,1,0
KOHLU,DISTRICT,15 &  ABOVE,WIDOWED,1566,1153,413,0,1282,893,389,0,284,260,24,0
KOHLU,DISTRICT,15 - 19,DIVORCED,11,7,4,0,11,7,4,0,0,0,0,0
KOHLU,DISTRICT,15 - 19,MARRIED,8259,4548,3711,0,7872,4313,3559,0,387,235,152,0
KOHLU,DISTRICT,15 - 19,NEVER MARRIED,19974,8617,11352,5,18339,7760,10574,5,1635,857,778,0
KOHLU,DISTRICT,15 - 19,SEPERATION,25,9,16,0,25,9,16,0,0,0,0,0
KOHLU,DISTRICT,15 - 19,WIDOWED,17,5,12,0,17,5,12,0,0,0,0,0
KOHLU,DISTRICT,20 - 24,DIVORCED,22,11,11,0,22,11,11,0,0,0,0,0
KOHLU,DISTRICT,20 - 24,MARRIED,13978,7592,6386,0,13015,7003,6012,0,963,589,374,0
KOHLU,DISTRICT,20 - 24,NEVER MARRIED,7150,2801,4348,1,6490,2480,4009,1,660,321,339,0
KOHLU,DISTRICT,20 - 24,SEPERATION,21,6,15,0,21,6,15,0,0,0,0,0
KOHLU,DISTRICT,20 - 24,WIDOWED,46,23,23,0,44,21,23,0,2,2,0,0
KOHLU,DISTRICT,25 - 29,DIVORCED,23,11,12,0,20,9,11,0,3,2,1,0
KOHLU,DISTRICT,25 - 29,MARRIED,12980,6593,6387,0,12061,6086,5975,0,919,507,412,0
KOHLU,DISTRICT,25 - 29,NEVER MARRIED,2343,960,1377,6,2102,843,1253,6,241,117,124,0
KOHLU,DISTRICT,25 - 29,SEPERATION,22,4,18,0,21,4,17,0,1,0,1,0
KOHLU,DISTRICT,25 - 29,WIDOWED,49,21,28,0,47,20,27,0,2,1,1,0
KOHLU,DISTRICT,30 - 34,DIVORCED,19,6,13,0,19,6,13,0,0,0,0,0
KOHLU,DISTRICT,30 - 34,MARRIED,11825,6194,5631,0,10887,5714,5173,0,938,480,458,0
KOHLU,DISTRICT,30 - 34,NEVER MARRIED,921,305,616,0,834,268,566,0,87,37,50,0
KOHLU,DISTRICT,30 - 34,SEPERATION,12,2,10,0,12,2,10,0,0,0,0,0
KOHLU,DISTRICT,30 - 34,WIDOWED,68,28,40,0,66,26,40,0,2,2,0,0
KOHLU,DISTRICT,35 - 39,DIVORCED,13,3,10,0,13,3,10,0,0,0,0,0
KOHLU,DISTRICT,35 - 39,MARRIED,10696,5297,5399,0,9930,4911,5019,0,766,386,380,0
KOHLU,DISTRICT,35 - 39,NEVER MARRIED,474,87,387,0,431,75,356,0,43,12,31,0
KOHLU,DISTRICT,35 - 39,SEPERATION,10,3,7,0,10,3,7,0,0,0,0,0
KOHLU,DISTRICT,35 - 39,WIDOWED,87,47,40,0,79,39,40,0,8,8,0,0
KOHLU,DISTRICT,40 - 44,DIVORCED,11,5,6,0,10,4,6,0,1,1,0,0
KOHLU,DISTRICT,40 - 44,MARRIED,9644,4699,4945,0,8887,4356,4531,0,757,343,414,0
KOHLU,DISTRICT,40 - 44,NEVER MARRIED,260,44,215,1,241,41,199,1,19,3,16,0
KOHLU,DISTRICT,40 - 44,SEPERATION,5,2,3,0,5,2,3,0,0,0,0,0
KOHLU,DISTRICT,40 - 44,WIDOWED,104,82,22,0,88,69,19,0,16,13,3,0
KOHLU,DISTRICT,45 - 49,DIVORCED,11,5,6,0,10,4,6,0,1,1,0,0
KOHLU,DISTRICT,45 - 49,MARRIED,7409,3490,3919,0,6949,3280,3669,0,460,210,250,0
KOHLU,DISTRICT,45 - 49,NEVER MARRIED,163,28,135,0,160,27,133,0,3,1,2,0
KOHLU,DISTRICT,45 - 49,SEPERATION,7,3,4,0,7,3,4,0,0,0,0,0
KOHLU,DISTRICT,45 - 49,WIDOWED,94,76,18,0,74,57,17,0,20,19,1,0
KOHLU,DISTRICT,50 - 54,DIVORCED,7,5,2,0,6,4,2,0,1,1,0,0
KOHLU,DISTRICT,50 - 54,MARRIED,5545,2400,3145,0,5156,2217,2939,0,389,183,206,0
KOHLU,DISTRICT,50 - 54,NEVER MARRIED,111,22,89,0,109,22,87,0,2,0,2,0
KOHLU,DISTRICT,50 - 54,SEPERATION,5,0,5,0,5,0,5,0,0,0,0,0
KOHLU,DISTRICT,50 - 54,WIDOWED,135,105,30,0,101,74,27,0,34,31,3,0
KOHLU,DISTRICT,55 - 59,DIVORCED,4,2,2,0,3,1,2,0,1,1,0,0
KOHLU,DISTRICT,55 - 59,MARRIED,4061,1631,2430,0,3771,1526,2245,0,290,105,185,0
KOHLU,DISTRICT,55 - 59,NEVER MARRIED,87,12,75,0,83,12,71,0,4,0,4,0
KOHLU,DISTRICT,55 - 59,SEPERATION,4,1,3,0,4,1,3,0,0,0,0,0
KOHLU,DISTRICT,55 - 59,WIDOWED,141,118,23,0,112,90,22,0,29,28,1,0
KOHLU,DISTRICT,60 - 64,DIVORCED,3,1,2,0,1,0,1,0,2,1,1,0
KOHLU,DISTRICT,60 - 64,MARRIED,3322,1180,2142,0,3100,1091,2009,0,222,89,133,0
KOHLU,DISTRICT,60 - 64,NEVER MARRIED,41,3,38,0,40,3,37,0,1,0,1,0
KOHLU,DISTRICT,60 - 64,SEPERATION,9,3,6,0,9,3,6,0,0,0,0,0
KOHLU,DISTRICT,60 - 64,WIDOWED,226,196,30,0,176,147,29,0,50,49,1,0
KOHLU,DISTRICT,65 - 69,DIVORCED,3,1,2,0,3,1,2,0,0,0,0,0
KOHLU,DISTRICT,65 - 69,MARRIED,1904,644,1260,0,1756,592,1164,0,148,52,96,0
KOHLU,DISTRICT,65 - 69,NEVER MARRIED,26,3,23,0,26,3,23,0,0,0,0,0
KOHLU,DISTRICT,65 - 69,SEPERATION,2,1,1,0,2,1,1,0,0,0,0,0
KOHLU,DISTRICT,65 - 69,WIDOWED,142,116,26,0,107,82,25,0,35,34,1,0
KOHLU,DISTRICT,70 - 74,DIVORCED,2,0,2,0,2,0,2,0,0,0,0,0
KOHLU,DISTRICT,70 - 74,MARRIED,1230,446,784,0,1140,421,719,0,90,25,65,0
KOHLU,DISTRICT,70 - 74,NEVER MARRIED,15,4,11,0,13,4,9,0,2,0,2,0
KOHLU,DISTRICT,70 - 74,SEPERATION,6,3,3,0,6,3,3,0,0,0,0,0
KOHLU,DISTRICT,70 - 74,WIDOWED,191,153,38,0,139,107,32,0,52,46,6,0
KOHLU,DISTRICT,75 & ABOVE,DIVORCED,4,1,3,0,4,1,3,0,0,0,0,0
KOHLU,DISTRICT,75 & ABOVE,MARRIED,1541,454,1087,0,1473,433,1040,0,68,21,47,0
KOHLU,DISTRICT,75 & ABOVE,NEVER MARRIED,10,3,7,0,10,3,7,0,0,0,0,0
KOHLU,DISTRICT,75 & ABOVE,SEPERATION,7,2,5,0,7,2,5,0,0,0,0,0
KOHLU,DISTRICT,75 & ABOVE,WIDOWED,266,183,83,0,232,156,76,0,34,27,7,0
LASBELA,DISTRICT,15 &  ABOVE,DIVORCED,688,492,196,0,359,251,108,0,329,241,88,0
LASBELA,DISTRICT,15 &  ABOVE,MARRIED,247110,123697,123413,0,124089,62385,61704,0,123021,61312,61709,0
LASBELA,DISTRICT,15 &  ABOVE,NEVER MARRIED,119704,49590,70094,20,57446,23943,33495,8,62258,25647,36599,12
LASBELA,DISTRICT,15 &  ABOVE,SEPERATION,348,185,163,0,191,87,104,0,157,98,59,0
LASBELA,DISTRICT,15 &  ABOVE,WIDOWED,14553,10992,3561,0,7575,5503,2072,0,6978,5489,1489,0
LASBELA,DISTRICT,15 - 19,DIVORCED,9,8,1,0,2,1,1,0,7,7,0,0
LASBELA,DISTRICT,15 - 19,MARRIED,6519,4667,1852,0,3035,2139,896,0,3484,2528,956,0
LASBELA,DISTRICT,15 - 19,NEVER MARRIED,62760,28523,34235,2,30912,14078,16832,2,31848,14445,17403,0
LASBELA,DISTRICT,15 - 19,SEPERATION,7,5,2,0,5,4,1,0,2,1,1,0
LASBELA,DISTRICT,15 - 19,WIDOWED,29,20,9,0,11,7,4,0,18,13,5,0
LASBELA,DISTRICT,20 - 24,DIVORCED,60,50,10,0,41,34,7,0,19,16,3,0
LASBELA,DISTRICT,20 - 24,MARRIED,26510,17206,9304,0,12857,8371,4486,0,13653,8835,4818,0
LASBELA,DISTRICT,20 - 24,NEVER MARRIED,32478,12034,20441,3,14738,5527,9210,1,17740,6507,11231,2
LASBELA,DISTRICT,20 - 24,SEPERATION,30,11,19,0,21,6,15,0,9,5,4,0
LASBELA,DISTRICT,20 - 24,WIDOWED,135,82,53,0,64,34,30,0,71,48,23,0
LASBELA,DISTRICT,25 - 29,DIVORCED,82,57,25,0,36,21,15,0,46,36,10,0
LASBELA,DISTRICT,25 - 29,MARRIED,34987,18773,16214,0,17213,9061,8152,0,17774,9712,8062,0
LASBELA,DISTRICT,25 - 29,NEVER MARRIED,12997,4930,8065,2,5989,2221,3767,1,7008,2709,4298,1
LASBELA,DISTRICT,25 - 29,SEPERATION,30,14,16,0,16,7,9,0,14,7,7,0
LASBELA,DISTRICT,25 - 29,WIDOWED,282,157,125,0,152,79,73,0,130,78,52,0
LASBELA,DISTRICT,30 - 34,DIVORCED,127,95,32,0,65,50,15,0,62,45,17,0
LASBELA,DISTRICT,30 - 34,MARRIED,35861,18908,16953,0,17498,9338,8160,0,18363,9570,8793,0
LASBELA,DISTRICT,30 - 34,NEVER MARRIED,5749,2210,3539,0,2754,1065,1689,0,2995,1145,1850,0
LASBELA,DISTRICT,30 - 34,SEPERATION,55,28,27,0,29,9,20,0,26,19,7,0
LASBELA,DISTRICT,30 - 34,WIDOWED,470,301,169,0,260,158,102,0,210,143,67,0
LASBELA,DISTRICT,35 - 39,DIVORCED,99,61,38,0,46,25,21,0,53,36,17,0
LASBELA,DISTRICT,35 - 39,MARRIED,33841,16650,17191,0,16263,8181,8082,0,17578,8469,9109,0
LASBELA,DISTRICT,35 - 39,NEVER MARRIED,2669,847,1821,1,1265,413,852,0,1404,434,969,1
LASBELA,DISTRICT,35 - 39,SEPERATION,42,22,20,0,22,9,13,0,20,13,7,0
LASBELA,DISTRICT,35 - 39,WIDOWED,613,419,194,0,302,188,114,0,311,231,80,0
LASBELA,DISTRICT,40 - 44,DIVORCED,115,90,25,0,58,44,14,0,57,46,11,0
LASBELA,DISTRICT,40 - 44,MARRIED,31619,14875,16744,0,15939,7634,8305,0,15680,7241,8439,0
LASBELA,DISTRICT,40 - 44,NEVER MARRIED,1376,443,932,1,714,226,488,0,662,217,444,1
LASBELA,DISTRICT,40 - 44,SEPERATION,53,23,30,0,30,12,18,0,23,11,12,0
LASBELA,DISTRICT,40 - 44,WIDOWED,947,683,264,0,485,331,154,0,462,352,110,0
LASBELA,DISTRICT,45 - 49,DIVORCED,71,46,25,0,33,20,13,0,38,26,12,0
LASBELA,DISTRICT,45 - 49,MARRIED,22383,10140,12243,0,11296,5212,6084,0,11087,4928,6159,0
LASBELA,DISTRICT,45 - 49,NEVER MARRIED,716,255,459,2,424,156,267,1,292,99,192,1
LASBELA,DISTRICT,45 - 49,SEPERATION,38,23,15,0,23,14,9,0,15,9,6,0
LASBELA,DISTRICT,45 - 49,WIDOWED,1133,841,292,0,532,384,148,0,601,457,144,0
LASBELA,DISTRICT,50 - 54,DIVORCED,51,37,14,0,29,21,8,0,22,16,6,0
LASBELA,DISTRICT,50 - 54,MARRIED,18980,8584,10396,0,9917,4609,5308,0,9063,3975,5088,0
LASBELA,DISTRICT,50 - 54,NEVER MARRIED,410,160,243,7,261,112,147,2,149,48,96,5
LASBELA,DISTRICT,50 - 54,SEPERATION,36,21,15,0,13,6,7,0,23,15,8,0
LASBELA,DISTRICT,50 - 54,WIDOWED,1613,1309,304,0,808,636,172,0,805,673,132,0
LASBELA,DISTRICT,55 - 59,DIVORCED,30,17,13,0,17,10,7,0,13,7,6,0
LASBELA,DISTRICT,55 - 59,MARRIED,13692,5598,8094,0,7249,3028,4221,0,6443,2570,3873,0
LASBELA,DISTRICT,55 - 59,NEVER MARRIED,265,96,169,0,205,86,119,0,60,10,50,0
LASBELA,DISTRICT,55 - 59,SEPERATION,19,12,7,0,11,6,5,0,8,6,2,0
LASBELA,DISTRICT,55 - 59,WIDOWED,1561,1211,350,0,748,545,203,0,813,666,147,0
LASBELA,DISTRICT,60 - 64,DIVORCED,21,12,9,0,13,9,4,0,8,3,5,0
LASBELA,DISTRICT,60 - 64,MARRIED,8857,3446,5411,0,4708,1914,2794,0,4149,1532,2617,0
LASBELA,DISTRICT,60 - 64,NEVER MARRIED,135,51,83,1,92,36,55,1,43,15,28,0
LASBELA,DISTRICT,60 - 64,SEPERATION,12,8,4,0,5,2,3,0,7,6,1,0
LASBELA,DISTRICT,60 - 64,WIDOWED,1838,1435,403,0,900,676,224,0,938,759,179,0
LASBELA,DISTRICT,65 - 69,DIVORCED,12,10,2,0,10,8,2,0,2,2,0,0
LASBELA,DISTRICT,65 - 69,MARRIED,6324,2409,3915,0,3555,1389,2166,0,2769,1020,1749,0
LASBELA,DISTRICT,65 - 69,NEVER MARRIED,81,24,57,0,50,13,37,0,31,11,20,0
LASBELA,DISTRICT,65 - 69,SEPERATION,11,9,2,0,6,6,0,0,5,3,2,0
LASBELA,DISTRICT,65 - 69,WIDOWED,1735,1361,374,0,843,640,203,0,892,721,171,0
LASBELA,DISTRICT,70 - 74,DIVORCED,5,4,1,0,3,3,0,0,2,1,1,0
LASBELA,DISTRICT,70 - 74,MARRIED,4294,1463,2831,0,2520,881,1639,0,1774,582,1192,0
LASBELA,DISTRICT,70 - 74,NEVER MARRIED,36,10,25,1,23,7,16,0,13,3,9,1
LASBELA,DISTRICT,70 - 74,SEPERATION,7,6,1,0,5,4,1,0,2,2,0,0
LASBELA,DISTRICT,70 - 74,WIDOWED,1839,1387,452,0,1032,757,275,0,807,630,177,0
LASBELA,DISTRICT,75 & ABOVE,DIVORCED,6,5,1,0,6,5,1,0,0,0,0,0
LASBELA,DISTRICT,75 & ABOVE,MARRIED,3243,978,2265,0,2039,628,1411,0,1204,350,854,0
LASBELA,DISTRICT,75 & ABOVE,NEVER MARRIED,32,7,25,0,19,3,16,0,13,4,9,0
LASBELA,DISTRICT,75 & ABOVE,SEPERATION,8,3,5,0,5,2,3,0,3,1,2,0
LASBELA,DISTRICT,75 & ABOVE,WIDOWED,2358,1786,572,0,1438,1068,370,0,920,718,202,0
LORALAI,DISTRICT,15 &  ABOVE,DIVORCED,41,24,17,0,19,15,4,0,22,9,13,0
LORALAI,DISTRICT,15 &  ABOVE,MARRIED,84231,42028,42203,0,66411,33209,33202,0,17820,8819,9001,0
LORALAI,DISTRICT,15 &  ABOVE,NEVER MARRIED,44323,18281,26025,17,32399,13353,19030,16,11924,4928,6995,1
LORALAI,DISTRICT,15 &  ABOVE,SEPERATION,56,11,45,0,42,6,36,0,14,5,9,0
LORALAI,DISTRICT,15 &  ABOVE,WIDOWED,2446,2097,349,0,1786,1536,250,0,660,561,99,0
LORALAI,DISTRICT,15 - 19,DIVORCED,3,2,1,0,0,0,0,0,3,2,1,0
LORALAI,DISTRICT,15 - 19,MARRIED,4161,2655,1506,0,3611,2290,1321,0,550,365,185,0
LORALAI,DISTRICT,15 - 19,NEVER MARRIED,24850,10734,14107,9,18958,8165,10785,8,5892,2569,3322,1
LORALAI,DISTRICT,15 - 19,SEPERATION,9,0,9,0,9,0,9,0,0,0,0,0
LORALAI,DISTRICT,15 - 19,WIDOWED,8,3,5,0,5,2,3,0,3,1,2,0
LORALAI,DISTRICT,20 - 24,DIVORCED,3,1,2,0,1,1,0,0,2,0,2,0
LORALAI,DISTRICT,20 - 24,MARRIED,10193,6055,4138,0,8376,4911,3465,0,1817,1144,673,0
LORALAI,DISTRICT,20 - 24,NEVER MARRIED,11989,4693,7296,0,8367,3248,5119,0,3622,1445,2177,0
LORALAI,DISTRICT,20 - 24,SEPERATION,10,2,8,0,6,0,6,0,4,2,2,0
LORALAI,DISTRICT,20 - 24,WIDOWED,13,5,8,0,11,4,7,0,2,1,1,0
LORALAI,DISTRICT,25 - 29,DIVORCED,7,3,4,0,2,1,1,0,5,2,3,0
LORALAI,DISTRICT,25 - 29,MARRIED,12398,6550,5848,0,9852,5151,4701,0,2546,1399,1147,0
LORALAI,DISTRICT,25 - 29,NEVER MARRIED,4517,1710,2805,2,2962,1138,1822,2,1555,572,983,0
LORALAI,DISTRICT,25 - 29,SEPERATION,6,0,6,0,4,0,4,0,2,0,2,0
LORALAI,DISTRICT,25 - 29,WIDOWED,29,23,6,0,18,14,4,0,11,9,2,0
LORALAI,DISTRICT,30 - 34,DIVORCED,7,5,2,0,4,4,0,0,3,1,2,0
LORALAI,DISTRICT,30 - 34,MARRIED,11893,6358,5535,0,9237,4983,4254,0,2656,1375,1281,0
LORALAI,DISTRICT,30 - 34,NEVER MARRIED,1624,658,966,0,1124,462,662,0,500,196,304,0
LORALAI,DISTRICT,30 - 34,SEPERATION,5,0,5,0,5,0,5,0,0,0,0,0
LORALAI,DISTRICT,30 - 34,WIDOWED,55,49,6,0,42,36,6,0,13,13,0,0
LORALAI,DISTRICT,35 - 39,DIVORCED,5,4,1,0,2,2,0,0,3,2,1,0
LORALAI,DISTRICT,35 - 39,MARRIED,10761,5228,5533,0,8411,4089,4322,0,2350,1139,1211,0
LORALAI,DISTRICT,35 - 39,NEVER MARRIED,614,212,399,3,449,149,297,3,165,63,102,0
LORALAI,DISTRICT,35 - 39,SEPERATION,5,3,2,0,4,2,2,0,1,1,0,0
LORALAI,DISTRICT,35 - 39,WIDOWED,69,60,9,0,41,36,5,0,28,24,4,0
LORALAI,DISTRICT,40 - 44,DIVORCED,7,6,1,0,5,4,1,0,2,2,0,0
LORALAI,DISTRICT,40 - 44,MARRIED,9452,4474,4978,0,7222,3413,3809,0,2230,1061,1169,0
LORALAI,DISTRICT,40 - 44,NEVER MARRIED,335,129,206,0,243,92,151,0,92,37,55,0
LORALAI,DISTRICT,40 - 44,SEPERATION,3,2,1,0,3,2,1,0,0,0,0,0
LORALAI,DISTRICT,40 - 44,WIDOWED,132,113,19,0,92,81,11,0,40,32,8,0
LORALAI,DISTRICT,45 - 49,DIVORCED,1,0,1,0,0,0,0,0,1,0,1,0
LORALAI,DISTRICT,45 - 49,MARRIED,6788,3195,3593,0,5225,2450,2775,0,1563,745,818,0
LORALAI,DISTRICT,45 - 49,NEVER MARRIED,162,52,109,1,120,36,83,1,42,16,26,0
LORALAI,DISTRICT,45 - 49,SEPERATION,2,0,2,0,1,0,1,0,1,0,1,0
LORALAI,DISTRICT,45 - 49,WIDOWED,177,160,17,0,135,123,12,0,42,37,5,0
LORALAI,DISTRICT,50 - 54,DIVORCED,6,3,3,0,4,3,1,0,2,0,2,0
LORALAI,DISTRICT,50 - 54,MARRIED,6085,2759,3326,0,4598,2118,2480,0,1487,641,846,0
LORALAI,DISTRICT,50 - 54,NEVER MARRIED,83,32,51,0,63,22,41,0,20,10,10,0
LORALAI,DISTRICT,50 - 54,SEPERATION,3,1,2,0,2,0,2,0,1,1,0,0
LORALAI,DISTRICT,50 - 54,WIDOWED,245,206,39,0,178,150,28,0,67,56,11,0
LORALAI,DISTRICT,55 - 59,DIVORCED,1,0,1,0,0,0,0,0,1,0,1,0
LORALAI,DISTRICT,55 - 59,MARRIED,4336,1766,2570,0,3363,1391,1972,0,973,375,598,0
LORALAI,DISTRICT,55 - 59,NEVER MARRIED,57,22,34,1,45,16,28,1,12,6,6,0
LORALAI,DISTRICT,55 - 59,SEPERATION,4,2,2,0,4,2,2,0,0,0,0,0
LORALAI,DISTRICT,55 - 59,WIDOWED,286,260,26,0,209,189,20,0,77,71,6,0
LORALAI,DISTRICT,60 - 64,DIVORCED,1,0,1,0,1,0,1,0,0,0,0,0
LORALAI,DISTRICT,60 - 64,MARRIED,3204,1249,1955,0,2526,1016,1510,0,678,233,445,0
LORALAI,DISTRICT,60 - 64,NEVER MARRIED,43,16,27,0,32,10,22,0,11,6,5,0
LORALAI,DISTRICT,60 - 64,SEPERATION,3,1,2,0,1,0,1,0,2,1,1,0
LORALAI,DISTRICT,60 - 64,WIDOWED,333,287,46,0,241,206,35,0,92,81,11,0
LORALAI,DISTRICT,65 - 69,DIVORCED,0,0,0,0,0,0,0,0,0,0,0,0
LORALAI,DISTRICT,65 - 69,MARRIED,2054,740,1314,0,1616,576,1040,0,438,164,274,0
LORALAI,DISTRICT,65 - 69,NEVER MARRIED,24,11,12,1,16,7,8,1,8,4,4,0
LORALAI,DISTRICT,65 - 69,SEPERATION,1,0,1,0,1,0,1,0,0,0,0,0
LORALAI,DISTRICT,65 - 69,WIDOWED,290,254,36,0,215,188,27,0,75,66,9,0
LORALAI,DISTRICT,70 - 74,DIVORCED,0,0,0,0,0,0,0,0,0,0,0,0
LORALAI,DISTRICT,70 - 74,MARRIED,1564,588,976,0,1259,484,775,0,305,104,201,0
LORALAI,DISTRICT,70 - 74,NEVER MARRIED,12,7,5,0,10,5,5,0,2,2,0,0
LORALAI,DISTRICT,70 - 74,SEPERATION,2,0,2,0,1,0,1,0,1,0,1,0
LORALAI,DISTRICT,70 - 74,WIDOWED,356,303,53,0,266,228,38,0,90,75,15,0
LORALAI,DISTRICT,75 & ABOVE,DIVORCED,0,0,0,0,0,0,0,0,0,0,0,0
LORALAI,DISTRICT,75 & ABOVE,MARRIED,1342,411,931,0,1115,337,778,0,227,74,153,0
LORALAI,DISTRICT,75 & ABOVE,NEVER MARRIED,13,5,8,0,10,3,7,0,3,2,1,0
LORALAI,DISTRICT,75 & ABOVE,SEPERATION,3,0,3,0,1,0,1,0,2,0,2,0
LORALAI,DISTRICT,75 & ABOVE,WIDOWED,453,374,79,0,333,279,54,0,120,95,25,0
MASTUNG,DISTRICT,15 &  ABOVE,DIVORCED,78,61,17,0,68,52,16,0,10,9,1,0
MASTUNG,DISTRICT,15 &  ABOVE,MARRIED,99079,50357,48722,0,86048,43753,42295,0,13031,6604,6427,0
MASTUNG,DISTRICT,15 &  ABOVE,NEVER MARRIED,56847,22580,34264,3,47776,18843,28930,3,9071,3737,5334,0
MASTUNG,DISTRICT,15 &  ABOVE,SEPERATION,110,27,83,0,106,24,82,0,4,3,1,0
MASTUNG,DISTRICT,15 &  ABOVE,WIDOWED,3815,3077,738,0,3286,2611,675,0,529,466,63,0
MASTUNG,DISTRICT,15 - 19,DIVORCED,2,2,0,0,2,2,0,0,0,0,0,0
MASTUNG,DISTRICT,15 - 19,MARRIED,3366,2397,969,0,3079,2207,872,0,287,190,97,0
MASTUNG,DISTRICT,15 - 19,NEVER MARRIED,30308,12531,17775,2,26004,10671,15331,2,4304,1860,2444,0
MASTUNG,DISTRICT,15 - 19,SEPERATION,13,2,11,0,12,2,10,0,1,0,1,0
MASTUNG,DISTRICT,15 - 19,WIDOWED,13,8,5,0,13,8,5,0,0,0,0,0
MASTUNG,DISTRICT,20 - 24,DIVORCED,14,13,1,0,12,11,1,0,2,2,0,0
MASTUNG,DISTRICT,20 - 24,MARRIED,10610,6680,3930,0,9670,6069,3601,0,940,611,329,0
MASTUNG,DISTRICT,20 - 24,NEVER MARRIED,15056,5711,9345,0,12558,4676,7882,0,2498,1035,1463,0
MASTUNG,DISTRICT,20 - 24,SEPERATION,10,3,7,0,10,3,7,0,0,0,0,0
MASTUNG,DISTRICT,20 - 24,WIDOWED,42,25,17,0,40,25,15,0,2,0,2,0
MASTUNG,DISTRICT,25 - 29,DIVORCED,12,9,3,0,10,7,3,0,2,2,0,0
MASTUNG,DISTRICT,25 - 29,MARRIED,13618,7674,5944,0,12008,6670,5338,0,1610,1004,606,0
MASTUNG,DISTRICT,25 - 29,NEVER MARRIED,6380,2237,4143,0,5158,1821,3337,0,1222,416,806,0
MASTUNG,DISTRICT,25 - 29,SEPERATION,20,2,18,0,20,2,18,0,0,0,0,0
MASTUNG,DISTRICT,25 - 29,WIDOWED,63,51,12,0,57,45,12,0,6,6,0,0
MASTUNG,DISTRICT,30 - 34,DIVORCED,13,12,1,0,11,10,1,0,2,2,0,0
MASTUNG,DISTRICT,30 - 34,MARRIED,14389,7845,6544,0,12531,6820,5711,0,1858,1025,833,0
MASTUNG,DISTRICT,30 - 34,NEVER MARRIED,2706,1068,1638,0,2160,849,1311,0,546,219,327,0
MASTUNG,DISTRICT,30 - 34,SEPERATION,15,3,12,0,14,2,12,0,1,1,0,0
MASTUNG,DISTRICT,30 - 34,WIDOWED,102,77,25,0,96,73,23,0,6,4,2,0
MASTUNG,DISTRICT,35 - 39,DIVORCED,15,12,3,0,12,10,2,0,3,2,1,0
MASTUNG,DISTRICT,35 - 39,MARRIED,13516,6794,6722,0,11687,5858,5829,0,1829,936,893,0
MASTUNG,DISTRICT,35 - 39,NEVER MARRIED,1291,520,771,0,1018,421,597,0,273,99,174,0
MASTUNG,DISTRICT,35 - 39,SEPERATION,15,3,12,0,15,3,12,0,0,0,0,0
MASTUNG,DISTRICT,35 - 39,WIDOWED,141,109,32,0,126,94,32,0,15,15,0,0
MASTUNG,DISTRICT,40 - 44,DIVORCED,7,5,2,0,7,5,2,0,0,0,0,0
MASTUNG,DISTRICT,40 - 44,MARRIED,12596,5888,6708,0,10816,5040,5776,0,1780,848,932,0
MASTUNG,DISTRICT,40 - 44,NEVER MARRIED,592,266,326,0,490,223,267,0,102,43,59,0
MASTUNG,DISTRICT,40 - 44,SEPERATION,17,4,13,0,17,4,13,0,0,0,0,0
MASTUNG,DISTRICT,40 - 44,WIDOWED,241,191,50,0,221,173,48,0,20,18,2,0
MASTUNG,DISTRICT,45 - 49,DIVORCED,6,2,4,0,5,1,4,0,1,1,0,0
MASTUNG,DISTRICT,45 - 49,MARRIED,8800,4022,4778,0,7453,3393,4060,0,1347,629,718,0
MASTUNG,DISTRICT,45 - 49,NEVER MARRIED,256,129,127,0,197,101,96,0,59,28,31,0
MASTUNG,DISTRICT,45 - 49,SEPERATION,7,3,4,0,7,3,4,0,0,0,0,0
MASTUNG,DISTRICT,45 - 49,WIDOWED,292,261,31,0,251,222,29,0,41,39,2,0
MASTUNG,DISTRICT,50 - 54,DIVORCED,3,2,1,0,3,2,1,0,0,0,0,0
MASTUNG,DISTRICT,50 - 54,MARRIED,7665,3486,4179,0,6491,2960,3531,0,1174,526,648,0
MASTUNG,DISTRICT,50 - 54,NEVER MARRIED,121,49,72,0,90,33,57,0,31,16,15,0
MASTUNG,DISTRICT,50 - 54,SEPERATION,6,6,0,0,5,5,0,0,1,1,0,0
MASTUNG,DISTRICT,50 - 54,WIDOWED,439,379,60,0,368,314,54,0,71,65,6,0
MASTUNG,DISTRICT,55 - 59,DIVORCED,0,0,0,0,0,0,0,0,0,0,0,0
MASTUNG,DISTRICT,55 - 59,MARRIED,5064,2141,2923,0,4228,1790,2438,0,836,351,485,0
MASTUNG,DISTRICT,55 - 59,NEVER MARRIED,55,35,19,1,40,26,13,1,15,9,6,0
MASTUNG,DISTRICT,55 - 59,SEPERATION,0,0,0,0,0,0,0,0,0,0,0,0
MASTUNG,DISTRICT,55 - 59,WIDOWED,421,364,57,0,360,306,54,0,61,58,3,0
MASTUNG,DISTRICT,60 - 64,DIVORCED,2,1,1,0,2,1,1,0,0,0,0,0
MASTUNG,DISTRICT,60 - 64,MARRIED,4008,1557,2451,0,3394,1339,2055,0,614,218,396,0
MASTUNG,DISTRICT,60 - 64,NEVER MARRIED,28,15,13,0,19,8,11,0,9,7,2,0
MASTUNG,DISTRICT,60 - 64,SEPERATION,3,1,2,0,2,0,2,0,1,1,0,0
MASTUNG,DISTRICT,60 - 64,WIDOWED,602,477,125,0,508,397,111,0,94,80,14,0
MASTUNG,DISTRICT,65 - 69,DIVORCED,0,0,0,0,0,0,0,0,0,0,0,0
MASTUNG,DISTRICT,65 - 69,MARRIED,2419,914,1505,0,2053,783,1270,0,366,131,235,0
MASTUNG,DISTRICT,65 - 69,NEVER MARRIED,18,5,13,0,15,5,10,0,3,0,3,0
MASTUNG,DISTRICT,65 - 69,SEPERATION,2,0,2,0,2,0,2,0,0,0,0,0
MASTUNG,DISTRICT,65 - 69,WIDOWED,500,397,103,0,423,329,94,0,77,68,9,0
MASTUNG,DISTRICT,70 - 74,DIVORCED,3,3,0,0,3,3,0,0,0,0,0,0
MASTUNG,DISTRICT,70 - 74,MARRIED,1704,560,1144,0,1487,488,999,0,217,72,145,0
MASTUNG,DISTRICT,70 - 74,NEVER MARRIED,21,8,13,0,17,5,12,0,4,3,1,0
MASTUNG,DISTRICT,70 - 74,SEPERATION,1,0,1,0,1,0,1,0,0,0,0,0
MASTUNG,DISTRICT,70 - 74,WIDOWED,440,353,87,0,377,299,78,0,63,54,9,0
MASTUNG,DISTRICT,75 & ABOVE,DIVORCED,1,0,1,0,1,0,1,0,0,0,0,0
MASTUNG,DISTRICT,75 & ABOVE,MARRIED,1324,399,925,0,1151,336,815,0,173,63,110,0
MASTUNG,DISTRICT,75 & ABOVE,NEVER MARRIED,15,6,9,0,10,4,6,0,5,2,3,0
MASTUNG,DISTRICT,75 & ABOVE,SEPERATION,1,0,1,0,1,0,1,0,0,0,0,0
MASTUNG,DISTRICT,75 & ABOVE,WIDOWED,519,385,134,0,446,326,120,0,73,59,14,0
MUSAKHEL,DISTRICT,15 &  ABOVE,DIVORCED,43,27,16,0,39,23,16,0,4,4,0,0
MUSAKHEL,DISTRICT,15 &  ABOVE,MARRIED,60380,30903,29477,0,56175,28708,27467,0,4205,2195,2010,0
MUSAKHEL,DISTRICT,15 &  ABOVE,NEVER MARRIED,18980,7062,11916,2,16611,6103,10506,2,2369,959,1410,0
MUSAKHEL,DISTRICT,15 &  ABOVE,SEPERATION,237,198,39,0,215,185,30,0,22,13,9,0
MUSAKHEL,DISTRICT,15 &  ABOVE,WIDOWED,2109,1793,316,0,1874,1596,278,0,235,197,38,0
MUSAKHEL,DISTRICT,15 - 19,DIVORCED,2,0,2,0,2,0,2,0,0,0,0,0
MUSAKHEL,DISTRICT,15 - 19,MARRIED,4989,3505,1484,0,4680,3302,1378,0,309,203,106,0
MUSAKHEL,DISTRICT,15 - 19,NEVER MARRIED,13948,5266,8682,0,12212,4579,7633,0,1736,687,1049,0
MUSAKHEL,DISTRICT,15 - 19,SEPERATION,7,2,5,0,7,2,5,0,0,0,0,0
MUSAKHEL,DISTRICT,15 - 19,WIDOWED,7,1,6,0,7,1,6,0,0,0,0,0
MUSAKHEL,DISTRICT,20 - 24,DIVORCED,5,2,3,0,4,1,3,0,1,1,0,0
MUSAKHEL,DISTRICT,20 - 24,MARRIED,8937,5323,3614,0,8227,4871,3356,0,710,452,258,0
MUSAKHEL,DISTRICT,20 - 24,NEVER MARRIED,3426,1242,2183,1,2999,1054,1944,1,427,188,239,0
MUSAKHEL,DISTRICT,20 - 24,SEPERATION,12,1,11,0,8,1,7,0,4,0,4,0
MUSAKHEL,DISTRICT,20 - 24,WIDOWED,21,6,15,0,18,5,13,0,3,1,2,0
MUSAKHEL,DISTRICT,25 - 29,DIVORCED,4,0,4,0,4,0,4,0,0,0,0,0
MUSAKHEL,DISTRICT,25 - 29,MARRIED,8428,4451,3977,0,7783,4092,3691,0,645,359,286,0
MUSAKHEL,DISTRICT,25 - 29,NEVER MARRIED,1002,318,683,1,865,261,603,1,137,57,80,0
MUSAKHEL,DISTRICT,25 - 29,SEPERATION,7,5,2,0,5,3,2,0,2,2,0,0
MUSAKHEL,DISTRICT,25 - 29,WIDOWED,49,28,21,0,43,26,17,0,6,2,4,0
MUSAKHEL,DISTRICT,30 - 34,DIVORCED,5,3,2,0,5,3,2,0,0,0,0,0
MUSAKHEL,DISTRICT,30 - 34,MARRIED,8147,4339,3808,0,7619,4063,3556,0,528,276,252,0
MUSAKHEL,DISTRICT,30 - 34,NEVER MARRIED,345,130,215,0,310,120,190,0,35,10,25,0
MUSAKHEL,DISTRICT,30 - 34,SEPERATION,26,23,3,0,24,21,3,0,2,2,0,0
MUSAKHEL,DISTRICT,30 - 34,WIDOWED,51,34,17,0,40,27,13,0,11,7,4,0
MUSAKHEL,DISTRICT,35 - 39,DIVORCED,5,5,0,0,4,4,0,0,1,1,0,0
MUSAKHEL,DISTRICT,35 - 39,MARRIED,6847,3311,3536,0,6335,3061,3274,0,512,250,262,0
MUSAKHEL,DISTRICT,35 - 39,NEVER MARRIED,121,50,71,0,101,40,61,0,20,10,10,0
MUSAKHEL,DISTRICT,35 - 39,SEPERATION,29,23,6,0,27,22,5,0,2,1,1,0
MUSAKHEL,DISTRICT,35 - 39,WIDOWED,92,73,19,0,76,59,17,0,16,14,2,0
MUSAKHEL,DISTRICT,40 - 44,DIVORCED,3,3,0,0,3,3,0,0,0,0,0,0
MUSAKHEL,DISTRICT,40 - 44,MARRIED,6279,3050,3229,0,5852,2850,3002,0,427,200,227,0
MUSAKHEL,DISTRICT,40 - 44,NEVER MARRIED,72,31,41,0,63,26,37,0,9,5,4,0
MUSAKHEL,DISTRICT,40 - 44,SEPERATION,30,27,3,0,29,27,2,0,1,0,1,0
MUSAKHEL,DISTRICT,40 - 44,WIDOWED,147,123,24,0,132,110,22,0,15,13,2,0
MUSAKHEL,DISTRICT,45 - 49,DIVORCED,8,6,2,0,8,6,2,0,0,0,0,0
MUSAKHEL,DISTRICT,45 - 49,MARRIED,4689,2234,2455,0,4379,2081,2298,0,310,153,157,0
MUSAKHEL,DISTRICT,45 - 49,NEVER MARRIED,27,9,18,0,24,8,16,0,3,1,2,0
MUSAKHEL,DISTRICT,45 - 49,SEPERATION,42,41,1,0,37,36,1,0,5,5,0,0
MUSAKHEL,DISTRICT,45 - 49,WIDOWED,135,121,14,0,118,105,13,0,17,16,1,0
MUSAKHEL,DISTRICT,50 - 54,DIVORCED,3,3,0,0,3,3,0,0,0,0,0,0
MUSAKHEL,DISTRICT,50 - 54,MARRIED,4204,1843,2361,0,3939,1723,2216,0,265,120,145,0
MUSAKHEL,DISTRICT,50 - 54,NEVER MARRIED,14,5,9,0,13,5,8,0,1,0,1,0
MUSAKHEL,DISTRICT,50 - 54,SEPERATION,28,27,1,0,28,27,1,0,0,0,0,0
MUSAKHEL,DISTRICT,50 - 54,WIDOWED,248,222,26,0,218,194,24,0,30,28,2,0
MUSAKHEL,DISTRICT,55 - 59,DIVORCED,2,2,0,0,0,0,0,0,2,2,0,0
MUSAKHEL,DISTRICT,55 - 59,MARRIED,2604,1016,1588,0,2437,954,1483,0,167,62,105,0
MUSAKHEL,DISTRICT,55 - 59,NEVER MARRIED,7,5,2,0,6,4,2,0,1,1,0,0
MUSAKHEL,DISTRICT,55 - 59,SEPERATION,16,14,2,0,13,12,1,0,3,2,1,0
MUSAKHEL,DISTRICT,55 - 59,WIDOWED,222,201,21,0,198,178,20,0,24,23,1,0
MUSAKHEL,DISTRICT,60 - 64,DIVORCED,3,1,2,0,3,1,2,0,0,0,0,0
MUSAKHEL,DISTRICT,60 - 64,MARRIED,1960,807,1153,0,1826,750,1076,0,134,57,77,0
MUSAKHEL,DISTRICT,60 - 64,NEVER MARRIED,5,1,4,0,5,1,4,0,0,0,0,0
MUSAKHEL,DISTRICT,60 - 64,SEPERATION,21,18,3,0,20,18,2,0,1,0,1,0
MUSAKHEL,DISTRICT,60 - 64,WIDOWED,269,234,35,0,239,210,29,0,30,24,6,0
MUSAKHEL,DISTRICT,65 - 69,DIVORCED,2,1,1,0,2,1,1,0,0,0,0,0
MUSAKHEL,DISTRICT,65 - 69,MARRIED,1293,446,847,0,1216,418,798,0,77,28,49,0
MUSAKHEL,DISTRICT,65 - 69,NEVER MARRIED,7,3,4,0,7,3,4,0,0,0,0,0
MUSAKHEL,DISTRICT,65 - 69,SEPERATION,7,6,1,0,5,5,0,0,2,1,1,0
MUSAKHEL,DISTRICT,65 - 69,WIDOWED,197,170,27,0,178,155,23,0,19,15,4,0
MUSAKHEL,DISTRICT,70 - 74,DIVORCED,0,0,0,0,0,0,0,0,0,0,0,0
MUSAKHEL,DISTRICT,70 - 74,MARRIED,1053,346,707,0,983,324,659,0,70,22,48,0
MUSAKHEL,DISTRICT,70 - 74,NEVER MARRIED,2,1,1,0,2,1,1,0,0,0,0,0
MUSAKHEL,DISTRICT,70 - 74,SEPERATION,7,7,0,0,7,7,0,0,0,0,0,0
MUSAKHEL,DISTRICT,70 - 74,WIDOWED,296,264,32,0,266,240,26,0,30,24,6,0
MUSAKHEL,DISTRICT,75 & ABOVE,DIVORCED,1,1,0,0,1,1,0,0,0,0,0,0
MUSAKHEL,DISTRICT,75 & ABOVE,MARRIED,950,232,718,0,899,219,680,0,51,13,38,0
MUSAKHEL,DISTRICT,75 & ABOVE,NEVER MARRIED,4,1,3,0,4,1,3,0,0,0,0,0
MUSAKHEL,DISTRICT,75 & ABOVE,SEPERATION,5,4,1,0,5,4,1,0,0,0,0,0
MUSAKHEL,DISTRICT,75 & ABOVE,WIDOWED,375,316,59,0,341,286,55,0,34,30,4,0
NASIRABAD,DISTRICT,15 &  ABOVE,DIVORCED,114,77,37,0,81,55,26,0,33,22,11,0
NASIRABAD,DISTRICT,15 &  ABOVE,MARRIED,194518,98788,95730,0,159521,81237,78284,0,34997,17551,17446,0
NASIRABAD,DISTRICT,15 &  ABOVE,NEVER MARRIED,66630,27958,38657,15,50870,20847,30010,13,15760,7111,8647,2
NASIRABAD,DISTRICT,15 &  ABOVE,SEPERATION,194,77,117,0,164,55,109,0,30,22,8,0
NASIRABAD,DISTRICT,15 &  ABOVE,WIDOWED,6657,4942,1715,0,4921,3559,1362,0,1736,1383,353,0
NASIRABAD,DISTRICT,15 - 19,DIVORCED,3,1,2,0,2,1,1,0,1,0,1,0
NASIRABAD,DISTRICT,15 - 19,MARRIED,12376,7403,4973,0,10923,6474,4449,0,1453,929,524,0
NASIRABAD,DISTRICT,15 - 19,NEVER MARRIED,45678,20219,25450,9,35979,15594,20376,9,9699,4625,5074,0
NASIRABAD,DISTRICT,15 - 19,SEPERATION,24,9,15,0,18,4,14,0,6,5,1,0
NASIRABAD,DISTRICT,15 - 19,WIDOWED,37,7,30,0,35,7,28,0,2,0,2,0
NASIRABAD,DISTRICT,20 - 24,DIVORCED,18,13,5,0,12,9,3,0,6,4,2,0
NASIRABAD,DISTRICT,20 - 24,MARRIED,28108,15860,12248,0,23551,13214,10337,0,4557,2646,1911,0
NASIRABAD,DISTRICT,20 - 24,NEVER MARRIED,13797,5025,8771,1,9991,3497,6494,0,3806,1528,2277,1
NASIRABAD,DISTRICT,20 - 24,SEPERATION,14,4,10,0,12,2,10,0,2,2,0,0
NASIRABAD,DISTRICT,20 - 24,WIDOWED,105,41,64,0,81,27,54,0,24,14,10,0
NASIRABAD,DISTRICT,25 - 29,DIVORCED,16,11,5,0,11,9,2,0,5,2,3,0
NASIRABAD,DISTRICT,25 - 29,MARRIED,28534,14828,13706,0,23284,12062,11222,0,5250,2766,2484,0
NASIRABAD,DISTRICT,25 - 29,NEVER MARRIED,4338,1700,2638,0,2943,1101,1842,0,1395,599,796,0
NASIRABAD,DISTRICT,25 - 29,SEPERATION,10,2,8,0,8,2,6,0,2,0,2,0
NASIRABAD,DISTRICT,25 - 29,WIDOWED,147,72,75,0,113,53,60,0,34,19,15,0
NASIRABAD,DISTRICT,30 - 34,DIVORCED,15,12,3,0,13,10,3,0,2,2,0,0
NASIRABAD,DISTRICT,30 - 34,MARRIED,26135,13885,12250,0,20907,11129,9778,0,5228,2756,2472,0
NASIRABAD,DISTRICT,30 - 34,NEVER MARRIED,1488,621,867,0,1016,405,611,0,472,216,256,0
NASIRABAD,DISTRICT,30 - 34,SEPERATION,22,10,12,0,16,5,11,0,6,5,1,0
NASIRABAD,DISTRICT,30 - 34,WIDOWED,229,129,100,0,170,85,85,0,59,44,15,0
NASIRABAD,DISTRICT,35 - 39,DIVORCED,14,10,4,0,7,5,2,0,7,5,2,0
NASIRABAD,DISTRICT,35 - 39,MARRIED,24648,12563,12085,0,19862,10186,9676,0,4786,2377,2409,0
NASIRABAD,DISTRICT,35 - 39,NEVER MARRIED,698,208,489,1,491,135,356,0,207,73,133,1
NASIRABAD,DISTRICT,35 - 39,SEPERATION,28,10,18,0,28,10,18,0,0,0,0,0
NASIRABAD,DISTRICT,35 - 39,WIDOWED,344,222,122,0,259,154,105,0,85,68,17,0
NASIRABAD,DISTRICT,40 - 44,DIVORCED,10,8,2,0,7,5,2,0,3,3,0,0
NASIRABAD,DISTRICT,40 - 44,MARRIED,23920,11625,12295,0,19541,9561,9980,0,4379,2064,2315,0
NASIRABAD,DISTRICT,40 - 44,NEVER MARRIED,296,99,197,0,199,60,139,0,97,39,58,0
NASIRABAD,DISTRICT,40 - 44,SEPERATION,22,6,16,0,20,5,15,0,2,1,1,0
NASIRABAD,DISTRICT,40 - 44,WIDOWED,503,380,123,0,376,270,106,0,127,110,17,0
NASIRABAD,DISTRICT,45 - 49,DIVORCED,14,12,2,0,11,9,2,0,3,3,0,0
NASIRABAD,DISTRICT,45 - 49,MARRIED,15312,6987,8325,0,12532,5731,6801,0,2780,1256,1524,0
NASIRABAD,DISTRICT,45 - 49,NEVER MARRIED,148,42,105,1,110,28,81,1,38,14,24,0
NASIRABAD,DISTRICT,45 - 49,SEPERATION,18,8,10,0,16,7,9,0,2,1,1,0
NASIRABAD,DISTRICT,45 - 49,WIDOWED,578,449,129,0,416,314,102,0,162,135,27,0
NASIRABAD,DISTRICT,50 - 54,DIVORCED,8,6,2,0,6,4,2,0,2,2,0,0
NASIRABAD,DISTRICT,50 - 54,MARRIED,12086,5735,6351,0,9607,4607,5000,0,2479,1128,1351,0
NASIRABAD,DISTRICT,50 - 54,NEVER MARRIED,62,12,48,2,45,9,34,2,17,3,14,0
NASIRABAD,DISTRICT,50 - 54,SEPERATION,15,8,7,0,11,5,6,0,4,3,1,0
NASIRABAD,DISTRICT,50 - 54,WIDOWED,739,600,139,0,538,434,104,0,201,166,35,0
NASIRABAD,DISTRICT,55 - 59,DIVORCED,5,3,2,0,4,2,2,0,1,1,0,0
NASIRABAD,DISTRICT,55 - 59,MARRIED,8448,3806,4642,0,6847,3142,3705,0,1601,664,937,0
NASIRABAD,DISTRICT,55 - 59,NEVER MARRIED,54,15,39,0,41,10,31,0,13,5,8,0
NASIRABAD,DISTRICT,55 - 59,SEPERATION,11,6,5,0,7,2,5,0,4,4,0,0
NASIRABAD,DISTRICT,55 - 59,WIDOWED,680,520,160,0,473,359,114,0,207,161,46,0
NASIRABAD,DISTRICT,60 - 64,DIVORCED,4,0,4,0,3,0,3,0,1,0,1,0
NASIRABAD,DISTRICT,60 - 64,MARRIED,6273,2744,3529,0,5147,2270,2877,0,1126,474,652,0
NASIRABAD,DISTRICT,60 - 64,NEVER MARRIED,25,9,16,0,18,4,14,0,7,5,2,0
NASIRABAD,DISTRICT,60 - 64,SEPERATION,9,7,2,0,9,7,2,0,0,0,0,0
NASIRABAD,DISTRICT,60 - 64,WIDOWED,919,724,195,0,657,510,147,0,262,214,48,0
NASIRABAD,DISTRICT,65 - 69,DIVORCED,2,0,2,0,1,0,1,0,1,0,1,0
NASIRABAD,DISTRICT,65 - 69,MARRIED,3693,1495,2198,0,3038,1251,1787,0,655,244,411,0
NASIRABAD,DISTRICT,65 - 69,NEVER MARRIED,19,5,14,0,14,2,12,0,5,3,2,0
NASIRABAD,DISTRICT,65 - 69,SEPERATION,7,2,5,0,7,2,5,0,0,0,0,0
NASIRABAD,DISTRICT,65 - 69,WIDOWED,720,568,152,0,540,423,117,0,180,145,35,0
NASIRABAD,DISTRICT,70 - 74,DIVORCED,2,1,1,0,2,1,1,0,0,0,0,0
NASIRABAD,DISTRICT,70 - 74,MARRIED,2577,1007,1570,0,2210,867,1343,0,367,140,227,0
NASIRABAD,DISTRICT,70 - 74,NEVER MARRIED,16,2,14,0,13,1,12,0,3,1,2,0
NASIRABAD,DISTRICT,70 - 74,SEPERATION,9,5,4,0,7,4,3,0,2,1,1,0
NASIRABAD,DISTRICT,70 - 74,WIDOWED,705,549,156,0,530,406,124,0,175,143,32,0
NASIRABAD,DISTRICT,75 & ABOVE,DIVORCED,3,0,3,0,2,0,2,0,1,0,1,0
NASIRABAD,DISTRICT,75 & ABOVE,MARRIED,2408,850,1558,0,2072,743,1329,0,336,107,229,0
NASIRABAD,DISTRICT,75 & ABOVE,NEVER MARRIED,11,1,9,1,10,1,8,1,1,0,1,0
NASIRABAD,DISTRICT,75 & ABOVE,SEPERATION,5,0,5,0,5,0,5,0,0,0,0,0
NASIRABAD,DISTRICT,75 & ABOVE,WIDOWED,951,681,270,0,733,517,216,0,218,164,54,0
NUSHKI,DISTRICT,15 &  ABOVE,DIVORCED,62,47,15,0,48,39,9,0,14,8,6,0
NUSHKI,DISTRICT,15 &  ABOVE,MARRIED,65094,33168,31926,0,49836,25431,24405,0,15258,7737,7521,0
NUSHKI,DISTRICT,15 &  ABOVE,NEVER MARRIED,39380,16684,22691,5,28985,12356,16625,4,10395,4328,6066,1
NUSHKI,DISTRICT,15 &  ABOVE,SEPERATION,38,25,13,0,28,18,10,0,10,7,3,0
NUSHKI,DISTRICT,15 &  ABOVE,WIDOWED,2517,2128,389,0,1865,1593,272,0,652,535,117,0
NUSHKI,DISTRICT,15 - 19,DIVORCED,6,6,0,0,5,5,0,0,1,1,0,0
NUSHKI,DISTRICT,15 - 19,MARRIED,1858,1379,479,0,1408,1040,368,0,450,339,111,0
NUSHKI,DISTRICT,15 - 19,NEVER MARRIED,19593,8696,10896,1,14602,6499,8102,1,4991,2197,2794,0
NUSHKI,DISTRICT,15 - 19,SEPERATION,2,1,1,0,2,1,1,0,0,0,0,0
NUSHKI,DISTRICT,15 - 19,WIDOWED,8,5,3,0,7,5,2,0,1,0,1,0
NUSHKI,DISTRICT,20 - 24,DIVORCED,12,9,3,0,11,9,2,0,1,0,1,0
NUSHKI,DISTRICT,20 - 24,MARRIED,6334,4315,2019,0,4946,3372,1574,0,1388,943,445,0
NUSHKI,DISTRICT,20 - 24,NEVER MARRIED,10826,4308,6517,1,7863,3163,4699,1,2963,1145,1818,0
NUSHKI,DISTRICT,20 - 24,SEPERATION,4,2,2,0,2,1,1,0,2,1,1,0
NUSHKI,DISTRICT,20 - 24,WIDOWED,15,11,4,0,13,9,4,0,2,2,0,0
NUSHKI,DISTRICT,25 - 29,DIVORCED,7,5,2,0,7,5,2,0,0,0,0,0
NUSHKI,DISTRICT,25 - 29,MARRIED,9278,5438,3840,0,7125,4148,2977,0,2153,1290,863,0
NUSHKI,DISTRICT,25 - 29,NEVER MARRIED,5111,1948,3162,1,3736,1424,2311,1,1375,524,851,0
NUSHKI,DISTRICT,25 - 29,SEPERATION,4,3,1,0,2,1,1,0,2,2,0,0
NUSHKI,DISTRICT,25 - 29,WIDOWED,39,26,13,0,32,22,10,0,7,4,3,0
NUSHKI,DISTRICT,30 - 34,DIVORCED,10,6,4,0,7,6,1,0,3,0,3,0
NUSHKI,DISTRICT,30 - 34,MARRIED,10134,5263,4871,0,7693,4018,3675,0,2441,1245,1196,0
NUSHKI,DISTRICT,30 - 34,NEVER MARRIED,2246,965,1280,1,1606,715,890,1,640,250,390,0
NUSHKI,DISTRICT,30 - 34,SEPERATION,6,4,2,0,6,4,2,0,0,0,0,0
NUSHKI,DISTRICT,30 - 34,WIDOWED,66,55,11,0,52,43,9,0,14,12,2,0
NUSHKI,DISTRICT,35 - 39,DIVORCED,9,7,2,0,6,5,1,0,3,2,1,0
NUSHKI,DISTRICT,35 - 39,MARRIED,8904,4387,4517,0,6829,3412,3417,0,2075,975,1100,0
NUSHKI,DISTRICT,35 - 39,NEVER MARRIED,892,408,484,0,652,286,366,0,240,122,118,0
NUSHKI,DISTRICT,35 - 39,SEPERATION,3,2,1,0,2,2,0,0,1,0,1,0
NUSHKI,DISTRICT,35 - 39,WIDOWED,88,71,17,0,64,55,9,0,24,16,8,0
NUSHKI,DISTRICT,40 - 44,DIVORCED,5,5,0,0,4,4,0,0,1,1,0,0
NUSHKI,DISTRICT,40 - 44,MARRIED,8310,3759,4551,0,6400,2911,3489,0,1910,848,1062,0
NUSHKI,DISTRICT,40 - 44,NEVER MARRIED,395,185,209,1,295,144,151,0,100,41,58,1
NUSHKI,DISTRICT,40 - 44,SEPERATION,3,3,0,0,2,2,0,0,1,1,0,0
NUSHKI,DISTRICT,40 - 44,WIDOWED,166,138,28,0,128,112,16,0,38,26,12,0
NUSHKI,DISTRICT,45 - 49,DIVORCED,4,3,1,0,4,3,1,0,0,0,0,0
NUSHKI,DISTRICT,45 - 49,MARRIED,5691,2606,3085,0,4371,2012,2359,0,1320,594,726,0
NUSHKI,DISTRICT,45 - 49,NEVER MARRIED,158,91,67,0,115,67,48,0,43,24,19,0
NUSHKI,DISTRICT,45 - 49,SEPERATION,4,1,3,0,3,1,2,0,1,0,1,0
NUSHKI,DISTRICT,45 - 49,WIDOWED,193,170,23,0,149,132,17,0,44,38,6,0
NUSHKI,DISTRICT,50 - 54,DIVORCED,5,4,1,0,1,0,1,0,4,4,0,0
NUSHKI,DISTRICT,50 - 54,MARRIED,4772,2221,2551,0,3624,1677,1947,0,1148,544,604,0
NUSHKI,DISTRICT,50 - 54,NEVER MARRIED,85,41,44,0,59,25,34,0,26,16,10,0
NUSHKI,DISTRICT,50 - 54,SEPERATION,4,3,1,0,3,2,1,0,1,1,0,0
NUSHKI,DISTRICT,50 - 54,WIDOWED,295,266,29,0,222,200,22,0,73,66,7,0
NUSHKI,DISTRICT,55 - 59,DIVORCED,1,0,1,0,1,0,1,0,0,0,0,0
NUSHKI,DISTRICT,55 - 59,MARRIED,3617,1512,2105,0,2712,1116,1596,0,905,396,509,0
NUSHKI,DISTRICT,55 - 59,NEVER MARRIED,35,21,14,0,25,15,10,0,10,6,4,0
NUSHKI,DISTRICT,55 - 59,SEPERATION,1,1,0,0,1,1,0,0,0,0,0,0
NUSHKI,DISTRICT,55 - 59,WIDOWED,330,293,37,0,217,195,22,0,113,98,15,0
NUSHKI,DISTRICT,60 - 64,DIVORCED,2,1,1,0,1,1,0,0,1,0,1,0
NUSHKI,DISTRICT,60 - 64,MARRIED,2545,1009,1536,0,1956,768,1188,0,589,241,348,0
NUSHKI,DISTRICT,60 - 64,NEVER MARRIED,19,10,9,0,15,8,7,0,4,2,2,0
NUSHKI,DISTRICT,60 - 64,SEPERATION,0,0,0,0,0,0,0,0,0,0,0,0
NUSHKI,DISTRICT,60 - 64,WIDOWED,350,297,53,0,256,218,38,0,94,79,15,0
NUSHKI,DISTRICT,65 - 69,DIVORCED,0,0,0,0,0,0,0,0,0,0,0,0
NUSHKI,DISTRICT,65 - 69,MARRIED,1694,637,1057,0,1285,461,824,0,409,176,233,0
NUSHKI,DISTRICT,65 - 69,NEVER MARRIED,8,3,5,0,6,3,3,0,2,0,2,0
NUSHKI,DISTRICT,65 - 69,SEPERATION,3,3,0,0,1,1,0,0,2,2,0,0
NUSHKI,DISTRICT,65 - 69,WIDOWED,334,288,46,0,240,209,31,0,94,79,15,0
NUSHKI,DISTRICT,70 - 74,DIVORCED,1,1,0,0,1,1,0,0,0,0,0,0
NUSHKI,DISTRICT,70 - 74,MARRIED,1118,389,729,0,829,294,535,0,289,95,194,0
NUSHKI,DISTRICT,70 - 74,NEVER MARRIED,6,4,2,0,5,3,2,0,1,1,0,0
NUSHKI,DISTRICT,70 - 74,SEPERATION,1,1,0,0,1,1,0,0,0,0,0,0
NUSHKI,DISTRICT,70 - 74,WIDOWED,308,258,50,0,228,190,38,0,80,68,12,0
NUSHKI,DISTRICT,75 & ABOVE,DIVORCED,0,0,0,0,0,0,0,0,0,0,0,0
NUSHKI,DISTRICT,75 & ABOVE,MARRIED,839,253,586,0,658,202,456,0,181,51,130,0
NUSHKI,DISTRICT,75 & ABOVE,NEVER MARRIED,6,4,2,0,6,4,2,0,0,0,0,0
NUSHKI,DISTRICT,75 & ABOVE,SEPERATION,3,1,2,0,3,1,2,0,0,0,0,0
NUSHKI,DISTRICT,75 & ABOVE,WIDOWED,325,250,75,0,257,203,54,0,68,47,21,0
PANJGUR,DISTRICT,15 &  ABOVE,DIVORCED,620,248,372,0,548,213,335,0,72,35,37,0
PANJGUR,DISTRICT,15 &  ABOVE,MARRIED,217355,103077,114278,0,152832,73682,79150,0,64523,29395,35128,0
PANJGUR,DISTRICT,15 &  ABOVE,NEVER MARRIED,77573,33717,43764,92,44445,18916,25499,30,33128,14801,18265,62
PANJGUR,DISTRICT,15 &  ABOVE,SEPERATION,437,92,345,0,386,78,308,0,51,14,37,0
PANJGUR,DISTRICT,15 &  ABOVE,WIDOWED,3273,1728,1545,0,2799,1473,1326,0,474,255,219,0
PANJGUR,DISTRICT,15 - 19,DIVORCED,48,6,42,0,41,5,36,0,7,1,6,0
PANJGUR,DISTRICT,15 - 19,MARRIED,34159,18293,15866,0,24877,13718,11159,0,9282,4575,4707,0
PANJGUR,DISTRICT,15 - 19,NEVER MARRIED,42832,18436,24350,46,26889,11148,15735,6,15943,7288,8615,40
PANJGUR,DISTRICT,15 - 19,SEPERATION,61,17,44,0,49,12,37,0,12,5,7,0
PANJGUR,DISTRICT,15 - 19,WIDOWED,226,27,199,0,188,20,168,0,38,7,31,0
PANJGUR,DISTRICT,20 - 24,DIVORCED,77,27,50,0,66,21,45,0,11,6,5,0
PANJGUR,DISTRICT,20 - 24,MARRIED,35649,18356,17293,0,26632,13944,12688,0,9017,4412,4605,0
PANJGUR,DISTRICT,20 - 24,NEVER MARRIED,16392,7275,9092,25,9649,4224,5414,11,6743,3051,3678,14
PANJGUR,DISTRICT,20 - 24,SEPERATION,34,8,26,0,27,5,22,0,7,3,4,0
PANJGUR,DISTRICT,20 - 24,WIDOWED,187,61,126,0,145,40,105,0,42,21,21,0
PANJGUR,DISTRICT,25 - 29,DIVORCED,70,25,45,0,59,21,38,0,11,4,7,0
PANJGUR,DISTRICT,25 - 29,MARRIED,33477,16527,16950,0,23786,11858,11928,0,9691,4669,5022,0
PANJGUR,DISTRICT,25 - 29,NEVER MARRIED,7456,3709,3743,4,3879,1872,2003,4,3577,1837,1740,0
PANJGUR,DISTRICT,25 - 29,SEPERATION,44,9,35,0,37,8,29,0,7,1,6,0
PANJGUR,DISTRICT,25 - 29,WIDOWED,145,72,73,0,111,53,58,0,34,19,15,0
PANJGUR,DISTRICT,30 - 34,DIVORCED,91,36,55,0,78,31,47,0,13,5,8,0
PANJGUR,DISTRICT,30 - 34,MARRIED,27172,12828,14344,0,18884,8983,9901,0,8288,3845,4443,0
PANJGUR,DISTRICT,30 - 34,NEVER MARRIED,4218,2695,1517,6,1998,1110,886,2,2220,1585,631,4
PANJGUR,DISTRICT,30 - 34,SEPERATION,72,11,61,0,65,9,56,0,7,2,5,0
PANJGUR,DISTRICT,30 - 34,WIDOWED,178,82,96,0,143,72,71,0,35,10,25,0
PANJGUR,DISTRICT,35 - 39,DIVORCED,85,45,40,0,77,42,35,0,8,3,5,0
PANJGUR,DISTRICT,35 - 39,MARRIED,24189,10844,13345,0,16405,7434,8971,0,7784,3410,4374,0
PANJGUR,DISTRICT,35 - 39,NEVER MARRIED,2491,647,1841,3,976,286,689,1,1515,361,1152,2
PANJGUR,DISTRICT,35 - 39,SEPERATION,71,15,56,0,70,15,55,0,1,0,1,0
PANJGUR,DISTRICT,35 - 39,WIDOWED,234,140,94,0,197,124,73,0,37,16,21,0
PANJGUR,DISTRICT,40 - 44,DIVORCED,58,29,29,0,53,26,27,0,5,3,2,0
PANJGUR,DISTRICT,40 - 44,MARRIED,17257,7735,9522,0,11956,5517,6439,0,5301,2218,3083,0
PANJGUR,DISTRICT,40 - 44,NEVER MARRIED,1296,371,924,1,374,129,244,1,922,242,680,0
PANJGUR,DISTRICT,40 - 44,SEPERATION,35,8,27,0,33,8,25,0,2,0,2,0
PANJGUR,DISTRICT,40 - 44,WIDOWED,256,162,94,0,213,142,71,0,43,20,23,0
PANJGUR,DISTRICT,45 - 49,DIVORCED,56,21,35,0,53,18,35,0,3,3,0,0
PANJGUR,DISTRICT,45 - 49,MARRIED,13502,5653,7849,0,9273,3993,5280,0,4229,1660,2569,0
PANJGUR,DISTRICT,45 - 49,NEVER MARRIED,942,248,691,3,198,50,145,3,744,198,546,0
PANJGUR,DISTRICT,45 - 49,SEPERATION,26,6,20,0,20,5,15,0,6,1,5,0
PANJGUR,DISTRICT,45 - 49,WIDOWED,226,128,98,0,197,116,81,0,29,12,17,0
PANJGUR,DISTRICT,50 - 54,DIVORCED,43,27,16,0,37,22,15,0,6,5,1,0
PANJGUR,DISTRICT,50 - 54,MARRIED,9158,4039,5119,0,6470,2797,3673,0,2688,1242,1446,0
PANJGUR,DISTRICT,50 - 54,NEVER MARRIED,647,148,498,1,123,35,87,1,524,113,411,0
PANJGUR,DISTRICT,50 - 54,SEPERATION,28,5,23,0,25,4,21,0,3,1,2,0
PANJGUR,DISTRICT,50 - 54,WIDOWED,277,180,97,0,238,151,87,0,39,29,10,0
PANJGUR,DISTRICT,55 - 59,DIVORCED,32,11,21,0,27,7,20,0,5,4,1,0
PANJGUR,DISTRICT,55 - 59,MARRIED,7428,2949,4479,0,5000,1976,3024,0,2428,973,1455,0
PANJGUR,DISTRICT,55 - 59,NEVER MARRIED,551,98,452,1,123,25,97,1,428,73,355,0
PANJGUR,DISTRICT,55 - 59,SEPERATION,24,5,19,0,22,4,18,0,2,1,1,0
PANJGUR,DISTRICT,55 - 59,WIDOWED,317,196,121,0,260,156,104,0,57,40,17,0
PANJGUR,DISTRICT,60 - 64,DIVORCED,25,10,15,0,24,10,14,0,1,0,1,0
PANJGUR,DISTRICT,60 - 64,MARRIED,5235,1981,3254,0,3451,1304,2147,0,1784,677,1107,0
PANJGUR,DISTRICT,60 - 64,NEVER MARRIED,313,41,271,1,89,16,73,0,224,25,198,1
PANJGUR,DISTRICT,60 - 64,SEPERATION,16,0,16,0,13,0,13,0,3,0,3,0
PANJGUR,DISTRICT,60 - 64,WIDOWED,312,166,146,0,275,142,133,0,37,24,13,0
PANJGUR,DISTRICT,65 - 69,DIVORCED,15,7,8,0,14,7,7,0,1,0,1,0
PANJGUR,DISTRICT,65 - 69,MARRIED,4005,1485,2520,0,2591,952,1639,0,1414,533,881,0
PANJGUR,DISTRICT,65 - 69,NEVER MARRIED,235,26,209,0,77,9,68,0,158,17,141,0
PANJGUR,DISTRICT,65 - 69,SEPERATION,10,2,8,0,10,2,8,0,0,0,0,0
PANJGUR,DISTRICT,65 - 69,WIDOWED,282,154,128,0,249,132,117,0,33,22,11,0
PANJGUR,DISTRICT,70 - 74,DIVORCED,8,1,7,0,8,1,7,0,0,0,0,0
PANJGUR,DISTRICT,70 - 74,MARRIED,2458,958,1500,0,1570,584,986,0,888,374,514,0
PANJGUR,DISTRICT,70 - 74,NEVER MARRIED,75,13,62,0,25,5,20,0,50,8,42,0
PANJGUR,DISTRICT,70 - 74,SEPERATION,3,2,1,0,3,2,1,0,0,0,0,0
PANJGUR,DISTRICT,70 - 74,WIDOWED,228,135,93,0,212,123,89,0,16,12,4,0
PANJGUR,DISTRICT,75 & ABOVE,DIVORCED,12,3,9,0,11,2,9,0,1,1,0,0
PANJGUR,DISTRICT,75 & ABOVE,MARRIED,3666,1429,2237,0,1937,622,1315,0,1729,807,922,0
PANJGUR,DISTRICT,75 & ABOVE,NEVER MARRIED,125,10,114,1,45,7,38,0,80,3,76,1
PANJGUR,DISTRICT,75 & ABOVE,SEPERATION,13,4,9,0,12,4,8,0,1,0,1,0
PANJGUR,DISTRICT,75 & ABOVE,WIDOWED,405,225,180,0,371,202,169,0,34,23,11,0
PISHIN,DISTRICT,15 &  ABOVE,DIVORCED,81,58,23,0,65,46,19,0,16,12,4,0
PISHIN,DISTRICT,15 &  ABOVE,MARRIED,286992,144887,142105,0,203101,102806,100295,0,83891,42081,41810,0
PISHIN,DISTRICT,15 &  ABOVE,NEVER MARRIED,115617,55033,60567,17,79543,37869,41664,10,36074,17164,18903,7
PISHIN,DISTRICT,15 &  ABOVE,SEPERATION,211,110,101,0,149,92,57,0,62,18,44,0
PISHIN,DISTRICT,15 &  ABOVE,WIDOWED,4544,3756,788,0,3285,2691,594,0,1259,1065,194,0
PISHIN,DISTRICT,15 - 19,DIVORCED,3,2,1,0,3,2,1,0,0,0,0,0
PISHIN,DISTRICT,15 - 19,MARRIED,20806,13308,7498,0,15579,9914,5665,0,5227,3394,1833,0
PISHIN,DISTRICT,15 - 19,NEVER MARRIED,72723,34124,38593,6,50761,23875,26882,4,21962,10249,11711,2
PISHIN,DISTRICT,15 - 19,SEPERATION,18,6,12,0,12,5,7,0,6,1,5,0
PISHIN,DISTRICT,15 - 19,WIDOWED,19,8,11,0,16,7,9,0,3,1,2,0
PISHIN,DISTRICT,20 - 24,DIVORCED,5,4,1,0,4,4,0,0,1,0,1,0
PISHIN,DISTRICT,20 - 24,MARRIED,44982,26201,18781,0,33124,19319,13805,0,11858,6882,4976,0
PISHIN,DISTRICT,20 - 24,NEVER MARRIED,29654,14366,15285,3,20100,9648,10450,2,9554,4718,4835,1
PISHIN,DISTRICT,20 - 24,SEPERATION,27,8,19,0,11,3,8,0,16,5,11,0
PISHIN,DISTRICT,20 - 24,WIDOWED,41,24,17,0,27,16,11,0,14,8,6,0
PISHIN,DISTRICT,25 - 29,DIVORCED,10,8,2,0,8,6,2,0,2,2,0,0
PISHIN,DISTRICT,25 - 29,MARRIED,45187,23621,21566,0,31806,16439,15367,0,13381,7182,6199,0
PISHIN,DISTRICT,25 - 29,NEVER MARRIED,8877,4293,4582,2,5831,2814,3015,2,3046,1479,1567,0
PISHIN,DISTRICT,25 - 29,SEPERATION,19,5,14,0,7,3,4,0,12,2,10,0
PISHIN,DISTRICT,25 - 29,WIDOWED,75,52,23,0,56,39,17,0,19,13,6,0
PISHIN,DISTRICT,30 - 34,DIVORCED,21,18,3,0,18,15,3,0,3,3,0,0
PISHIN,DISTRICT,30 - 34,MARRIED,40273,20217,20056,0,28157,14186,13971,0,12116,6031,6085,0
PISHIN,DISTRICT,30 - 34,NEVER MARRIED,2721,1456,1264,1,1772,1004,767,1,949,452,497,0
PISHIN,DISTRICT,30 - 34,SEPERATION,22,11,11,0,16,9,7,0,6,2,4,0
PISHIN,DISTRICT,30 - 34,WIDOWED,97,70,27,0,77,57,20,0,20,13,7,0
PISHIN,DISTRICT,35 - 39,DIVORCED,12,4,8,0,7,1,6,0,5,3,2,0
PISHIN,DISTRICT,35 - 39,MARRIED,34581,17040,17541,0,24232,11860,12372,0,10349,5180,5169,0
PISHIN,DISTRICT,35 - 39,NEVER MARRIED,912,483,428,1,608,329,279,0,304,154,149,1
PISHIN,DISTRICT,35 - 39,SEPERATION,25,13,12,0,18,11,7,0,7,2,5,0
PISHIN,DISTRICT,35 - 39,WIDOWED,139,113,26,0,110,90,20,0,29,23,6,0
PISHIN,DISTRICT,40 - 44,DIVORCED,14,11,3,0,11,9,2,0,3,2,1,0
PISHIN,DISTRICT,40 - 44,MARRIED,29622,13943,15679,0,20567,9746,10821,0,9055,4197,4858,0
PISHIN,DISTRICT,40 - 44,NEVER MARRIED,371,173,197,1,233,106,127,0,138,67,70,1
PISHIN,DISTRICT,40 - 44,SEPERATION,24,16,8,0,20,16,4,0,4,0,4,0
PISHIN,DISTRICT,40 - 44,WIDOWED,275,249,26,0,209,187,22,0,66,62,4,0
PISHIN,DISTRICT,45 - 49,DIVORCED,1,1,0,0,1,1,0,0,0,0,0,0
PISHIN,DISTRICT,45 - 49,MARRIED,20447,9355,11092,0,13916,6344,7572,0,6531,3011,3520,0
PISHIN,DISTRICT,45 - 49,NEVER MARRIED,170,69,101,0,107,43,64,0,63,26,37,0
PISHIN,DISTRICT,45 - 49,SEPERATION,22,19,3,0,19,17,2,0,3,2,1,0
PISHIN,DISTRICT,45 - 49,WIDOWED,329,286,43,0,239,205,34,0,90,81,9,0
PISHIN,DISTRICT,50 - 54,DIVORCED,5,3,2,0,4,2,2,0,1,1,0,0
PISHIN,DISTRICT,50 - 54,MARRIED,15914,7596,8318,0,10990,5360,5630,0,4924,2236,2688,0
PISHIN,DISTRICT,50 - 54,NEVER MARRIED,73,29,44,0,51,21,30,0,22,8,14,0
PISHIN,DISTRICT,50 - 54,SEPERATION,20,14,6,0,17,12,5,0,3,2,1,0
PISHIN,DISTRICT,50 - 54,WIDOWED,507,443,64,0,354,309,45,0,153,134,19,0
PISHIN,DISTRICT,55 - 59,DIVORCED,5,5,0,0,4,4,0,0,1,1,0,0
PISHIN,DISTRICT,55 - 59,MARRIED,12517,5347,7170,0,8776,3756,5020,0,3741,1591,2150,0
PISHIN,DISTRICT,55 - 59,NEVER MARRIED,43,16,26,1,25,9,16,0,18,7,10,1
PISHIN,DISTRICT,55 - 59,SEPERATION,11,6,5,0,9,6,3,0,2,0,2,0
PISHIN,DISTRICT,55 - 59,WIDOWED,569,487,82,0,409,346,63,0,160,141,19,0
PISHIN,DISTRICT,60 - 64,DIVORCED,4,2,2,0,4,2,2,0,0,0,0,0
PISHIN,DISTRICT,60 - 64,MARRIED,9217,3690,5527,0,6466,2629,3837,0,2751,1061,1690,0
PISHIN,DISTRICT,60 - 64,NEVER MARRIED,26,10,16,0,20,9,11,0,6,1,5,0
PISHIN,DISTRICT,60 - 64,SEPERATION,5,4,1,0,5,4,1,0,0,0,0,0
PISHIN,DISTRICT,60 - 64,WIDOWED,676,592,84,0,473,415,58,0,203,177,26,0
PISHIN,DISTRICT,65 - 69,DIVORCED,1,0,1,0,1,0,1,0,0,0,0,0
PISHIN,DISTRICT,65 - 69,MARRIED,5800,2207,3593,0,4148,1597,2551,0,1652,610,1042,0
PISHIN,DISTRICT,65 - 69,NEVER MARRIED,16,6,9,1,13,6,7,0,3,0,2,1
PISHIN,DISTRICT,65 - 69,SEPERATION,4,4,0,0,2,2,0,0,2,2,0,0
PISHIN,DISTRICT,65 - 69,WIDOWED,555,451,104,0,398,321,77,0,157,130,27,0
PISHIN,DISTRICT,70 - 74,DIVORCED,0,0,0,0,0,0,0,0,0,0,0,0
PISHIN,DISTRICT,70 - 74,MARRIED,4147,1450,2697,0,2952,1041,1911,0,1195,409,786,0
PISHIN,DISTRICT,70 - 74,NEVER MARRIED,7,4,3,0,6,3,3,0,1,1,0,0
PISHIN,DISTRICT,70 - 74,SEPERATION,7,4,3,0,6,4,2,0,1,0,1,0
PISHIN,DISTRICT,70 - 74,WIDOWED,579,477,102,0,433,356,77,0,146,121,25,0
PISHIN,DISTRICT,75 & ABOVE,DIVORCED,0,0,0,0,0,0,0,0,0,0,0,0
PISHIN,DISTRICT,75 & ABOVE,MARRIED,3499,912,2587,0,2388,615,1773,0,1111,297,814,0
PISHIN,DISTRICT,75 & ABOVE,NEVER MARRIED,24,4,19,1,16,2,13,1,8,2,6,0
PISHIN,DISTRICT,75 & ABOVE,SEPERATION,7,0,7,0,7,0,7,0,0,0,0,0
PISHIN,DISTRICT,75 & ABOVE,WIDOWED,683,504,179,0,484,343,141,0,199,161,38,0
QUETTA,DISTRICT,15 &  ABOVE,DIVORCED,835,632,203,0,258,178,80,0,577,454,123,0
QUETTA,DISTRICT,15 &  ABOVE,MARRIED,765378,381678,383700,0,323068,162281,160787,0,442310,219397,222913,0
QUETTA,DISTRICT,15 &  ABOVE,NEVER MARRIED,461040,202490,258457,93,186110,79942,106146,22,274930,122548,152311,71
QUETTA,DISTRICT,15 &  ABOVE,SEPERATION,427,211,216,0,169,76,93,0,258,135,123,0
QUETTA,DISTRICT,15 &  ABOVE,WIDOWED,24395,19668,4727,0,9026,7299,1727,0,15369,12369,3000,0
QUETTA,DISTRICT,15 - 19,DIVORCED,11,8,3,0,3,2,1,0,8,6,2,0
QUETTA,DISTRICT,15 - 19,MARRIED,21459,15050,6409,0,10916,7675,3241,0,10543,7375,3168,0
QUETTA,DISTRICT,15 - 19,NEVER MARRIED,236367,108971,127372,24,101019,45926,55085,8,135348,63045,72287,16
QUETTA,DISTRICT,15 - 19,SEPERATION,38,15,23,0,19,7,12,0,19,8,11,0
QUETTA,DISTRICT,15 - 19,WIDOWED,43,22,21,0,18,10,8,0,25,12,13,0
QUETTA,DISTRICT,20 - 24,DIVORCED,56,47,9,0,20,16,4,0,36,31,5,0
QUETTA,DISTRICT,20 - 24,MARRIED,82072,52010,30062,0,39051,24344,14707,0,43021,27666,15355,0
QUETTA,DISTRICT,20 - 24,NEVER MARRIED,131227,54476,76733,18,51880,20860,31016,4,79347,33616,45717,14
QUETTA,DISTRICT,20 - 24,SEPERATION,38,17,21,0,19,6,13,0,19,11,8,0
QUETTA,DISTRICT,20 - 24,WIDOWED,147,92,55,0,76,44,32,0,71,48,23,0
QUETTA,DISTRICT,25 - 29,DIVORCED,112,92,20,0,44,32,12,0,68,60,8,0
QUETTA,DISTRICT,25 - 29,MARRIED,118304,64383,53921,0,52033,28155,23878,0,66271,36228,30043,0
QUETTA,DISTRICT,25 - 29,NEVER MARRIED,54301,21690,32594,17,19715,7667,12046,2,34586,14023,20548,15
QUETTA,DISTRICT,25 - 29,SEPERATION,50,28,22,0,28,12,16,0,22,16,6,0
QUETTA,DISTRICT,25 - 29,WIDOWED,326,249,77,0,156,112,44,0,170,137,33,0
QUETTA,DISTRICT,30 - 34,DIVORCED,166,127,39,0,58,39,19,0,108,88,20,0
QUETTA,DISTRICT,30 - 34,MARRIED,111934,57267,54667,0,46764,23830,22934,0,65170,33437,31733,0
QUETTA,DISTRICT,30 - 34,NEVER MARRIED,20617,10314,10295,8,7121,3492,3628,1,13496,6822,6667,7
QUETTA,DISTRICT,30 - 34,SEPERATION,42,16,26,0,16,5,11,0,26,11,15,0
QUETTA,DISTRICT,30 - 34,WIDOWED,555,406,149,0,257,183,74,0,298,223,75,0
QUETTA,DISTRICT,35 - 39,DIVORCED,153,123,30,0,39,24,15,0,114,99,15,0
QUETTA,DISTRICT,35 - 39,MARRIED,103723,51387,52336,0,42607,21120,21487,0,61116,30267,30849,0
QUETTA,DISTRICT,35 - 39,NEVER MARRIED,8908,3350,5545,13,2988,1002,1984,2,5920,2348,3561,11
QUETTA,DISTRICT,35 - 39,SEPERATION,55,19,36,0,19,7,12,0,36,12,24,0
QUETTA,DISTRICT,35 - 39,WIDOWED,886,681,205,0,394,297,97,0,492,384,108,0
QUETTA,DISTRICT,40 - 44,DIVORCED,143,100,43,0,44,32,12,0,99,68,31,0
QUETTA,DISTRICT,40 - 44,MARRIED,93192,44136,49056,0,37685,17869,19816,0,55507,26267,29240,0
QUETTA,DISTRICT,40 - 44,NEVER MARRIED,4300,1647,2650,3,1450,435,1014,1,2850,1212,1636,2
QUETTA,DISTRICT,40 - 44,SEPERATION,56,28,28,0,19,10,9,0,37,18,19,0
QUETTA,DISTRICT,40 - 44,WIDOWED,1562,1285,277,0,633,530,103,0,929,755,174,0
QUETTA,DISTRICT,45 - 49,DIVORCED,81,61,20,0,23,15,8,0,58,46,12,0
QUETTA,DISTRICT,45 - 49,MARRIED,69232,31625,37607,0,27876,12851,15025,0,41356,18774,22582,0
QUETTA,DISTRICT,45 - 49,NEVER MARRIED,2165,801,1362,2,797,238,558,1,1368,563,804,1
QUETTA,DISTRICT,45 - 49,SEPERATION,34,18,16,0,8,5,3,0,26,13,13,0
QUETTA,DISTRICT,45 - 49,WIDOWED,1966,1670,296,0,773,659,114,0,1193,1011,182,0
QUETTA,DISTRICT,50 - 54,DIVORCED,50,34,16,0,12,10,2,0,38,24,14,0
QUETTA,DISTRICT,50 - 54,MARRIED,54093,24225,29868,0,21694,9818,11876,0,32399,14407,17992,0
QUETTA,DISTRICT,50 - 54,NEVER MARRIED,1344,514,827,3,499,149,349,1,845,365,478,2
QUETTA,DISTRICT,50 - 54,SEPERATION,36,23,13,0,17,10,7,0,19,13,6,0
QUETTA,DISTRICT,50 - 54,WIDOWED,2955,2555,400,0,1133,981,152,0,1822,1574,248,0
QUETTA,DISTRICT,55 - 59,DIVORCED,23,15,8,0,4,1,3,0,19,14,5,0
QUETTA,DISTRICT,55 - 59,MARRIED,40657,16982,23675,0,16049,6670,9379,0,24608,10312,14296,0
QUETTA,DISTRICT,55 - 59,NEVER MARRIED,813,299,511,3,334,86,247,1,479,213,264,2
QUETTA,DISTRICT,55 - 59,SEPERATION,29,19,10,0,7,6,1,0,22,13,9,0
QUETTA,DISTRICT,55 - 59,WIDOWED,3071,2594,477,0,1120,951,169,0,1951,1643,308,0
QUETTA,DISTRICT,60 - 64,DIVORCED,14,7,7,0,6,3,3,0,8,4,4,0
QUETTA,DISTRICT,60 - 64,MARRIED,29663,11194,18469,0,11595,4465,7130,0,18068,6729,11339,0
QUETTA,DISTRICT,60 - 64,NEVER MARRIED,487,210,277,0,168,52,116,0,319,158,161,0
QUETTA,DISTRICT,60 - 64,SEPERATION,24,12,12,0,8,3,5,0,16,9,7,0
QUETTA,DISTRICT,60 - 64,WIDOWED,3529,2938,591,0,1275,1061,214,0,2254,1877,377,0
QUETTA,DISTRICT,65 - 69,DIVORCED,15,12,3,0,3,2,1,0,12,10,2,0
QUETTA,DISTRICT,65 - 69,MARRIED,19014,6828,12186,0,7616,2744,4872,0,11398,4084,7314,0
QUETTA,DISTRICT,65 - 69,NEVER MARRIED,269,105,163,1,90,15,74,1,179,90,89,0
QUETTA,DISTRICT,65 - 69,SEPERATION,11,7,4,0,2,2,0,0,9,5,4,0
QUETTA,DISTRICT,65 - 69,WIDOWED,3176,2580,596,0,1126,910,216,0,2050,1670,380,0
QUETTA,DISTRICT,70 - 74,DIVORCED,6,3,3,0,1,1,0,0,5,2,3,0
QUETTA,DISTRICT,70 - 74,MARRIED,12305,3897,8408,0,5059,1624,3435,0,7246,2273,4973,0
QUETTA,DISTRICT,70 - 74,NEVER MARRIED,138,65,73,0,34,14,20,0,104,51,53,0
QUETTA,DISTRICT,70 - 74,SEPERATION,8,4,4,0,6,3,3,0,2,1,1,0
QUETTA,DISTRICT,70 - 74,WIDOWED,2953,2285,668,0,994,786,208,0,1959,1499,460,0
QUETTA,DISTRICT,75 & ABOVE,DIVORCED,5,3,2,0,1,1,0,0,4,2,2,0
QUETTA,DISTRICT,75 & ABOVE,MARRIED,9730,2694,7036,0,4123,1116,3007,0,5607,1578,4029,0
QUETTA,DISTRICT,75 & ABOVE,NEVER MARRIED,104,48,55,1,15,6,9,0,89,42,46,1
QUETTA,DISTRICT,75 & ABOVE,SEPERATION,6,5,1,0,1,0,1,0,5,5,0,0
QUETTA,DISTRICT,75 & ABOVE,WIDOWED,3226,2311,915,0,1071,775,296,0,2155,1536,619,0
SHERANI,DISTRICT,15 &  ABOVE,DIVORCED,116,69,47,0,116,69,47,0,0,0,0,0
SHERANI,DISTRICT,15 &  ABOVE,MARRIED,67534,34495,33039,0,67534,34495,33039,0,0,0,0,0
SHERANI,DISTRICT,15 &  ABOVE,NEVER MARRIED,19577,7070,12501,6,19577,7070,12501,6,0,0,0,0
SHERANI,DISTRICT,15 &  ABOVE,SEPERATION,282,201,81,0,282,201,81,0,0,0,0,0
SHERANI,DISTRICT,15 &  ABOVE,WIDOWED,823,621,202,0,823,621,202,0,0,0,0,0
SHERANI,DISTRICT,15 - 19,DIVORCED,9,5,4,0,9,5,4,0,0,0,0,0
SHERANI,DISTRICT,15 - 19,MARRIED,6734,3709,3025,0,6734,3709,3025,0,0,0,0,0
SHERANI,DISTRICT,15 - 19,NEVER MARRIED,15415,5602,9808,5,15415,5602,9808,5,0,0,0,0
SHERANI,DISTRICT,15 - 19,SEPERATION,23,3,20,0,23,3,20,0,0,0,0,0
SHERANI,DISTRICT,15 - 19,WIDOWED,9,1,8,0,9,1,8,0,0,0,0,0
SHERANI,DISTRICT,20 - 24,DIVORCED,10,6,4,0,10,6,4,0,0,0,0,0
SHERANI,DISTRICT,20 - 24,MARRIED,11264,6308,4956,0,11264,6308,4956,0,0,0,0,0
SHERANI,DISTRICT,20 - 24,NEVER MARRIED,2670,935,1735,0,2670,935,1735,0,0,0,0,0
SHERANI,DISTRICT,20 - 24,SEPERATION,16,5,11,0,16,5,11,0,0,0,0,0
SHERANI,DISTRICT,20 - 24,WIDOWED,18,12,6,0,18,12,6,0,0,0,0,0
SHERANI,DISTRICT,25 - 29,DIVORCED,11,8,3,0,11,8,3,0,0,0,0,0
SHERANI,DISTRICT,25 - 29,MARRIED,11221,5871,5350,0,11221,5871,5350,0,0,0,0,0
SHERANI,DISTRICT,25 - 29,NEVER MARRIED,933,325,608,0,933,325,608,0,0,0,0,0
SHERANI,DISTRICT,25 - 29,SEPERATION,25,15,10,0,25,15,10,0,0,0,0,0
SHERANI,DISTRICT,25 - 29,WIDOWED,47,27,20,0,47,27,20,0,0,0,0,0
SHERANI,DISTRICT,30 - 34,DIVORCED,13,7,6,0,13,7,6,0,0,0,0,0
SHERANI,DISTRICT,30 - 34,MARRIED,9487,4948,4539,0,9487,4948,4539,0,0,0,0,0
SHERANI,DISTRICT,30 - 34,NEVER MARRIED,308,110,198,0,308,110,198,0,0,0,0,0
SHERANI,DISTRICT,30 - 34,SEPERATION,26,21,5,0,26,21,5,0,0,0,0,0
SHERANI,DISTRICT,30 - 34,WIDOWED,70,49,21,0,70,49,21,0,0,0,0,0
SHERANI,DISTRICT,35 - 39,DIVORCED,15,10,5,0,15,10,5,0,0,0,0,0
SHERANI,DISTRICT,35 - 39,MARRIED,8018,4080,3938,0,8018,4080,3938,0,0,0,0,0
SHERANI,DISTRICT,35 - 39,NEVER MARRIED,101,54,47,0,101,54,47,0,0,0,0,0
SHERANI,DISTRICT,35 - 39,SEPERATION,34,29,5,0,34,29,5,0,0,0,0,0
SHERANI,DISTRICT,35 - 39,WIDOWED,73,53,20,0,73,53,20,0,0,0,0,0
SHERANI,DISTRICT,40 - 44,DIVORCED,7,7,0,0,7,7,0,0,0,0,0,0
SHERANI,DISTRICT,40 - 44,MARRIED,6393,3314,3079,0,6393,3314,3079,0,0,0,0,0
SHERANI,DISTRICT,40 - 44,NEVER MARRIED,38,15,22,1,38,15,22,1,0,0,0,0
SHERANI,DISTRICT,40 - 44,SEPERATION,32,28,4,0,32,28,4,0,0,0,0,0
SHERANI,DISTRICT,40 - 44,WIDOWED,86,74,12,0,86,74,12,0,0,0,0,0
SHERANI,DISTRICT,45 - 49,DIVORCED,8,8,0,0,8,8,0,0,0,0,0,0
SHERANI,DISTRICT,45 - 49,MARRIED,4862,2215,2647,0,4862,2215,2647,0,0,0,0,0
SHERANI,DISTRICT,45 - 49,NEVER MARRIED,30,12,18,0,30,12,18,0,0,0,0,0
SHERANI,DISTRICT,45 - 49,SEPERATION,41,31,10,0,41,31,10,0,0,0,0,0
SHERANI,DISTRICT,45 - 49,WIDOWED,96,82,14,0,96,82,14,0,0,0,0,0
SHERANI,DISTRICT,50 - 54,DIVORCED,10,5,5,0,10,5,5,0,0,0,0,0
SHERANI,DISTRICT,50 - 54,MARRIED,3122,1484,1638,0,3122,1484,1638,0,0,0,0,0
SHERANI,DISTRICT,50 - 54,NEVER MARRIED,13,6,7,0,13,6,7,0,0,0,0,0
SHERANI,DISTRICT,50 - 54,SEPERATION,33,27,6,0,33,27,6,0,0,0,0,0
SHERANI,DISTRICT,50 - 54,WIDOWED,88,74,14,0,88,74,14,0,0,0,0,0
SHERANI,DISTRICT,55 - 59,DIVORCED,11,5,6,0,11,5,6,0,0,0,0,0
SHERANI,DISTRICT,55 - 59,MARRIED,2419,1030,1389,0,2419,1030,1389,0,0,0,0,0
SHERANI,DISTRICT,55 - 59,NEVER MARRIED,23,3,20,0,23,3,20,0,0,0,0,0
SHERANI,DISTRICT,55 - 59,SEPERATION,13,12,1,0,13,12,1,0,0,0,0,0
SHERANI,DISTRICT,55 - 59,WIDOWED,80,70,10,0,80,70,10,0,0,0,0,0
SHERANI,DISTRICT,60 - 64,DIVORCED,10,5,5,0,10,5,5,0,0,0,0,0
SHERANI,DISTRICT,60 - 64,MARRIED,1550,574,976,0,1550,574,976,0,0,0,0,0
SHERANI,DISTRICT,60 - 64,NEVER MARRIED,8,1,7,0,8,1,7,0,0,0,0,0
SHERANI,DISTRICT,60 - 64,SEPERATION,14,14,0,0,14,14,0,0,0,0,0,0
SHERANI,DISTRICT,60 - 64,WIDOWED,67,54,13,0,67,54,13,0,0,0,0,0
SHERANI,DISTRICT,65 - 69,DIVORCED,12,3,9,0,12,3,9,0,0,0,0,0
SHERANI,DISTRICT,65 - 69,MARRIED,949,405,544,0,949,405,544,0,0,0,0,0
SHERANI,DISTRICT,65 - 69,NEVER MARRIED,14,3,11,0,14,3,11,0,0,0,0,0
SHERANI,DISTRICT,65 - 69,SEPERATION,8,6,2,0,8,6,2,0,0,0,0,0
SHERANI,DISTRICT,65 - 69,WIDOWED,55,41,14,0,55,41,14,0,0,0,0,0
SHERANI,DISTRICT,70 - 74,DIVORCED,0,0,0,0,0,0,0,0,0,0,0,0
SHERANI,DISTRICT,70 - 74,MARRIED,724,281,443,0,724,281,443,0,0,0,0,0
SHERANI,DISTRICT,70 - 74,NEVER MARRIED,2,0,2,0,2,0,2,0,0,0,0,0
SHERANI,DISTRICT,70 - 74,SEPERATION,7,6,1,0,7,6,1,0,0,0,0,0
SHERANI,DISTRICT,70 - 74,WIDOWED,49,35,14,0,49,35,14,0,0,0,0,0
SHERANI,DISTRICT,75 & ABOVE,DIVORCED,0,0,0,0,0,0,0,0,0,0,0,0
SHERANI,DISTRICT,75 & ABOVE,MARRIED,791,276,515,0,791,276,515,0,0,0,0,0
SHERANI,DISTRICT,75 & ABOVE,NEVER MARRIED,22,4,18,0,22,4,18,0,0,0,0,0
SHERANI,DISTRICT,75 & ABOVE,SEPERATION,10,4,6,0,10,4,6,0,0,0,0,0
SHERANI,DISTRICT,75 & ABOVE,WIDOWED,85,49,36,0,85,49,36,0,0,0,0,0
SIBI,DISTRICT,15 &  ABOVE,DIVORCED,93,68,25,0,59,46,13,0,34,22,12,0
SIBI,DISTRICT,15 &  ABOVE,MARRIED,74028,37223,36805,0,47868,24245,23623,0,26160,12978,13182,0
SIBI,DISTRICT,15 &  ABOVE,NEVER MARRIED,38060,16288,21767,5,24157,10204,13948,5,13903,6084,7819,0
SIBI,DISTRICT,15 &  ABOVE,SEPERATION,84,48,36,0,54,30,24,0,30,18,12,0
SIBI,DISTRICT,15 &  ABOVE,WIDOWED,3247,2530,717,0,1823,1417,406,0,1424,1113,311,0
SIBI,DISTRICT,15 - 19,DIVORCED,3,2,1,0,2,1,1,0,1,1,0,0
SIBI,DISTRICT,15 - 19,MARRIED,2845,1815,1030,0,2254,1399,855,0,591,416,175,0
SIBI,DISTRICT,15 - 19,NEVER MARRIED,20309,9208,11099,2,13884,6118,7764,2,6425,3090,3335,0
SIBI,DISTRICT,15 - 19,SEPERATION,9,5,4,0,7,3,4,0,2,2,0,0
SIBI,DISTRICT,15 - 19,WIDOWED,9,4,5,0,7,3,4,0,2,1,1,0
SIBI,DISTRICT,20 - 24,DIVORCED,7,6,1,0,4,3,1,0,3,3,0,0
SIBI,DISTRICT,20 - 24,MARRIED,7790,4804,2986,0,5576,3361,2215,0,2214,1443,771,0
SIBI,DISTRICT,20 - 24,NEVER MARRIED,9535,3826,5709,0,5759,2265,3494,0,3776,1561,2215,0
SIBI,DISTRICT,20 - 24,SEPERATION,8,4,4,0,7,3,4,0,1,1,0,0
SIBI,DISTRICT,20 - 24,WIDOWED,33,19,14,0,23,14,9,0,10,5,5,0
SIBI,DISTRICT,25 - 29,DIVORCED,13,12,1,0,8,8,0,0,5,4,1,0
SIBI,DISTRICT,25 - 29,MARRIED,10222,5707,4515,0,6837,3764,3073,0,3385,1943,1442,0
SIBI,DISTRICT,25 - 29,NEVER MARRIED,4628,1779,2848,1,2694,1031,1662,1,1934,748,1186,0
SIBI,DISTRICT,25 - 29,SEPERATION,5,3,2,0,3,1,2,0,2,2,0,0
SIBI,DISTRICT,25 - 29,WIDOWED,62,41,21,0,44,33,11,0,18,8,10,0
SIBI,DISTRICT,30 - 34,DIVORCED,14,10,4,0,13,10,3,0,1,0,1,0
SIBI,DISTRICT,30 - 34,MARRIED,10233,5372,4861,0,6517,3414,3103,0,3716,1958,1758,0
SIBI,DISTRICT,30 - 34,NEVER MARRIED,1856,855,1001,0,960,460,500,0,896,395,501,0
SIBI,DISTRICT,30 - 34,SEPERATION,11,5,6,0,7,4,3,0,4,1,3,0
SIBI,DISTRICT,30 - 34,WIDOWED,95,66,29,0,57,36,21,0,38,30,8,0
SIBI,DISTRICT,35 - 39,DIVORCED,13,7,6,0,8,5,3,0,5,2,3,0
SIBI,DISTRICT,35 - 39,MARRIED,10129,5201,4928,0,6333,3296,3037,0,3796,1905,1891,0
SIBI,DISTRICT,35 - 39,NEVER MARRIED,828,257,571,0,410,136,274,0,418,121,297,0
SIBI,DISTRICT,35 - 39,SEPERATION,13,9,4,0,11,7,4,0,2,2,0,0
SIBI,DISTRICT,35 - 39,WIDOWED,103,76,27,0,57,40,17,0,46,36,10,0
SIBI,DISTRICT,40 - 44,DIVORCED,15,12,3,0,10,9,1,0,5,3,2,0
SIBI,DISTRICT,40 - 44,MARRIED,9673,4586,5087,0,6212,2979,3233,0,3461,1607,1854,0
SIBI,DISTRICT,40 - 44,NEVER MARRIED,401,142,259,0,220,81,139,0,181,61,120,0
SIBI,DISTRICT,40 - 44,SEPERATION,12,7,5,0,7,4,3,0,5,3,2,0
SIBI,DISTRICT,40 - 44,WIDOWED,188,147,41,0,105,82,23,0,83,65,18,0
SIBI,DISTRICT,45 - 49,DIVORCED,11,8,3,0,6,5,1,0,5,3,2,0
SIBI,DISTRICT,45 - 49,MARRIED,6821,3205,3616,0,4177,1999,2178,0,2644,1206,1438,0
SIBI,DISTRICT,45 - 49,NEVER MARRIED,208,81,127,0,105,47,58,0,103,34,69,0
SIBI,DISTRICT,45 - 49,SEPERATION,6,4,2,0,4,2,2,0,2,2,0,0
SIBI,DISTRICT,45 - 49,WIDOWED,228,187,41,0,132,110,22,0,96,77,19,0
SIBI,DISTRICT,50 - 54,DIVORCED,9,8,1,0,4,3,1,0,5,5,0,0
SIBI,DISTRICT,50 - 54,MARRIED,5918,2668,3250,0,3751,1679,2072,0,2167,989,1178,0
SIBI,DISTRICT,50 - 54,NEVER MARRIED,123,51,72,0,42,21,21,0,81,30,51,0
SIBI,DISTRICT,50 - 54,SEPERATION,10,5,5,0,5,4,1,0,5,1,4,0
SIBI,DISTRICT,50 - 54,WIDOWED,400,318,82,0,220,173,47,0,180,145,35,0
SIBI,DISTRICT,55 - 59,DIVORCED,4,2,2,0,2,2,0,0,2,0,2,0
SIBI,DISTRICT,55 - 59,MARRIED,4079,1573,2506,0,2381,956,1425,0,1698,617,1081,0
SIBI,DISTRICT,55 - 59,NEVER MARRIED,78,39,39,0,38,19,19,0,40,20,20,0
SIBI,DISTRICT,55 - 59,SEPERATION,5,4,1,0,1,1,0,0,4,3,1,0
SIBI,DISTRICT,55 - 59,WIDOWED,371,302,69,0,180,148,32,0,191,154,37,0
SIBI,DISTRICT,60 - 64,DIVORCED,3,1,2,0,2,0,2,0,1,1,0,0
SIBI,DISTRICT,60 - 64,MARRIED,2756,1064,1692,0,1638,639,999,0,1118,425,693,0
SIBI,DISTRICT,60 - 64,NEVER MARRIED,41,23,18,0,22,11,11,0,19,12,7,0
SIBI,DISTRICT,60 - 64,SEPERATION,1,1,0,0,0,0,0,0,1,1,0,0
SIBI,DISTRICT,60 - 64,WIDOWED,433,348,85,0,217,181,36,0,216,167,49,0
SIBI,DISTRICT,65 - 69,DIVORCED,0,0,0,0,0,0,0,0,0,0,0,0
SIBI,DISTRICT,65 - 69,MARRIED,1738,632,1106,0,1019,366,653,0,719,266,453,0
SIBI,DISTRICT,65 - 69,NEVER MARRIED,25,14,10,1,9,7,1,1,16,7,9,0
SIBI,DISTRICT,65 - 69,SEPERATION,2,0,2,0,1,0,1,0,1,0,1,0
SIBI,DISTRICT,65 - 69,WIDOWED,457,359,98,0,234,175,59,0,223,184,39,0
SIBI,DISTRICT,70 - 74,DIVORCED,1,0,1,0,0,0,0,0,1,0,1,0
SIBI,DISTRICT,70 - 74,MARRIED,1103,379,724,0,686,244,442,0,417,135,282,0
SIBI,DISTRICT,70 - 74,NEVER MARRIED,16,6,9,1,8,4,3,1,8,2,6,0
SIBI,DISTRICT,70 - 74,SEPERATION,1,0,1,0,0,0,0,0,1,0,1,0
SIBI,DISTRICT,70 - 74,WIDOWED,425,320,105,0,279,211,68,0,146,109,37,0
SIBI,DISTRICT,75 & ABOVE,DIVORCED,0,0,0,0,0,0,0,0,0,0,0,0
SIBI,DISTRICT,75 & ABOVE,MARRIED,721,217,504,0,487,149,338,0,234,68,166,0
SIBI,DISTRICT,75 & ABOVE,NEVER MARRIED,12,7,5,0,6,4,2,0,6,3,3,0
SIBI,DISTRICT,75 & ABOVE,SEPERATION,1,1,0,0,1,1,0,0,0,0,0,0
SIBI,DISTRICT,75 & ABOVE,WIDOWED,443,343,100,0,268,211,57,0,175,132,43,0
SOHBATPUR,DISTRICT,15 &  ABOVE,DIVORCED,89,58,31,0,81,52,29,0,8,6,2,0
SOHBATPUR,DISTRICT,15 &  ABOVE,MARRIED,75761,38421,37340,0,72161,36619,35542,0,3600,1802,1798,0
SOHBATPUR,DISTRICT,15 &  ABOVE,NEVER MARRIED,24845,10209,14635,1,22510,9153,13356,1,2335,1056,1279,0
SOHBATPUR,DISTRICT,15 &  ABOVE,SEPERATION,57,42,15,0,45,34,11,0,12,8,4,0
SOHBATPUR,DISTRICT,15 &  ABOVE,WIDOWED,3574,2896,678,0,3300,2689,611,0,274,207,67,0
SOHBATPUR,DISTRICT,15 - 19,DIVORCED,1,1,0,0,1,1,0,0,0,0,0,0
SOHBATPUR,DISTRICT,15 - 19,MARRIED,5365,3226,2139,0,5197,3120,2077,0,168,106,62,0
SOHBATPUR,DISTRICT,15 - 19,NEVER MARRIED,16803,7365,9437,1,15326,6691,8634,1,1477,674,803,0
SOHBATPUR,DISTRICT,15 - 19,SEPERATION,1,1,0,0,0,0,0,0,1,1,0,0
SOHBATPUR,DISTRICT,15 - 19,WIDOWED,13,5,8,0,13,5,8,0,0,0,0,0
SOHBATPUR,DISTRICT,20 - 24,DIVORCED,11,8,3,0,10,7,3,0,1,1,0,0
SOHBATPUR,DISTRICT,20 - 24,MARRIED,10955,6313,4642,0,10554,6078,4476,0,401,235,166,0
SOHBATPUR,DISTRICT,20 - 24,NEVER MARRIED,4982,1692,3290,0,4495,1485,3010,0,487,207,280,0
SOHBATPUR,DISTRICT,20 - 24,SEPERATION,6,3,3,0,5,3,2,0,1,0,1,0
SOHBATPUR,DISTRICT,20 - 24,WIDOWED,49,23,26,0,49,23,26,0,0,0,0,0
SOHBATPUR,DISTRICT,25 - 29,DIVORCED,12,7,5,0,11,7,4,0,1,0,1,0
SOHBATPUR,DISTRICT,25 - 29,MARRIED,10378,5463,4915,0,9912,5206,4706,0,466,257,209,0
SOHBATPUR,DISTRICT,25 - 29,NEVER MARRIED,1705,628,1077,0,1503,530,973,0,202,98,104,0
SOHBATPUR,DISTRICT,25 - 29,SEPERATION,9,5,4,0,7,4,3,0,2,1,1,0
SOHBATPUR,DISTRICT,25 - 29,WIDOWED,61,42,19,0,60,42,18,0,1,0,1,0
SOHBATPUR,DISTRICT,30 - 34,DIVORCED,15,11,4,0,13,9,4,0,2,2,0,0
SOHBATPUR,DISTRICT,30 - 34,MARRIED,10291,5405,4886,0,9753,5131,4622,0,538,274,264,0
SOHBATPUR,DISTRICT,30 - 34,NEVER MARRIED,725,327,398,0,622,275,347,0,103,52,51,0
SOHBATPUR,DISTRICT,30 - 34,SEPERATION,6,4,2,0,5,3,2,0,1,1,0,0
SOHBATPUR,DISTRICT,30 - 34,WIDOWED,100,75,25,0,94,73,21,0,6,2,4,0
SOHBATPUR,DISTRICT,35 - 39,DIVORCED,12,7,5,0,12,7,5,0,0,0,0,0
SOHBATPUR,DISTRICT,35 - 39,MARRIED,9259,4676,4583,0,8793,4443,4350,0,466,233,233,0
SOHBATPUR,DISTRICT,35 - 39,NEVER MARRIED,313,99,214,0,283,87,196,0,30,12,18,0
SOHBATPUR,DISTRICT,35 - 39,SEPERATION,7,6,1,0,5,5,0,0,2,1,1,0
SOHBATPUR,DISTRICT,35 - 39,WIDOWED,145,113,32,0,141,110,31,0,4,3,1,0
SOHBATPUR,DISTRICT,40 - 44,DIVORCED,15,8,7,0,14,7,7,0,1,1,0,0
SOHBATPUR,DISTRICT,40 - 44,MARRIED,9319,4500,4819,0,8836,4259,4577,0,483,241,242,0
SOHBATPUR,DISTRICT,40 - 44,NEVER MARRIED,137,38,99,0,120,32,88,0,17,6,11,0
SOHBATPUR,DISTRICT,40 - 44,SEPERATION,2,2,0,0,1,1,0,0,1,1,0,0
SOHBATPUR,DISTRICT,40 - 44,WIDOWED,248,199,49,0,235,190,45,0,13,9,4,0
SOHBATPUR,DISTRICT,45 - 49,DIVORCED,5,3,2,0,2,1,1,0,3,2,1,0
SOHBATPUR,DISTRICT,45 - 49,MARRIED,6033,2685,3348,0,5695,2527,3168,0,338,158,180,0
SOHBATPUR,DISTRICT,45 - 49,NEVER MARRIED,94,32,62,0,84,28,56,0,10,4,6,0
SOHBATPUR,DISTRICT,45 - 49,SEPERATION,6,6,0,0,4,4,0,0,2,2,0,0
SOHBATPUR,DISTRICT,45 - 49,WIDOWED,277,226,51,0,257,208,49,0,20,18,2,0
SOHBATPUR,DISTRICT,50 - 54,DIVORCED,5,4,1,0,5,4,1,0,0,0,0,0
SOHBATPUR,DISTRICT,50 - 54,MARRIED,4902,2362,2540,0,4651,2258,2393,0,251,104,147,0
SOHBATPUR,DISTRICT,50 - 54,NEVER MARRIED,29,11,18,0,27,10,17,0,2,1,1,0
SOHBATPUR,DISTRICT,50 - 54,SEPERATION,9,6,3,0,8,5,3,0,1,1,0,0
SOHBATPUR,DISTRICT,50 - 54,WIDOWED,412,344,68,0,379,319,60,0,33,25,8,0
SOHBATPUR,DISTRICT,55 - 59,DIVORCED,5,4,1,0,5,4,1,0,0,0,0,0
SOHBATPUR,DISTRICT,55 - 59,MARRIED,3503,1563,1940,0,3291,1478,1813,0,212,85,127,0
SOHBATPUR,DISTRICT,55 - 59,NEVER MARRIED,24,10,14,0,20,8,12,0,4,2,2,0
SOHBATPUR,DISTRICT,55 - 59,SEPERATION,3,1,2,0,2,1,1,0,1,0,1,0
SOHBATPUR,DISTRICT,55 - 59,WIDOWED,391,312,79,0,340,271,69,0,51,41,10,0
SOHBATPUR,DISTRICT,60 - 64,DIVORCED,4,1,3,0,4,1,3,0,0,0,0,0
SOHBATPUR,DISTRICT,60 - 64,MARRIED,2489,1022,1467,0,2353,963,1390,0,136,59,77,0
SOHBATPUR,DISTRICT,60 - 64,NEVER MARRIED,15,2,13,0,14,2,12,0,1,0,1,0
SOHBATPUR,DISTRICT,60 - 64,SEPERATION,5,5,0,0,5,5,0,0,0,0,0,0
SOHBATPUR,DISTRICT,60 - 64,WIDOWED,497,417,80,0,455,387,68,0,42,30,12,0
SOHBATPUR,DISTRICT,65 - 69,DIVORCED,2,2,0,0,2,2,0,0,0,0,0,0
SOHBATPUR,DISTRICT,65 - 69,MARRIED,1377,563,814,0,1304,534,770,0,73,29,44,0
SOHBATPUR,DISTRICT,65 - 69,NEVER MARRIED,10,3,7,0,9,3,6,0,1,0,1,0
SOHBATPUR,DISTRICT,65 - 69,SEPERATION,2,2,0,0,2,2,0,0,0,0,0,0
SOHBATPUR,DISTRICT,65 - 69,WIDOWED,432,368,64,0,395,339,56,0,37,29,8,0
SOHBATPUR,DISTRICT,70 - 74,DIVORCED,1,1,0,0,1,1,0,0,0,0,0,0
SOHBATPUR,DISTRICT,70 - 74,MARRIED,1066,389,677,0,1020,374,646,0,46,15,31,0
SOHBATPUR,DISTRICT,70 - 74,NEVER MARRIED,3,2,1,0,3,2,1,0,0,0,0,0
SOHBATPUR,DISTRICT,70 - 74,SEPERATION,0,0,0,0,0,0,0,0,0,0,0,0
SOHBATPUR,DISTRICT,70 - 74,WIDOWED,446,376,70,0,411,347,64,0,35,29,6,0
SOHBATPUR,DISTRICT,75 & ABOVE,DIVORCED,1,1,0,0,1,1,0,0,0,0,0,0
SOHBATPUR,DISTRICT,75 & ABOVE,MARRIED,824,254,570,0,802,248,554,0,22,6,16,0
SOHBATPUR,DISTRICT,75 & ABOVE,NEVER MARRIED,5,0,5,0,4,0,4,0,1,0,1,0
SOHBATPUR,DISTRICT,75 & ABOVE,SEPERATION,1,1,0,0,1,1,0,0,0,0,0,0
SOHBATPUR,DISTRICT,75 & ABOVE,WIDOWED,503,396,107,0,471,375,96,0,32,21,11,0
SURAB,DISTRICT,15 &  ABOVE,DIVORCED,139,100,39,0,120,88,32,0,19,12,7,0
SURAB,DISTRICT,15 &  ABOVE,MARRIED,95493,48921,46572,0,83325,42671,40654,0,12168,6250,5918,0
SURAB,DISTRICT,15 &  ABOVE,NEVER MARRIED,29817,13004,16795,18,25515,10790,14707,18,4302,2214,2088,0
SURAB,DISTRICT,15 &  ABOVE,SEPERATION,97,51,46,0,86,46,40,0,11,5,6,0
SURAB,DISTRICT,15 &  ABOVE,WIDOWED,2068,1591,477,0,1725,1304,421,0,343,287,56,0
SURAB,DISTRICT,15 - 19,DIVORCED,6,5,1,0,6,5,1,0,0,0,0,0
SURAB,DISTRICT,15 - 19,MARRIED,10571,6178,4393,0,9560,5556,4004,0,1011,622,389,0
SURAB,DISTRICT,15 - 19,NEVER MARRIED,20988,9167,11808,13,18259,7776,10470,13,2729,1391,1338,0
SURAB,DISTRICT,15 - 19,SEPERATION,9,3,6,0,9,3,6,0,0,0,0,0
SURAB,DISTRICT,15 - 19,WIDOWED,16,6,10,0,15,5,10,0,1,1,0,0
SURAB,DISTRICT,20 - 24,DIVORCED,17,10,7,0,17,10,7,0,0,0,0,0
SURAB,DISTRICT,20 - 24,MARRIED,18192,9963,8229,0,16069,8719,7350,0,2123,1244,879,0
SURAB,DISTRICT,20 - 24,NEVER MARRIED,5807,2447,3360,0,4896,2003,2893,0,911,444,467,0
SURAB,DISTRICT,20 - 24,SEPERATION,9,2,7,0,9,2,7,0,0,0,0,0
SURAB,DISTRICT,20 - 24,WIDOWED,72,31,41,0,64,27,37,0,8,4,4,0
SURAB,DISTRICT,25 - 29,DIVORCED,25,20,5,0,20,17,3,0,5,3,2,0
SURAB,DISTRICT,25 - 29,MARRIED,15514,7919,7595,0,13395,6808,6587,0,2119,1111,1008,0
SURAB,DISTRICT,25 - 29,NEVER MARRIED,1842,879,963,0,1478,672,806,0,364,207,157,0
SURAB,DISTRICT,25 - 29,SEPERATION,13,9,4,0,13,9,4,0,0,0,0,0
SURAB,DISTRICT,25 - 29,WIDOWED,85,53,32,0,79,49,30,0,6,4,2,0
SURAB,DISTRICT,30 - 34,DIVORCED,21,16,5,0,18,14,4,0,3,2,1,0
SURAB,DISTRICT,30 - 34,MARRIED,12094,6417,5677,0,10489,5608,4881,0,1605,809,796,0
SURAB,DISTRICT,30 - 34,NEVER MARRIED,616,302,309,5,472,209,258,5,144,93,51,0
SURAB,DISTRICT,30 - 34,SEPERATION,17,10,7,0,16,10,6,0,1,0,1,0
SURAB,DISTRICT,30 - 34,WIDOWED,103,74,29,0,87,62,25,0,16,12,4,0
SURAB,DISTRICT,35 - 39,DIVORCED,24,16,8,0,22,14,8,0,2,2,0,0
SURAB,DISTRICT,35 - 39,MARRIED,11028,5529,5499,0,9522,4802,4720,0,1506,727,779,0
SURAB,DISTRICT,35 - 39,NEVER MARRIED,286,111,175,0,215,69,146,0,71,42,29,0
SURAB,DISTRICT,35 - 39,SEPERATION,8,6,2,0,6,5,1,0,2,1,1,0
SURAB,DISTRICT,35 - 39,WIDOWED,170,135,35,0,147,117,30,0,23,18,5,0
SURAB,DISTRICT,40 - 44,DIVORCED,13,12,1,0,11,10,1,0,2,2,0,0
SURAB,DISTRICT,40 - 44,MARRIED,8875,4254,4621,0,7724,3715,4009,0,1151,539,612,0
SURAB,DISTRICT,40 - 44,NEVER MARRIED,115,45,70,0,97,36,61,0,18,9,9,0
SURAB,DISTRICT,40 - 44,SEPERATION,10,4,6,0,10,4,6,0,0,0,0,0
SURAB,DISTRICT,40 - 44,WIDOWED,201,164,37,0,179,145,34,0,22,19,3,0
SURAB,DISTRICT,45 - 49,DIVORCED,13,11,2,0,11,9,2,0,2,2,0,0
SURAB,DISTRICT,45 - 49,MARRIED,5647,2615,3032,0,4894,2262,2632,0,753,353,400,0
SURAB,DISTRICT,45 - 49,NEVER MARRIED,59,17,42,0,49,15,34,0,10,2,8,0
SURAB,DISTRICT,45 - 49,SEPERATION,8,3,5,0,8,3,5,0,0,0,0,0
SURAB,DISTRICT,45 - 49,WIDOWED,171,140,31,0,138,111,27,0,33,29,4,0
SURAB,DISTRICT,50 - 54,DIVORCED,5,3,2,0,4,2,2,0,1,1,0,0
SURAB,DISTRICT,50 - 54,MARRIED,4491,2214,2277,0,3839,1905,1934,0,652,309,343,0
SURAB,DISTRICT,50 - 54,NEVER MARRIED,14,4,10,0,13,3,10,0,1,1,0,0
SURAB,DISTRICT,50 - 54,SEPERATION,5,2,3,0,4,2,2,0,1,0,1,0
SURAB,DISTRICT,50 - 54,WIDOWED,248,209,39,0,201,164,37,0,47,45,2,0
SURAB,DISTRICT,55 - 59,DIVORCED,5,3,2,0,5,3,2,0,0,0,0,0
SURAB,DISTRICT,55 - 59,MARRIED,3188,1476,1712,0,2740,1278,1462,0,448,198,250,0
SURAB,DISTRICT,55 - 59,NEVER MARRIED,34,14,20,0,13,2,11,0,21,12,9,0
SURAB,DISTRICT,55 - 59,SEPERATION,6,5,1,0,4,4,0,0,2,1,1,0
SURAB,DISTRICT,55 - 59,WIDOWED,230,195,35,0,190,162,28,0,40,33,7,0
SURAB,DISTRICT,60 - 64,DIVORCED,4,2,2,0,3,2,1,0,1,0,1,0
SURAB,DISTRICT,60 - 64,MARRIED,2369,971,1398,0,2050,833,1217,0,319,138,181,0
SURAB,DISTRICT,60 - 64,NEVER MARRIED,31,8,23,0,11,2,9,0,20,6,14,0
SURAB,DISTRICT,60 - 64,SEPERATION,5,3,2,0,3,2,1,0,2,1,1,0
SURAB,DISTRICT,60 - 64,WIDOWED,212,181,31,0,158,132,26,0,54,49,5,0
SURAB,DISTRICT,65 - 69,DIVORCED,1,0,1,0,0,0,0,0,1,0,1,0
SURAB,DISTRICT,65 - 69,MARRIED,1557,653,904,0,1330,558,772,0,227,95,132,0
SURAB,DISTRICT,65 - 69,NEVER MARRIED,11,4,7,0,3,0,3,0,8,4,4,0
SURAB,DISTRICT,65 - 69,SEPERATION,2,2,0,0,1,1,0,0,1,1,0,0
SURAB,DISTRICT,65 - 69,WIDOWED,179,144,35,0,141,111,30,0,38,33,5,0
SURAB,DISTRICT,70 - 74,DIVORCED,2,1,1,0,1,1,0,0,1,0,1,0
SURAB,DISTRICT,70 - 74,MARRIED,1076,421,655,0,919,353,566,0,157,68,89,0
SURAB,DISTRICT,70 - 74,NEVER MARRIED,7,4,3,0,3,2,1,0,4,2,2,0
SURAB,DISTRICT,70 - 74,SEPERATION,2,1,1,0,2,1,1,0,0,0,0,0
SURAB,DISTRICT,70 - 74,WIDOWED,190,142,48,0,160,116,44,0,30,26,4,0
SURAB,DISTRICT,75 & ABOVE,DIVORCED,3,1,2,0,2,1,1,0,1,0,1,0
SURAB,DISTRICT,75 & ABOVE,MARRIED,891,311,580,0,794,274,520,0,97,37,60,0
SURAB,DISTRICT,75 & ABOVE,NEVER MARRIED,7,2,5,0,6,1,5,0,1,1,0,0
SURAB,DISTRICT,75 & ABOVE,SEPERATION,3,1,2,0,1,0,1,0,2,1,1,0
SURAB,DISTRICT,75 & ABOVE,WIDOWED,191,117,74,0,166,103,63,0,25,14,11,0
WASHUK,DISTRICT,15 &  ABOVE,DIVORCED,172,136,36,0,145,113,32,0,27,23,4,0
WASHUK,DISTRICT,15 &  ABOVE,MARRIED,98740,49828,48912,0,85288,42923,42365,0,13452,6905,6547,0
WASHUK,DISTRICT,15 &  ABOVE,NEVER MARRIED,34920,14050,20848,22,30636,12259,18355,22,4284,1791,2493,0
WASHUK,DISTRICT,15 &  ABOVE,SEPERATION,126,48,78,0,116,42,74,0,10,6,4,0
WASHUK,DISTRICT,15 &  ABOVE,WIDOWED,2247,1660,587,0,1944,1427,517,0,303,233,70,0
WASHUK,DISTRICT,15 - 19,DIVORCED,6,6,0,0,4,4,0,0,2,2,0,0
WASHUK,DISTRICT,15 - 19,MARRIED,10952,6222,4730,0,9768,5497,4271,0,1184,725,459,0
WASHUK,DISTRICT,15 - 19,NEVER MARRIED,24206,9499,14698,9,21292,8317,12966,9,2914,1182,1732,0
WASHUK,DISTRICT,15 - 19,SEPERATION,21,4,17,0,19,3,16,0,2,1,1,0
WASHUK,DISTRICT,15 - 19,WIDOWED,24,12,12,0,20,10,10,0,4,2,2,0
WASHUK,DISTRICT,20 - 24,DIVORCED,15,14,1,0,11,10,1,0,4,4,0,0
WASHUK,DISTRICT,20 - 24,MARRIED,14728,8300,6428,0,12226,6882,5344,0,2502,1418,1084,0
WASHUK,DISTRICT,20 - 24,NEVER MARRIED,6272,2667,3601,4,5473,2321,3148,4,799,346,453,0
WASHUK,DISTRICT,20 - 24,SEPERATION,15,7,8,0,15,7,8,0,0,0,0,0
WASHUK,DISTRICT,20 - 24,WIDOWED,33,23,10,0,29,21,8,0,4,2,2,0
WASHUK,DISTRICT,25 - 29,DIVORCED,30,25,5,0,21,18,3,0,9,7,2,0
WASHUK,DISTRICT,25 - 29,MARRIED,15964,8225,7739,0,13551,6986,6565,0,2413,1239,1174,0
WASHUK,DISTRICT,25 - 29,NEVER MARRIED,2370,947,1419,4,2045,795,1246,4,325,152,173,0
WASHUK,DISTRICT,25 - 29,SEPERATION,19,6,13,0,18,5,13,0,1,1,0,0
WASHUK,DISTRICT,25 - 29,WIDOWED,70,47,23,0,59,40,19,0,11,7,4,0
WASHUK,DISTRICT,30 - 34,DIVORCED,20,17,3,0,18,16,2,0,2,1,1,0
WASHUK,DISTRICT,30 - 34,MARRIED,13159,6989,6170,0,11326,6057,5269,0,1833,932,901,0
WASHUK,DISTRICT,30 - 34,NEVER MARRIED,1017,470,546,1,880,402,477,1,137,68,69,0
WASHUK,DISTRICT,30 - 34,SEPERATION,9,5,4,0,7,4,3,0,2,1,1,0
WASHUK,DISTRICT,30 - 34,WIDOWED,89,69,20,0,74,56,18,0,15,13,2,0
WASHUK,DISTRICT,35 - 39,DIVORCED,21,17,4,0,19,15,4,0,2,2,0,0
WASHUK,DISTRICT,35 - 39,MARRIED,12143,6147,5996,0,10799,5498,5301,0,1344,649,695,0
WASHUK,DISTRICT,35 - 39,NEVER MARRIED,536,257,279,0,470,231,239,0,66,26,40,0
WASHUK,DISTRICT,35 - 39,SEPERATION,8,4,4,0,5,2,3,0,3,2,1,0
WASHUK,DISTRICT,35 - 39,WIDOWED,129,102,27,0,105,80,25,0,24,22,2,0
WASHUK,DISTRICT,40 - 44,DIVORCED,16,13,3,0,13,10,3,0,3,3,0,0
WASHUK,DISTRICT,40 - 44,MARRIED,9394,4231,5163,0,8373,3744,4629,0,1021,487,534,0
WASHUK,DISTRICT,40 - 44,NEVER MARRIED,263,111,151,1,238,102,135,1,25,9,16,0
WASHUK,DISTRICT,40 - 44,SEPERATION,7,3,4,0,7,3,4,0,0,0,0,0
WASHUK,DISTRICT,40 - 44,WIDOWED,180,137,43,0,153,117,36,0,27,20,7,0
WASHUK,DISTRICT,45 - 49,DIVORCED,13,11,2,0,13,11,2,0,0,0,0,0
WASHUK,DISTRICT,45 - 49,MARRIED,6586,3167,3419,0,5790,2775,3015,0,796,392,404,0
WASHUK,DISTRICT,45 - 49,NEVER MARRIED,139,55,83,1,131,51,79,1,8,4,4,0
WASHUK,DISTRICT,45 - 49,SEPERATION,7,4,3,0,7,4,3,0,0,0,0,0
WASHUK,DISTRICT,45 - 49,WIDOWED,179,132,47,0,157,112,45,0,22,20,2,0
WASHUK,DISTRICT,50 - 54,DIVORCED,12,10,2,0,10,9,1,0,2,1,1,0
WASHUK,DISTRICT,50 - 54,MARRIED,5020,2255,2765,0,4335,1913,2422,0,685,342,343,0
WASHUK,DISTRICT,50 - 54,NEVER MARRIED,62,28,32,2,60,27,31,2,2,1,1,0
WASHUK,DISTRICT,50 - 54,SEPERATION,9,4,5,0,8,3,5,0,1,1,0,0
WASHUK,DISTRICT,50 - 54,WIDOWED,269,205,64,0,240,186,54,0,29,19,10,0
WASHUK,DISTRICT,55 - 59,DIVORCED,9,8,1,0,7,6,1,0,2,2,0,0
WASHUK,DISTRICT,55 - 59,MARRIED,3577,1657,1920,0,3059,1405,1654,0,518,252,266,0
WASHUK,DISTRICT,55 - 59,NEVER MARRIED,18,5,13,0,15,4,11,0,3,1,2,0
WASHUK,DISTRICT,55 - 59,SEPERATION,8,3,5,0,8,3,5,0,0,0,0,0
WASHUK,DISTRICT,55 - 59,WIDOWED,250,185,65,0,226,167,59,0,24,18,6,0
WASHUK,DISTRICT,60 - 64,DIVORCED,12,6,6,0,11,5,6,0,1,1,0,0
WASHUK,DISTRICT,60 - 64,MARRIED,2786,1076,1710,0,2367,886,1481,0,419,190,229,0
WASHUK,DISTRICT,60 - 64,NEVER MARRIED,15,3,12,0,15,3,12,0,0,0,0,0
WASHUK,DISTRICT,60 - 64,SEPERATION,4,1,3,0,4,1,3,0,0,0,0,0
WASHUK,DISTRICT,60 - 64,WIDOWED,279,215,64,0,241,186,55,0,38,29,9,0
WASHUK,DISTRICT,65 - 69,DIVORCED,7,6,1,0,7,6,1,0,0,0,0,0
WASHUK,DISTRICT,65 - 69,MARRIED,1790,712,1078,0,1497,594,903,0,293,118,175,0
WASHUK,DISTRICT,65 - 69,NEVER MARRIED,10,4,6,0,10,4,6,0,0,0,0,0
WASHUK,DISTRICT,65 - 69,SEPERATION,4,0,4,0,3,0,3,0,1,0,1,0
WASHUK,DISTRICT,65 - 69,WIDOWED,189,144,45,0,163,123,40,0,26,21,5,0
WASHUK,DISTRICT,70 - 74,DIVORCED,3,1,2,0,3,1,2,0,0,0,0,0
WASHUK,DISTRICT,70 - 74,MARRIED,1251,428,823,0,1042,348,694,0,209,80,129,0
WASHUK,DISTRICT,70 - 74,NEVER MARRIED,6,0,6,0,4,0,4,0,2,0,2,0
WASHUK,DISTRICT,70 - 74,SEPERATION,5,3,2,0,5,3,2,0,0,0,0,0
WASHUK,DISTRICT,70 - 74,WIDOWED,228,164,64,0,196,135,61,0,32,29,3,0
WASHUK,DISTRICT,75 & ABOVE,DIVORCED,8,2,6,0,8,2,6,0,0,0,0,0
WASHUK,DISTRICT,75 & ABOVE,MARRIED,1390,419,971,0,1155,338,817,0,235,81,154,0
WASHUK,DISTRICT,75 & ABOVE,NEVER MARRIED,6,4,2,0,3,2,1,0,3,2,1,0
WASHUK,DISTRICT,75 & ABOVE,SEPERATION,10,4,6,0,10,4,6,0,0,0,0,0
WASHUK,DISTRICT,75 & ABOVE,WIDOWED,328,225,103,0,281,194,87,0,47,31,16,0
ZHOB,DISTRICT,15 &  ABOVE,DIVORCED,72,65,7,0,59,53,6,0,13,12,1,0
ZHOB,DISTRICT,15 &  ABOVE,MARRIED,100139,50840,49299,0,87276,44495,42781,0,12863,6345,6518,0
ZHOB,DISTRICT,15 &  ABOVE,NEVER MARRIED,42689,16512,26173,4,35449,13622,21823,4,7240,2890,4350,0
ZHOB,DISTRICT,15 &  ABOVE,SEPERATION,108,71,37,0,89,57,32,0,19,14,5,0
ZHOB,DISTRICT,15 &  ABOVE,WIDOWED,2334,1967,367,0,1740,1484,256,0,594,483,111,0
ZHOB,DISTRICT,15 - 19,DIVORCED,1,1,0,0,1,1,0,0,0,0,0,0
ZHOB,DISTRICT,15 - 19,MARRIED,5740,3600,2140,0,5402,3366,2036,0,338,234,104,0
ZHOB,DISTRICT,15 - 19,NEVER MARRIED,27486,11125,16357,4,23551,9481,14066,4,3935,1644,2291,0
ZHOB,DISTRICT,15 - 19,SEPERATION,3,2,1,0,1,1,0,0,2,1,1,0
ZHOB,DISTRICT,15 - 19,WIDOWED,5,2,3,0,5,2,3,0,0,0,0,0
ZHOB,DISTRICT,20 - 24,DIVORCED,14,14,0,0,13,13,0,0,1,1,0,0
ZHOB,DISTRICT,20 - 24,MARRIED,12193,7396,4797,0,10871,6517,4354,0,1322,879,443,0
ZHOB,DISTRICT,20 - 24,NEVER MARRIED,9848,3571,6277,0,7909,2802,5107,0,1939,769,1170,0
ZHOB,DISTRICT,20 - 24,SEPERATION,20,14,6,0,18,13,5,0,2,1,1,0
ZHOB,DISTRICT,20 - 24,WIDOWED,48,32,16,0,44,29,15,0,4,3,1,0
ZHOB,DISTRICT,25 - 29,DIVORCED,16,15,1,0,14,13,1,0,2,2,0,0
ZHOB,DISTRICT,25 - 29,MARRIED,14702,8003,6699,0,12847,6968,5879,0,1855,1035,820,0
ZHOB,DISTRICT,25 - 29,NEVER MARRIED,3405,1081,2324,0,2596,814,1782,0,809,267,542,0
ZHOB,DISTRICT,25 - 29,SEPERATION,21,17,4,0,21,17,4,0,0,0,0,0
ZHOB,DISTRICT,25 - 29,WIDOWED,64,45,19,0,49,32,17,0,15,13,2,0
ZHOB,DISTRICT,30 - 34,DIVORCED,8,7,1,0,4,4,0,0,4,3,1,0
ZHOB,DISTRICT,30 - 34,MARRIED,15351,8333,7018,0,13279,7262,6017,0,2072,1071,1001,0
ZHOB,DISTRICT,30 - 34,NEVER MARRIED,1226,434,792,0,898,324,574,0,328,110,218,0
ZHOB,DISTRICT,30 - 34,SEPERATION,8,2,6,0,7,2,5,0,1,0,1,0
ZHOB,DISTRICT,30 - 34,WIDOWED,88,65,23,0,68,54,14,0,20,11,9,0
ZHOB,DISTRICT,35 - 39,DIVORCED,7,5,2,0,6,4,2,0,1,1,0,0
ZHOB,DISTRICT,35 - 39,MARRIED,13119,6377,6742,0,11322,5538,5784,0,1797,839,958,0
ZHOB,DISTRICT,35 - 39,NEVER MARRIED,395,157,238,0,271,105,166,0,124,52,72,0
ZHOB,DISTRICT,35 - 39,SEPERATION,10,7,3,0,10,7,3,0,0,0,0,0
ZHOB,DISTRICT,35 - 39,WIDOWED,90,76,14,0,71,60,11,0,19,16,3,0
ZHOB,DISTRICT,40 - 44,DIVORCED,13,12,1,0,12,11,1,0,1,1,0,0
ZHOB,DISTRICT,40 - 44,MARRIED,10553,4963,5590,0,9018,4258,4760,0,1535,705,830,0
ZHOB,DISTRICT,40 - 44,NEVER MARRIED,135,67,68,0,93,45,48,0,42,22,20,0
ZHOB,DISTRICT,40 - 44,SEPERATION,10,7,3,0,7,5,2,0,3,2,1,0
ZHOB,DISTRICT,40 - 44,WIDOWED,156,136,20,0,118,101,17,0,38,35,3,0
ZHOB,DISTRICT,45 - 49,DIVORCED,5,5,0,0,3,3,0,0,2,2,0,0
ZHOB,DISTRICT,45 - 49,MARRIED,7457,3598,3859,0,6328,3100,3228,0,1129,498,631,0
ZHOB,DISTRICT,45 - 49,NEVER MARRIED,68,28,40,0,37,15,22,0,31,13,18,0
ZHOB,DISTRICT,45 - 49,SEPERATION,9,7,2,0,6,4,2,0,3,3,0,0
ZHOB,DISTRICT,45 - 49,WIDOWED,160,149,11,0,109,102,7,0,51,47,4,0
ZHOB,DISTRICT,50 - 54,DIVORCED,4,3,1,0,3,2,1,0,1,1,0,0
ZHOB,DISTRICT,50 - 54,MARRIED,6482,2981,3501,0,5571,2565,3006,0,911,416,495,0
ZHOB,DISTRICT,50 - 54,NEVER MARRIED,49,24,25,0,40,19,21,0,9,5,4,0
ZHOB,DISTRICT,50 - 54,SEPERATION,4,4,0,0,1,1,0,0,3,3,0,0
ZHOB,DISTRICT,50 - 54,WIDOWED,263,225,38,0,198,171,27,0,65,54,11,0
ZHOB,DISTRICT,55 - 59,DIVORCED,2,1,1,0,2,1,1,0,0,0,0,0
ZHOB,DISTRICT,55 - 59,MARRIED,4988,2058,2930,0,4242,1786,2456,0,746,272,474,0
ZHOB,DISTRICT,55 - 59,NEVER MARRIED,38,15,23,0,27,9,18,0,11,6,5,0
ZHOB,DISTRICT,55 - 59,SEPERATION,6,3,3,0,3,1,2,0,3,2,1,0
ZHOB,DISTRICT,55 - 59,WIDOWED,249,223,26,0,177,161,16,0,72,62,10,0
ZHOB,DISTRICT,60 - 64,DIVORCED,1,1,0,0,0,0,0,0,1,1,0,0
ZHOB,DISTRICT,60 - 64,MARRIED,3677,1453,2224,0,3207,1280,1927,0,470,173,297,0
ZHOB,DISTRICT,60 - 64,NEVER MARRIED,27,7,20,0,16,6,10,0,11,1,10,0
ZHOB,DISTRICT,60 - 64,SEPERATION,4,2,2,0,3,1,2,0,1,1,0,0
ZHOB,DISTRICT,60 - 64,WIDOWED,300,253,47,0,218,187,31,0,82,66,16,0
ZHOB,DISTRICT,65 - 69,DIVORCED,0,0,0,0,0,0,0,0,0,0,0,0
ZHOB,DISTRICT,65 - 69,MARRIED,2296,860,1436,0,2011,776,1235,0,285,84,201,0
ZHOB,DISTRICT,65 - 69,NEVER MARRIED,6,1,5,0,5,0,5,0,1,1,0,0
ZHOB,DISTRICT,65 - 69,SEPERATION,3,2,1,0,3,2,1,0,0,0,0,0
ZHOB,DISTRICT,65 - 69,WIDOWED,239,202,37,0,178,156,22,0,61,46,15,0
ZHOB,DISTRICT,70 - 74,DIVORCED,1,1,0,0,1,1,0,0,0,0,0,0
ZHOB,DISTRICT,70 - 74,MARRIED,1747,636,1111,0,1528,552,976,0,219,84,135,0
ZHOB,DISTRICT,70 - 74,NEVER MARRIED,1,1,0,0,1,1,0,0,0,0,0,0
ZHOB,DISTRICT,70 - 74,SEPERATION,3,0,3,0,3,0,3,0,0,0,0,0
ZHOB,DISTRICT,70 - 74,WIDOWED,284,242,42,0,219,191,28,0,65,51,14,0
ZHOB,DISTRICT,75 & ABOVE,DIVORCED,0,0,0,0,0,0,0,0,0,0,0,0
ZHOB,DISTRICT,75 & ABOVE,MARRIED,1834,582,1252,0,1650,527,1123,0,184,55,129,0
ZHOB,DISTRICT,75 & ABOVE,NEVER MARRIED,5,1,4,0,5,1,4,0,0,0,0,0
ZHOB,DISTRICT,75 & ABOVE,SEPERATION,7,4,3,0,6,3,3,0,1,1,0,0
ZHOB,DISTRICT,75 & ABOVE,WIDOWED,388,317,71,0,286,238,48,0,102,79,23,0
ZIARAT,DISTRICT,15 &  ABOVE,DIVORCED,40,34,6,0,27,23,4,0,13,11,2,0
ZIARAT,DISTRICT,15 &  ABOVE,MARRIED,50079,25590,24489,0,37743,19263,18480,0,12336,6327,6009,0
ZIARAT,DISTRICT,15 &  ABOVE,NEVER MARRIED,32189,14701,17483,5,22721,10661,12056,4,9468,4040,5427,1
ZIARAT,DISTRICT,15 &  ABOVE,SEPERATION,21,12,9,0,14,11,3,0,7,1,6,0
ZIARAT,DISTRICT,15 &  ABOVE,WIDOWED,1848,1585,263,0,1341,1139,202,0,507,446,61,0
ZIARAT,DISTRICT,15 - 19,DIVORCED,0,0,0,0,0,0,0,0,0,0,0,0
ZIARAT,DISTRICT,15 - 19,MARRIED,1680,1083,597,0,1254,809,445,0,426,274,152,0
ZIARAT,DISTRICT,15 - 19,NEVER MARRIED,16828,7839,8986,3,12065,5657,6406,2,4763,2182,2580,1
ZIARAT,DISTRICT,15 - 19,SEPERATION,4,2,2,0,3,2,1,0,1,0,1,0
ZIARAT,DISTRICT,15 - 19,WIDOWED,3,3,0,0,3,3,0,0,0,0,0,0
ZIARAT,DISTRICT,20 - 24,DIVORCED,2,2,0,0,0,0,0,0,2,2,0,0
ZIARAT,DISTRICT,20 - 24,MARRIED,5202,3219,1983,0,4069,2544,1525,0,1133,675,458,0
ZIARAT,DISTRICT,20 - 24,NEVER MARRIED,8151,3533,4618,0,5696,2594,3102,0,2455,939,1516,0
ZIARAT,DISTRICT,20 - 24,SEPERATION,6,2,4,0,3,2,1,0,3,0,3,0
ZIARAT,DISTRICT,20 - 24,WIDOWED,10,10,0,0,9,9,0,0,1,1,0,0
ZIARAT,DISTRICT,25 - 29,DIVORCED,4,4,0,0,3,3,0,0,1,1,0,0
ZIARAT,DISTRICT,25 - 29,MARRIED,6512,3527,2985,0,5020,2682,2338,0,1492,845,647,0
ZIARAT,DISTRICT,25 - 29,NEVER MARRIED,3789,1645,2144,0,2589,1167,1422,0,1200,478,722,0
ZIARAT,DISTRICT,25 - 29,SEPERATION,2,1,1,0,2,1,1,0,0,0,0,0
ZIARAT,DISTRICT,25 - 29,WIDOWED,17,13,4,0,14,11,3,0,3,2,1,0
ZIARAT,DISTRICT,30 - 34,DIVORCED,7,5,2,0,4,4,0,0,3,1,2,0
ZIARAT,DISTRICT,30 - 34,MARRIED,7417,4049,3368,0,5561,3037,2524,0,1856,1012,844,0
ZIARAT,DISTRICT,30 - 34,NEVER MARRIED,1874,984,890,0,1334,731,603,0,540,253,287,0
ZIARAT,DISTRICT,30 - 34,SEPERATION,0,0,0,0,0,0,0,0,0,0,0,0
ZIARAT,DISTRICT,30 - 34,WIDOWED,26,20,6,0,22,18,4,0,4,2,2,0
ZIARAT,DISTRICT,35 - 39,DIVORCED,5,5,0,0,4,4,0,0,1,1,0,0
ZIARAT,DISTRICT,35 - 39,MARRIED,6981,3625,3356,0,5164,2679,2485,0,1817,946,871,0
ZIARAT,DISTRICT,35 - 39,NEVER MARRIED,698,315,383,0,475,229,246,0,223,86,137,0
ZIARAT,DISTRICT,35 - 39,SEPERATION,0,0,0,0,0,0,0,0,0,0,0,0
ZIARAT,DISTRICT,35 - 39,WIDOWED,51,43,8,0,39,32,7,0,12,11,1,0
ZIARAT,DISTRICT,40 - 44,DIVORCED,8,7,1,0,7,6,1,0,1,1,0,0
ZIARAT,DISTRICT,40 - 44,MARRIED,6708,3265,3443,0,5045,2435,2610,0,1663,830,833,0
ZIARAT,DISTRICT,40 - 44,NEVER MARRIED,363,179,184,0,234,127,107,0,129,52,77,0
ZIARAT,DISTRICT,40 - 44,SEPERATION,0,0,0,0,0,0,0,0,0,0,0,0
ZIARAT,DISTRICT,40 - 44,WIDOWED,101,86,15,0,69,58,11,0,32,28,4,0
ZIARAT,DISTRICT,45 - 49,DIVORCED,4,3,1,0,1,0,1,0,3,3,0,0
ZIARAT,DISTRICT,45 - 49,MARRIED,4178,1988,2190,0,3073,1458,1615,0,1105,530,575,0
ZIARAT,DISTRICT,45 - 49,NEVER MARRIED,166,66,100,0,95,43,52,0,71,23,48,0
ZIARAT,DISTRICT,45 - 49,SEPERATION,0,0,0,0,0,0,0,0,0,0,0,0
ZIARAT,DISTRICT,45 - 49,WIDOWED,107,99,8,0,76,69,7,0,31,30,1,0
ZIARAT,DISTRICT,50 - 54,DIVORCED,3,3,0,0,3,3,0,0,0,0,0,0
ZIARAT,DISTRICT,50 - 54,MARRIED,3832,1827,2005,0,2835,1350,1485,0,997,477,520,0
ZIARAT,DISTRICT,50 - 54,NEVER MARRIED,98,39,59,0,62,29,33,0,36,10,26,0
ZIARAT,DISTRICT,50 - 54,SEPERATION,1,1,0,0,1,1,0,0,0,0,0,0
ZIARAT,DISTRICT,50 - 54,WIDOWED,218,188,30,0,155,135,20,0,63,53,10,0
ZIARAT,DISTRICT,55 - 59,DIVORCED,5,4,1,0,4,3,1,0,1,1,0,0
ZIARAT,DISTRICT,55 - 59,MARRIED,2732,1149,1583,0,1989,839,1150,0,743,310,433,0
ZIARAT,DISTRICT,55 - 59,NEVER MARRIED,85,40,45,0,59,32,27,0,26,8,18,0
ZIARAT,DISTRICT,55 - 59,SEPERATION,2,2,0,0,2,2,0,0,0,0,0,0
ZIARAT,DISTRICT,55 - 59,WIDOWED,184,158,26,0,123,104,19,0,61,54,7,0
ZIARAT,DISTRICT,60 - 64,DIVORCED,1,0,1,0,1,0,1,0,0,0,0,0
ZIARAT,DISTRICT,60 - 64,MARRIED,2006,828,1178,0,1519,626,893,0,487,202,285,0
ZIARAT,DISTRICT,60 - 64,NEVER MARRIED,36,16,20,0,26,13,13,0,10,3,7,0
ZIARAT,DISTRICT,60 - 64,SEPERATION,3,3,0,0,2,2,0,0,1,1,0,0
ZIARAT,DISTRICT,60 - 64,WIDOWED,282,244,38,0,204,175,29,0,78,69,9,0
ZIARAT,DISTRICT,65 - 69,DIVORCED,1,1,0,0,0,0,0,0,1,1,0,0
ZIARAT,DISTRICT,65 - 69,MARRIED,1318,515,803,0,1018,399,619,0,300,116,184,0
ZIARAT,DISTRICT,65 - 69,NEVER MARRIED,38,17,20,1,35,16,18,1,3,1,2,0
ZIARAT,DISTRICT,65 - 69,SEPERATION,2,0,2,0,0,0,0,0,2,0,2,0
ZIARAT,DISTRICT,65 - 69,WIDOWED,260,229,31,0,200,176,24,0,60,53,7,0
ZIARAT,DISTRICT,70 - 74,DIVORCED,0,0,0,0,0,0,0,0,0,0,0,0
ZIARAT,DISTRICT,70 - 74,MARRIED,860,305,555,0,675,236,439,0,185,69,116,0
ZIARAT,DISTRICT,70 - 74,NEVER MARRIED,29,13,16,0,24,11,13,0,5,2,3,0
ZIARAT,DISTRICT,70 - 74,SEPERATION,1,1,0,0,1,1,0,0,0,0,0,0
ZIARAT,DISTRICT,70 - 74,WIDOWED,286,242,44,0,210,176,34,0,76,66,10,0
ZIARAT,DISTRICT,75 & ABOVE,DIVORCED,0,0,0,0,0,0,0,0,0,0,0,0
ZIARAT,DISTRICT,75 & ABOVE,MARRIED,653,210,443,0,521,169,352,0,132,41,91,0
ZIARAT,DISTRICT,75 & ABOVE,NEVER MARRIED,34,15,18,1,27,12,14,1,7,3,4,0
ZIARAT,DISTRICT,75 & ABOVE,SEPERATION,0,0,0,0,0,0,0,0,0,0,0,0
ZIARAT,DISTRICT,75 & ABOVE,WIDOWED,303,250,53,0,217,173,44,0,86,77,9,0
