name_admin_unit,admin_unit,age_group,marital_status,all_sexes_overall,female_overall,male_overall,tgend_overall,all_sexes_rural,female_rural,male_rural,tgend_rural,all_sexes_urban,female_urban,male_urban,tgend_urban
ATTOCK,DISTRICT,15 &  ABOVE,DIVORCED,7726,5854,1872,0,6023,4545,1478,0,1703,1309,394,0
ATTOCK,DISTRICT,15 &  ABOVE,MARRIED,930316,472577,457739,0,680920,346400,334520,0,249396,126177,123219,0
ATTOCK,DISTRICT,15 &  ABOVE,NEVER MARRIED,421244,177737,243427,80,301445,126830,174598,17,119799,50907,68829,63
ATTOCK,DISTRICT,15 &  ABOVE,SEPERATION,1738,855,883,0,1238,597,641,0,500,258,242,0
ATTOCK,DISTRICT,15 &  ABOVE,WIDOWED,67697,53911,13786,0,51071,40459,10612,0,16626,13452,3174,0
ATTOCK,DISTRICT,15 - 19,DIVORCED,54,50,4,0,43,40,3,0,11,10,1,0
ATTOCK,DISTRICT,15 - 19,MARRIED,12170,9662,2508,0,9312,7438,1874,0,2858,2224,634,0
ATTOCK,DISTRICT,15 - 19,NEVER MARRIED,188014,89349,98656,9,133987,64040,69942,5,54027,25309,28714,4
ATTOCK,DISTRICT,15 - 19,SEPERATION,15,11,4,0,11,8,3,0,4,3,1,0
ATTOCK,DISTRICT,15 - 19,WIDOWED,30,20,10,0,22,12,10,0,8,8,0,0
ATTOCK,DISTRICT,20 - 24,DIVORCED,389,334,55,0,298,255,43,0,91,79,12,0
ATTOCK,DISTRICT,20 - 24,MARRIED,56725,41493,15232,0,42824,31295,11529,0,13901,10198,3703,0
ATTOCK,DISTRICT,20 - 24,NEVER MARRIED,119104,46023,73066,15,84540,31944,52594,2,34564,14079,20472,13
ATTOCK,DISTRICT,20 - 24,SEPERATION,99,74,25,0,65,47,18,0,34,27,7,0
ATTOCK,DISTRICT,20 - 24,WIDOWED,166,119,47,0,135,96,39,0,31,23,8,0
ATTOCK,DISTRICT,25 - 29,DIVORCED,782,619,163,0,602,472,130,0,180,147,33,0
ATTOCK,DISTRICT,25 - 29,MARRIED,105304,65298,40006,0,77881,48077,29804,0,27423,17221,10202,0
ATTOCK,DISTRICT,25 - 29,NEVER MARRIED,59398,19038,40344,16,42526,13290,29230,6,16872,5748,11114,10
ATTOCK,DISTRICT,25 - 29,SEPERATION,158,87,71,0,107,57,50,0,51,30,21,0
ATTOCK,DISTRICT,25 - 29,WIDOWED,450,335,115,0,340,250,90,0,110,85,25,0
ATTOCK,DISTRICT,30 - 34,DIVORCED,1135,832,303,0,870,631,239,0,265,201,64,0
ATTOCK,DISTRICT,30 - 34,MARRIED,129398,71274,58124,0,93512,51269,42243,0,35886,20005,15881,0
ATTOCK,DISTRICT,30 - 34,NEVER MARRIED,24154,8416,15726,12,17390,6028,11362,0,6764,2388,4364,12
ATTOCK,DISTRICT,30 - 34,SEPERATION,256,127,129,0,184,85,99,0,72,42,30,0
ATTOCK,DISTRICT,30 - 34,WIDOWED,876,672,204,0,637,490,147,0,239,182,57,0
ATTOCK,DISTRICT,35 - 39,DIVORCED,1227,903,324,0,916,665,251,0,311,238,73,0
ATTOCK,DISTRICT,35 - 39,MARRIED,134933,69046,65887,0,96561,49317,47244,0,38372,19729,18643,0
ATTOCK,DISTRICT,35 - 39,NEVER MARRIED,11420,4494,6916,10,8341,3336,5004,1,3079,1158,1912,9
ATTOCK,DISTRICT,35 - 39,SEPERATION,259,131,128,0,177,84,93,0,82,47,35,0
ATTOCK,DISTRICT,35 - 39,WIDOWED,1620,1325,295,0,1172,955,217,0,448,370,78,0
ATTOCK,DISTRICT,40 - 44,DIVORCED,1085,819,266,0,825,614,211,0,260,205,55,0
ATTOCK,DISTRICT,40 - 44,MARRIED,119949,58802,61147,0,85328,41927,43401,0,34621,16875,17746,0
ATTOCK,DISTRICT,40 - 44,NEVER MARRIED,6523,3085,3432,6,4850,2358,2492,0,1673,727,940,6
ATTOCK,DISTRICT,40 - 44,SEPERATION,230,90,140,0,162,66,96,0,68,24,44,0
ATTOCK,DISTRICT,40 - 44,WIDOWED,2800,2413,387,0,2027,1743,284,0,773,670,103,0
ATTOCK,DISTRICT,45 - 49,DIVORCED,853,657,196,0,678,527,151,0,175,130,45,0
ATTOCK,DISTRICT,45 - 49,MARRIED,97607,45702,51905,0,69879,33095,36784,0,27728,12607,15121,0
ATTOCK,DISTRICT,45 - 49,NEVER MARRIED,4033,2128,1900,5,3089,1663,1425,1,944,465,475,4
ATTOCK,DISTRICT,45 - 49,SEPERATION,204,85,119,0,148,63,85,0,56,22,34,0
ATTOCK,DISTRICT,45 - 49,WIDOWED,3765,3278,487,0,2760,2395,365,0,1005,883,122,0
ATTOCK,DISTRICT,50 - 54,DIVORCED,707,530,177,0,556,427,129,0,151,103,48,0
ATTOCK,DISTRICT,50 - 54,MARRIED,79978,36705,43273,0,58741,27172,31569,0,21237,9533,11704,0
ATTOCK,DISTRICT,50 - 54,NEVER MARRIED,2856,1635,1217,4,2225,1331,893,1,631,304,324,3
ATTOCK,DISTRICT,50 - 54,SEPERATION,179,94,85,0,129,66,63,0,50,28,22,0
ATTOCK,DISTRICT,50 - 54,WIDOWED,5914,5175,739,0,4355,3805,550,0,1559,1370,189,0
ATTOCK,DISTRICT,55 - 59,DIVORCED,570,443,127,0,471,367,104,0,99,76,23,0
ATTOCK,DISTRICT,55 - 59,MARRIED,65382,27996,37386,0,48487,20888,27599,0,16895,7108,9787,0
ATTOCK,DISTRICT,55 - 59,NEVER MARRIED,2088,1259,829,0,1642,1019,623,0,446,240,206,0
ATTOCK,DISTRICT,55 - 59,SEPERATION,111,55,56,0,80,40,40,0,31,15,16,0
ATTOCK,DISTRICT,55 - 59,WIDOWED,7304,6170,1134,0,5428,4570,858,0,1876,1600,276,0
ATTOCK,DISTRICT,60 - 64,DIVORCED,397,287,110,0,333,239,94,0,64,48,16,0
ATTOCK,DISTRICT,60 - 64,MARRIED,50075,19627,30448,0,37355,14796,22559,0,12720,4831,7889,0
ATTOCK,DISTRICT,60 - 64,NEVER MARRIED,1502,901,600,1,1142,706,436,0,360,195,164,1
ATTOCK,DISTRICT,60 - 64,SEPERATION,81,37,44,0,60,29,31,0,21,8,13,0
ATTOCK,DISTRICT,60 - 64,WIDOWED,8956,7370,1586,0,6490,5328,1162,0,2466,2042,424,0
ATTOCK,DISTRICT,65 - 69,DIVORCED,245,177,68,0,197,144,53,0,48,33,15,0
ATTOCK,DISTRICT,65 - 69,MARRIED,35407,13886,21521,0,26886,10677,16209,0,8521,3209,5312,0
ATTOCK,DISTRICT,65 - 69,NEVER MARRIED,1000,684,315,1,795,538,256,1,205,146,59,0
ATTOCK,DISTRICT,65 - 69,SEPERATION,67,28,39,0,59,25,34,0,8,3,5,0
ATTOCK,DISTRICT,65 - 69,WIDOWED,10039,8132,1907,0,7547,6067,1480,0,2492,2065,427,0
ATTOCK,DISTRICT,70 - 74,DIVORCED,152,100,52,0,124,79,45,0,28,21,7,0
ATTOCK,DISTRICT,70 - 74,MARRIED,22750,7074,15676,0,17659,5572,12087,0,5091,1502,3589,0
ATTOCK,DISTRICT,70 - 74,NEVER MARRIED,564,348,216,0,451,279,172,0,113,69,44,0
ATTOCK,DISTRICT,70 - 74,SEPERATION,46,22,24,0,29,15,14,0,17,7,10,0
ATTOCK,DISTRICT,70 - 74,WIDOWED,9821,7464,2357,0,7578,5738,1840,0,2243,1726,517,0
ATTOCK,DISTRICT,75 & ABOVE,DIVORCED,130,103,27,0,110,85,25,0,20,18,2,0
ATTOCK,DISTRICT,75 & ABOVE,MARRIED,20638,6012,14626,0,16495,4877,11618,0,4143,1135,3008,0
ATTOCK,DISTRICT,75 & ABOVE,NEVER MARRIED,588,377,210,1,467,298,169,0,121,79,41,1
ATTOCK,DISTRICT,75 & ABOVE,SEPERATION,33,14,19,0,27,12,15,0,6,2,4,0
ATTOCK,DISTRICT,75 & ABOVE,WIDOWED,15956,11438,4518,0,12580,9010,3570,0,3376,2428,948,0
BAHAWALNAGAR,DISTRICT,15 &  ABOVE,DIVORCED,12734,8518,4216,0,8987,6031,2956,0,3747,2487,1260,0
BAHAWALNAGAR,DISTRICT,15 &  ABOVE,MARRIED,1398027,703122,694905,0,1016725,511625,505100,0,381302,191497,189805,0
BAHAWALNAGAR,DISTRICT,15 &  ABOVE,NEVER MARRIED,616907,252406,364145,356,423638,171566,251983,89,193269,80840,112162,267
BAHAWALNAGAR,DISTRICT,15 &  ABOVE,SEPERATION,5137,3132,2005,0,4026,2475,1551,0,1111,657,454,0
BAHAWALNAGAR,DISTRICT,15 &  ABOVE,WIDOWED,89738,62570,27168,0,63178,43320,19858,0,26560,19250,7310,0
BAHAWALNAGAR,DISTRICT,15 - 19,DIVORCED,270,218,52,0,203,158,45,0,67,60,7,0
BAHAWALNAGAR,DISTRICT,15 - 19,MARRIED,28193,20085,8108,0,22221,15728,6493,0,5972,4357,1615,0
BAHAWALNAGAR,DISTRICT,15 - 19,NEVER MARRIED,321024,144502,176489,33,224694,100878,123797,19,96330,43624,52692,14
BAHAWALNAGAR,DISTRICT,15 - 19,SEPERATION,159,120,39,0,130,93,37,0,29,27,2,0
BAHAWALNAGAR,DISTRICT,15 - 19,WIDOWED,113,64,49,0,86,48,38,0,27,16,11,0
BAHAWALNAGAR,DISTRICT,20 - 24,DIVORCED,1040,720,320,0,730,488,242,0,310,232,78,0
BAHAWALNAGAR,DISTRICT,20 - 24,MARRIED,109660,71634,38026,0,83640,54127,29513,0,26020,17507,8513,0
BAHAWALNAGAR,DISTRICT,20 - 24,NEVER MARRIED,173020,67834,105125,61,115973,44023,71941,9,57047,23811,33184,52
BAHAWALNAGAR,DISTRICT,20 - 24,SEPERATION,441,279,162,0,356,228,128,0,85,51,34,0
BAHAWALNAGAR,DISTRICT,20 - 24,WIDOWED,501,287,214,0,371,209,162,0,130,78,52,0
BAHAWALNAGAR,DISTRICT,25 - 29,DIVORCED,1567,1034,533,0,1119,735,384,0,448,299,149,0
BAHAWALNAGAR,DISTRICT,25 - 29,MARRIED,177811,101085,76726,0,129872,73170,56702,0,47939,27915,20024,0
BAHAWALNAGAR,DISTRICT,25 - 29,NEVER MARRIED,73323,24169,49077,77,48674,15443,33220,11,24649,8726,15857,66
BAHAWALNAGAR,DISTRICT,25 - 29,SEPERATION,607,380,227,0,475,298,177,0,132,82,50,0
BAHAWALNAGAR,DISTRICT,25 - 29,WIDOWED,1054,572,482,0,793,411,382,0,261,161,100,0
BAHAWALNAGAR,DISTRICT,30 - 34,DIVORCED,1928,1274,654,0,1301,866,435,0,627,408,219,0
BAHAWALNAGAR,DISTRICT,30 - 34,MARRIED,197770,105254,92516,0,141485,75055,66430,0,56285,30199,26086,0
BAHAWALNAGAR,DISTRICT,30 - 34,NEVER MARRIED,24357,7106,17203,48,16419,4732,11678,9,7938,2374,5525,39
BAHAWALNAGAR,DISTRICT,30 - 34,SEPERATION,648,392,256,0,487,295,192,0,161,97,64,0
BAHAWALNAGAR,DISTRICT,30 - 34,WIDOWED,1747,1092,655,0,1239,746,493,0,508,346,162,0
BAHAWALNAGAR,DISTRICT,35 - 39,DIVORCED,1763,1146,617,0,1225,806,419,0,538,340,198,0
BAHAWALNAGAR,DISTRICT,35 - 39,MARRIED,194137,96718,97419,0,138482,68760,69722,0,55655,27958,27697,0
BAHAWALNAGAR,DISTRICT,35 - 39,NEVER MARRIED,10608,3303,7272,33,7298,2314,4972,12,3310,989,2300,21
BAHAWALNAGAR,DISTRICT,35 - 39,SEPERATION,660,388,272,0,507,301,206,0,153,87,66,0
BAHAWALNAGAR,DISTRICT,35 - 39,WIDOWED,2758,1925,833,0,1933,1312,621,0,825,613,212,0
BAHAWALNAGAR,DISTRICT,40 - 44,DIVORCED,1657,1158,499,0,1134,805,329,0,523,353,170,0
BAHAWALNAGAR,DISTRICT,40 - 44,MARRIED,172759,83585,89174,0,124188,59979,64209,0,48571,23606,24965,0
BAHAWALNAGAR,DISTRICT,40 - 44,NEVER MARRIED,5302,1914,3354,34,3701,1420,2272,9,1601,494,1082,25
BAHAWALNAGAR,DISTRICT,40 - 44,SEPERATION,628,398,230,0,486,317,169,0,142,81,61,0
BAHAWALNAGAR,DISTRICT,40 - 44,WIDOWED,4444,3348,1096,0,3063,2252,811,0,1381,1096,285,0
BAHAWALNAGAR,DISTRICT,45 - 49,DIVORCED,1358,916,442,0,942,643,299,0,416,273,143,0
BAHAWALNAGAR,DISTRICT,45 - 49,MARRIED,135976,64261,71715,0,96856,46096,50760,0,39120,18165,20955,0
BAHAWALNAGAR,DISTRICT,45 - 49,NEVER MARRIED,3220,1186,2011,23,2313,896,1409,8,907,290,602,15
BAHAWALNAGAR,DISTRICT,45 - 49,SEPERATION,546,328,218,0,422,265,157,0,124,63,61,0
BAHAWALNAGAR,DISTRICT,45 - 49,WIDOWED,5659,4392,1267,0,3829,2923,906,0,1830,1469,361,0
BAHAWALNAGAR,DISTRICT,50 - 54,DIVORCED,1154,798,356,0,844,593,251,0,310,205,105,0
BAHAWALNAGAR,DISTRICT,50 - 54,MARRIED,120490,55234,65256,0,86698,40043,46655,0,33792,15191,18601,0
BAHAWALNAGAR,DISTRICT,50 - 54,NEVER MARRIED,2183,886,1274,23,1584,684,892,8,599,202,382,15
BAHAWALNAGAR,DISTRICT,50 - 54,SEPERATION,447,280,167,0,352,219,133,0,95,61,34,0
BAHAWALNAGAR,DISTRICT,50 - 54,WIDOWED,8980,6981,1999,0,6110,4687,1423,0,2870,2294,576,0
BAHAWALNAGAR,DISTRICT,55 - 59,DIVORCED,831,538,293,0,613,403,210,0,218,135,83,0
BAHAWALNAGAR,DISTRICT,55 - 59,MARRIED,94364,40323,54041,0,68260,29388,38872,0,26104,10935,15169,0
BAHAWALNAGAR,DISTRICT,55 - 59,NEVER MARRIED,1467,592,866,9,1120,461,658,1,347,131,208,8
BAHAWALNAGAR,DISTRICT,55 - 59,SEPERATION,374,198,176,0,297,157,140,0,77,41,36,0
BAHAWALNAGAR,DISTRICT,55 - 59,WIDOWED,10236,7586,2650,0,6808,4944,1864,0,3428,2642,786,0
BAHAWALNAGAR,DISTRICT,60 - 64,DIVORCED,541,354,187,0,403,267,136,0,138,87,51,0
BAHAWALNAGAR,DISTRICT,60 - 64,MARRIED,67020,28008,39012,0,48811,20702,28109,0,18209,7306,10903,0
BAHAWALNAGAR,DISTRICT,60 - 64,NEVER MARRIED,1096,441,647,8,839,342,495,2,257,99,152,6
BAHAWALNAGAR,DISTRICT,60 - 64,SEPERATION,309,194,115,0,250,158,92,0,59,36,23,0
BAHAWALNAGAR,DISTRICT,60 - 64,WIDOWED,11987,8709,3278,0,8286,5984,2302,0,3701,2725,976,0
BAHAWALNAGAR,DISTRICT,65 - 69,DIVORCED,314,202,112,0,239,153,86,0,75,49,26,0
BAHAWALNAGAR,DISTRICT,65 - 69,MARRIED,45075,18609,26466,0,33423,14036,19387,0,11652,4573,7079,0
BAHAWALNAGAR,DISTRICT,65 - 69,NEVER MARRIED,605,241,362,2,463,189,273,1,142,52,89,1
BAHAWALNAGAR,DISTRICT,65 - 69,SEPERATION,146,85,61,0,114,65,49,0,32,20,12,0
BAHAWALNAGAR,DISTRICT,65 - 69,WIDOWED,12103,8575,3528,0,8356,5854,2502,0,3747,2721,1026,0
BAHAWALNAGAR,DISTRICT,70 - 74,DIVORCED,178,93,85,0,134,63,71,0,44,30,14,0
BAHAWALNAGAR,DISTRICT,70 - 74,MARRIED,28871,10152,18719,0,22171,7972,14199,0,6700,2180,4520,0
BAHAWALNAGAR,DISTRICT,70 - 74,NEVER MARRIED,353,120,229,4,267,92,175,0,86,28,54,4
BAHAWALNAGAR,DISTRICT,70 - 74,SEPERATION,96,55,41,0,82,46,36,0,14,9,5,0
BAHAWALNAGAR,DISTRICT,70 - 74,WIDOWED,11755,7801,3954,0,8588,5665,2923,0,3167,2136,1031,0
BAHAWALNAGAR,DISTRICT,75 & ABOVE,DIVORCED,133,67,66,0,100,51,49,0,33,16,17,0
BAHAWALNAGAR,DISTRICT,75 & ABOVE,MARRIED,25901,8174,17727,0,20618,6569,14049,0,5283,1605,3678,0
BAHAWALNAGAR,DISTRICT,75 & ABOVE,NEVER MARRIED,349,112,236,1,293,92,201,0,56,20,35,1
BAHAWALNAGAR,DISTRICT,75 & ABOVE,SEPERATION,76,35,41,0,68,33,35,0,8,2,6,0
BAHAWALNAGAR,DISTRICT,75 & ABOVE,WIDOWED,18401,11238,7163,0,13716,8285,5431,0,4685,2953,1732,0
BAHAWALPUR,DISTRICT,15 &  ABOVE,DIVORCED,10331,6866,3465,0,6178,4017,2161,0,4153,2849,1304,0
BAHAWALPUR,DISTRICT,15 &  ABOVE,MARRIED,1692658,851684,840974,0,1061658,535178,526480,0,631000,316506,314494,0
BAHAWALPUR,DISTRICT,15 &  ABOVE,NEVER MARRIED,711516,300709,410356,451,395027,164312,230588,127,316489,136397,179768,324
BAHAWALPUR,DISTRICT,15 &  ABOVE,SEPERATION,4714,2613,2101,0,3107,1712,1395,0,1607,901,706,0
BAHAWALPUR,DISTRICT,15 &  ABOVE,WIDOWED,101526,74167,27359,0,62506,45007,17499,0,39020,29160,9860,0
BAHAWALPUR,DISTRICT,15 - 19,DIVORCED,210,170,40,0,146,115,31,0,64,55,9,0
BAHAWALPUR,DISTRICT,15 - 19,MARRIED,42069,30392,11677,0,30072,21417,8655,0,11997,8975,3022,0
BAHAWALPUR,DISTRICT,15 - 19,NEVER MARRIED,371398,173112,198233,53,221325,103295,118011,19,150073,69817,80222,34
BAHAWALPUR,DISTRICT,15 - 19,SEPERATION,138,97,41,0,90,65,25,0,48,32,16,0
BAHAWALPUR,DISTRICT,15 - 19,WIDOWED,155,92,63,0,107,66,41,0,48,26,22,0
BAHAWALPUR,DISTRICT,20 - 24,DIVORCED,882,655,227,0,547,391,156,0,335,264,71,0
BAHAWALPUR,DISTRICT,20 - 24,MARRIED,152939,98380,54559,0,103435,65306,38129,0,49504,33074,16430,0
BAHAWALPUR,DISTRICT,20 - 24,NEVER MARRIED,202963,79181,123696,86,104094,37697,66381,16,98869,41484,57315,70
BAHAWALPUR,DISTRICT,20 - 24,SEPERATION,406,267,139,0,283,194,89,0,123,73,50,0
BAHAWALPUR,DISTRICT,20 - 24,WIDOWED,649,370,279,0,452,246,206,0,197,124,73,0
BAHAWALPUR,DISTRICT,25 - 29,DIVORCED,1413,937,476,0,826,534,292,0,587,403,184,0
BAHAWALPUR,DISTRICT,25 - 29,MARRIED,223986,124898,99088,0,142178,77899,64279,0,81808,46999,34809,0
BAHAWALPUR,DISTRICT,25 - 29,NEVER MARRIED,82253,29039,53128,86,41288,13504,27769,15,40965,15535,25359,71
BAHAWALPUR,DISTRICT,25 - 29,SEPERATION,571,324,247,0,368,202,166,0,203,122,81,0
BAHAWALPUR,DISTRICT,25 - 29,WIDOWED,1251,683,568,0,860,456,404,0,391,227,164,0
BAHAWALPUR,DISTRICT,30 - 34,DIVORCED,1620,1079,541,0,954,607,347,0,666,472,194,0
BAHAWALPUR,DISTRICT,30 - 34,MARRIED,243291,128229,115062,0,149991,78483,71508,0,93300,49746,43554,0
BAHAWALPUR,DISTRICT,30 - 34,NEVER MARRIED,27430,10198,17178,54,14098,5073,9012,13,13332,5125,8166,41
BAHAWALPUR,DISTRICT,30 - 34,SEPERATION,691,378,313,0,454,248,206,0,237,130,107,0
BAHAWALPUR,DISTRICT,30 - 34,WIDOWED,2159,1437,722,0,1377,903,474,0,782,534,248,0
BAHAWALPUR,DISTRICT,35 - 39,DIVORCED,1716,1123,593,0,980,632,348,0,736,491,245,0
BAHAWALPUR,DISTRICT,35 - 39,MARRIED,233938,116661,117277,0,140856,70704,70152,0,93082,45957,47125,0
BAHAWALPUR,DISTRICT,35 - 39,NEVER MARRIED,12575,4028,8487,60,6430,1995,4419,16,6145,2033,4068,44
BAHAWALPUR,DISTRICT,35 - 39,SEPERATION,636,317,319,0,409,202,207,0,227,115,112,0
BAHAWALPUR,DISTRICT,35 - 39,WIDOWED,3397,2421,976,0,2089,1448,641,0,1308,973,335,0
BAHAWALPUR,DISTRICT,40 - 44,DIVORCED,1406,937,469,0,861,574,287,0,545,363,182,0
BAHAWALPUR,DISTRICT,40 - 44,MARRIED,215359,103027,112332,0,134898,64484,70414,0,80461,38543,41918,0
BAHAWALPUR,DISTRICT,40 - 44,NEVER MARRIED,6191,2022,4134,35,3235,1068,2153,14,2956,954,1981,21
BAHAWALPUR,DISTRICT,40 - 44,SEPERATION,626,348,278,0,405,237,168,0,221,111,110,0
BAHAWALPUR,DISTRICT,40 - 44,WIDOWED,5516,4229,1287,0,3508,2623,885,0,2008,1606,402,0
BAHAWALPUR,DISTRICT,45 - 49,DIVORCED,965,628,337,0,579,374,205,0,386,254,132,0
BAHAWALPUR,DISTRICT,45 - 49,MARRIED,162254,75978,86276,0,98754,46663,52091,0,63500,29315,34185,0
BAHAWALPUR,DISTRICT,45 - 49,NEVER MARRIED,3408,1096,2281,31,1728,593,1120,15,1680,503,1161,16
BAHAWALPUR,DISTRICT,45 - 49,SEPERATION,507,268,239,0,342,174,168,0,165,94,71,0
BAHAWALPUR,DISTRICT,45 - 49,WIDOWED,7382,5814,1568,0,4481,3465,1016,0,2901,2349,552,0
BAHAWALPUR,DISTRICT,50 - 54,DIVORCED,774,526,248,0,473,310,163,0,301,216,85,0
BAHAWALPUR,DISTRICT,50 - 54,MARRIED,134635,61251,73384,0,82636,37968,44668,0,51999,23283,28716,0
BAHAWALPUR,DISTRICT,50 - 54,NEVER MARRIED,2052,767,1270,15,1069,418,643,8,983,349,627,7
BAHAWALPUR,DISTRICT,50 - 54,SEPERATION,376,217,159,0,246,137,109,0,130,80,50,0
BAHAWALPUR,DISTRICT,50 - 54,WIDOWED,10316,8213,2103,0,6216,4857,1359,0,4100,3356,744,0
BAHAWALPUR,DISTRICT,55 - 59,DIVORCED,568,334,234,0,325,185,140,0,243,149,94,0
BAHAWALPUR,DISTRICT,55 - 59,MARRIED,102233,43019,59214,0,62230,26350,35880,0,40003,16669,23334,0
BAHAWALPUR,DISTRICT,55 - 59,NEVER MARRIED,1237,467,755,15,662,259,399,4,575,208,356,11
BAHAWALPUR,DISTRICT,55 - 59,SEPERATION,279,147,132,0,188,99,89,0,91,48,43,0
BAHAWALPUR,DISTRICT,55 - 59,WIDOWED,11578,8821,2757,0,6781,5050,1731,0,4797,3771,1026,0
BAHAWALPUR,DISTRICT,60 - 64,DIVORCED,369,228,141,0,234,145,89,0,135,83,52,0
BAHAWALPUR,DISTRICT,60 - 64,MARRIED,73489,29987,43502,0,44931,18939,25992,0,28558,11048,17510,0
BAHAWALPUR,DISTRICT,60 - 64,NEVER MARRIED,936,366,564,6,506,187,318,1,430,179,246,5
BAHAWALPUR,DISTRICT,60 - 64,SEPERATION,201,110,91,0,135,66,69,0,66,44,22,0
BAHAWALPUR,DISTRICT,60 - 64,WIDOWED,13807,10534,3273,0,8071,6103,1968,0,5736,4431,1305,0
BAHAWALPUR,DISTRICT,65 - 69,DIVORCED,197,124,73,0,119,76,43,0,78,48,30,0
BAHAWALPUR,DISTRICT,65 - 69,MARRIED,50248,20947,29301,0,31530,13552,17978,0,18718,7395,11323,0
BAHAWALPUR,DISTRICT,65 - 69,NEVER MARRIED,542,212,326,4,288,103,184,1,254,109,142,3
BAHAWALPUR,DISTRICT,65 - 69,SEPERATION,125,69,56,0,82,44,38,0,43,25,18,0
BAHAWALPUR,DISTRICT,65 - 69,WIDOWED,14095,10617,3478,0,8355,6319,2036,0,5740,4298,1442,0
BAHAWALPUR,DISTRICT,70 - 74,DIVORCED,118,69,49,0,73,39,34,0,45,30,15,0
BAHAWALPUR,DISTRICT,70 - 74,MARRIED,31490,10672,20818,0,21308,7490,13818,0,10182,3182,7000,0
BAHAWALPUR,DISTRICT,70 - 74,NEVER MARRIED,289,124,161,4,159,62,94,3,130,62,67,1
BAHAWALPUR,DISTRICT,70 - 74,SEPERATION,81,41,40,0,57,27,30,0,24,14,10,0
BAHAWALPUR,DISTRICT,70 - 74,WIDOWED,13231,9296,3935,0,8489,5985,2504,0,4742,3311,1431,0
BAHAWALPUR,DISTRICT,75 & ABOVE,DIVORCED,93,56,37,0,61,35,26,0,32,21,11,0
BAHAWALPUR,DISTRICT,75 & ABOVE,MARRIED,26727,8243,18484,0,18839,5923,12916,0,7888,2320,5568,0
BAHAWALPUR,DISTRICT,75 & ABOVE,NEVER MARRIED,242,97,143,2,145,58,85,2,97,39,58,0
BAHAWALPUR,DISTRICT,75 & ABOVE,SEPERATION,77,30,47,0,48,17,31,0,29,13,16,0
BAHAWALPUR,DISTRICT,75 & ABOVE,WIDOWED,17990,11640,6350,0,11720,7486,4234,0,6270,4154,2116,0
BHAKKAR,DISTRICT,15 &  ABOVE,DIVORCED,3956,2823,1133,0,3096,2237,859,0,860,586,274,0
BHAKKAR,DISTRICT,15 &  ABOVE,MARRIED,757599,382881,374718,0,622406,314649,307757,0,135193,68232,66961,0
BHAKKAR,DISTRICT,15 &  ABOVE,NEVER MARRIED,340189,141327,198788,74,270770,112245,158492,33,69419,29082,40296,41
BHAKKAR,DISTRICT,15 &  ABOVE,SEPERATION,1893,1080,813,0,1610,933,677,0,283,147,136,0
BHAKKAR,DISTRICT,15 &  ABOVE,WIDOWED,42528,30880,11648,0,33644,24187,9457,0,8884,6693,2191,0
BHAKKAR,DISTRICT,15 - 19,DIVORCED,78,57,21,0,64,47,17,0,14,10,4,0
BHAKKAR,DISTRICT,15 - 19,MARRIED,16072,11549,4523,0,14110,10095,4015,0,1962,1454,508,0
BHAKKAR,DISTRICT,15 - 19,NEVER MARRIED,167434,75936,91486,12,136021,61662,74350,9,31413,14274,17136,3
BHAKKAR,DISTRICT,15 - 19,SEPERATION,57,36,21,0,53,32,21,0,4,4,0,0
BHAKKAR,DISTRICT,15 - 19,WIDOWED,32,12,20,0,29,12,17,0,3,0,3,0
BHAKKAR,DISTRICT,20 - 24,DIVORCED,304,224,80,0,250,180,70,0,54,44,10,0
BHAKKAR,DISTRICT,20 - 24,MARRIED,61193,39595,21598,0,52227,33470,18757,0,8966,6125,2841,0
BHAKKAR,DISTRICT,20 - 24,NEVER MARRIED,95707,37354,58344,9,75140,28807,46330,3,20567,8547,12014,6
BHAKKAR,DISTRICT,20 - 24,SEPERATION,122,73,49,0,106,67,39,0,16,6,10,0
BHAKKAR,DISTRICT,20 - 24,WIDOWED,138,67,71,0,119,54,65,0,19,13,6,0
BHAKKAR,DISTRICT,25 - 29,DIVORCED,482,335,147,0,378,263,115,0,104,72,32,0
BHAKKAR,DISTRICT,25 - 29,MARRIED,99823,57206,42617,0,82547,46773,35774,0,17276,10433,6843,0
BHAKKAR,DISTRICT,25 - 29,NEVER MARRIED,42511,14577,27921,13,32332,10864,21460,8,10179,3713,6461,5
BHAKKAR,DISTRICT,25 - 29,SEPERATION,187,102,85,0,155,86,69,0,32,16,16,0
BHAKKAR,DISTRICT,25 - 29,WIDOWED,394,216,178,0,329,178,151,0,65,38,27,0
BHAKKAR,DISTRICT,30 - 34,DIVORCED,533,375,158,0,404,285,119,0,129,90,39,0
BHAKKAR,DISTRICT,30 - 34,MARRIED,111770,58909,52861,0,91015,47932,43083,0,20755,10977,9778,0
BHAKKAR,DISTRICT,30 - 34,NEVER MARRIED,16061,5412,10644,5,12445,4268,8175,2,3616,1144,2469,3
BHAKKAR,DISTRICT,30 - 34,SEPERATION,220,132,88,0,186,109,77,0,34,23,11,0
BHAKKAR,DISTRICT,30 - 34,WIDOWED,746,473,273,0,588,366,222,0,158,107,51,0
BHAKKAR,DISTRICT,35 - 39,DIVORCED,560,378,182,0,421,290,131,0,139,88,51,0
BHAKKAR,DISTRICT,35 - 39,MARRIED,99143,49928,49215,0,80155,40443,39712,0,18988,9485,9503,0
BHAKKAR,DISTRICT,35 - 39,NEVER MARRIED,6930,2514,4403,13,5414,2013,3398,3,1516,501,1005,10
BHAKKAR,DISTRICT,35 - 39,SEPERATION,245,128,117,0,204,110,94,0,41,18,23,0
BHAKKAR,DISTRICT,35 - 39,WIDOWED,1163,855,308,0,920,666,254,0,243,189,54,0
BHAKKAR,DISTRICT,40 - 44,DIVORCED,544,392,152,0,418,307,111,0,126,85,41,0
BHAKKAR,DISTRICT,40 - 44,MARRIED,98189,48544,49645,0,80293,39795,40498,0,17896,8749,9147,0
BHAKKAR,DISTRICT,40 - 44,NEVER MARRIED,4221,1858,2356,7,3463,1561,1899,3,758,297,457,4
BHAKKAR,DISTRICT,40 - 44,SEPERATION,244,147,97,0,203,124,79,0,41,23,18,0
BHAKKAR,DISTRICT,40 - 44,WIDOWED,2198,1749,449,0,1733,1368,365,0,465,381,84,0
BHAKKAR,DISTRICT,45 - 49,DIVORCED,386,277,109,0,297,221,76,0,89,56,33,0
BHAKKAR,DISTRICT,45 - 49,MARRIED,69698,33503,36195,0,56260,27169,29091,0,13438,6334,7104,0
BHAKKAR,DISTRICT,45 - 49,NEVER MARRIED,2330,1073,1252,5,1883,900,982,1,447,173,270,4
BHAKKAR,DISTRICT,45 - 49,SEPERATION,218,121,97,0,196,115,81,0,22,6,16,0
BHAKKAR,DISTRICT,45 - 49,WIDOWED,2694,2171,523,0,2128,1707,421,0,566,464,102,0
BHAKKAR,DISTRICT,50 - 54,DIVORCED,401,299,102,0,329,247,82,0,72,52,20,0
BHAKKAR,DISTRICT,50 - 54,MARRIED,63178,29321,33857,0,51865,24133,27732,0,11313,5188,6125,0
BHAKKAR,DISTRICT,50 - 54,NEVER MARRIED,1671,826,845,0,1362,698,664,0,309,128,181,0
BHAKKAR,DISTRICT,50 - 54,SEPERATION,180,112,68,0,147,92,55,0,33,20,13,0
BHAKKAR,DISTRICT,50 - 54,WIDOWED,4034,3266,768,0,3160,2542,618,0,874,724,150,0
BHAKKAR,DISTRICT,55 - 59,DIVORCED,257,186,71,0,207,151,56,0,50,35,15,0
BHAKKAR,DISTRICT,55 - 59,MARRIED,50044,20918,29126,0,40827,17084,23743,0,9217,3834,5383,0
BHAKKAR,DISTRICT,55 - 59,NEVER MARRIED,1277,683,588,6,1047,569,474,4,230,114,114,2
BHAKKAR,DISTRICT,55 - 59,SEPERATION,156,91,65,0,128,75,53,0,28,16,12,0
BHAKKAR,DISTRICT,55 - 59,WIDOWED,4855,3700,1155,0,3753,2818,935,0,1102,882,220,0
BHAKKAR,DISTRICT,60 - 64,DIVORCED,205,147,58,0,162,121,41,0,43,26,17,0
BHAKKAR,DISTRICT,60 - 64,MARRIED,35369,14302,21067,0,28585,11649,16936,0,6784,2653,4131,0
BHAKKAR,DISTRICT,60 - 64,NEVER MARRIED,905,502,400,3,719,413,306,0,186,89,94,3
BHAKKAR,DISTRICT,60 - 64,SEPERATION,115,68,47,0,96,59,37,0,19,9,10,0
BHAKKAR,DISTRICT,60 - 64,WIDOWED,5646,4179,1467,0,4306,3185,1121,0,1340,994,346,0
BHAKKAR,DISTRICT,65 - 69,DIVORCED,93,73,20,0,75,60,15,0,18,13,5,0
BHAKKAR,DISTRICT,65 - 69,MARRIED,23913,9637,14276,0,19619,7929,11690,0,4294,1708,2586,0
BHAKKAR,DISTRICT,65 - 69,NEVER MARRIED,559,316,243,0,456,257,199,0,103,59,44,0
BHAKKAR,DISTRICT,65 - 69,SEPERATION,73,38,35,0,65,33,32,0,8,5,3,0
BHAKKAR,DISTRICT,65 - 69,WIDOWED,5834,4323,1511,0,4497,3308,1189,0,1337,1015,322,0
BHAKKAR,DISTRICT,70 - 74,DIVORCED,72,52,20,0,60,44,16,0,12,8,4,0
BHAKKAR,DISTRICT,70 - 74,MARRIED,15898,5390,10508,0,13455,4661,8794,0,2443,729,1714,0
BHAKKAR,DISTRICT,70 - 74,NEVER MARRIED,351,179,171,1,286,149,137,0,65,30,34,1
BHAKKAR,DISTRICT,70 - 74,SEPERATION,46,21,25,0,41,20,21,0,5,1,4,0
BHAKKAR,DISTRICT,70 - 74,WIDOWED,5952,4159,1793,0,4779,3326,1453,0,1173,833,340,0
BHAKKAR,DISTRICT,75 & ABOVE,DIVORCED,41,28,13,0,31,21,10,0,10,7,3,0
BHAKKAR,DISTRICT,75 & ABOVE,MARRIED,13309,4079,9230,0,11448,3516,7932,0,1861,563,1298,0
BHAKKAR,DISTRICT,75 & ABOVE,NEVER MARRIED,232,97,135,0,202,84,118,0,30,13,17,0
BHAKKAR,DISTRICT,75 & ABOVE,SEPERATION,30,11,19,0,30,11,19,0,0,0,0,0
BHAKKAR,DISTRICT,75 & ABOVE,WIDOWED,8842,5710,3132,0,7303,4657,2646,0,1539,1053,486,0
CHAKWAL,DISTRICT,15 &  ABOVE,DIVORCED,9917,7675,2242,0,7952,6190,1762,0,1965,1485,480,0
CHAKWAL,DISTRICT,15 &  ABOVE,MARRIED,740494,379687,360807,0,561022,288628,272394,0,179472,91059,88413,0
CHAKWAL,DISTRICT,15 &  ABOVE,NEVER MARRIED,337740,143577,194079,84,250887,107004,143868,15,86853,36573,50211,69
CHAKWAL,DISTRICT,15 &  ABOVE,SEPERATION,2419,1220,1199,0,1968,974,994,0,451,246,205,0
CHAKWAL,DISTRICT,15 &  ABOVE,WIDOWED,69423,54103,15320,0,55004,42825,12179,0,14419,11278,3141,0
CHAKWAL,DISTRICT,15 - 19,DIVORCED,55,48,7,0,46,41,5,0,9,7,2,0
CHAKWAL,DISTRICT,15 - 19,MARRIED,7142,5430,1712,0,5274,4037,1237,0,1868,1393,475,0
CHAKWAL,DISTRICT,15 - 19,NEVER MARRIED,144382,66384,77984,14,105381,49015,56363,3,39001,17369,21621,11
CHAKWAL,DISTRICT,15 - 19,SEPERATION,17,14,3,0,13,11,2,0,4,3,1,0
CHAKWAL,DISTRICT,15 - 19,WIDOWED,14,12,2,0,10,9,1,0,4,3,1,0
CHAKWAL,DISTRICT,20 - 24,DIVORCED,426,365,61,0,319,273,46,0,107,92,15,0
CHAKWAL,DISTRICT,20 - 24,MARRIED,37680,27179,10501,0,28116,20451,7665,0,9564,6728,2836,0
CHAKWAL,DISTRICT,20 - 24,NEVER MARRIED,96759,40435,56312,12,71819,29960,41858,1,24940,10475,14454,11
CHAKWAL,DISTRICT,20 - 24,SEPERATION,93,53,40,0,71,40,31,0,22,13,9,0
CHAKWAL,DISTRICT,20 - 24,WIDOWED,102,77,25,0,73,61,12,0,29,16,13,0
CHAKWAL,DISTRICT,25 - 29,DIVORCED,911,719,192,0,706,564,142,0,205,155,50,0
CHAKWAL,DISTRICT,25 - 29,MARRIED,78288,49195,29093,0,58777,37199,21578,0,19511,11996,7515,0
CHAKWAL,DISTRICT,25 - 29,NEVER MARRIED,49143,17779,31348,16,37059,13262,23793,4,12084,4517,7555,12
CHAKWAL,DISTRICT,25 - 29,SEPERATION,214,97,117,0,165,74,91,0,49,23,26,0
CHAKWAL,DISTRICT,25 - 29,WIDOWED,345,238,107,0,256,170,86,0,89,68,21,0
CHAKWAL,DISTRICT,30 - 34,DIVORCED,1325,1009,316,0,1057,803,254,0,268,206,62,0
CHAKWAL,DISTRICT,30 - 34,MARRIED,102030,57686,44344,0,76878,43601,33277,0,25152,14085,11067,0
CHAKWAL,DISTRICT,30 - 34,NEVER MARRIED,20559,6808,13743,8,15694,5153,10541,0,4865,1655,3202,8
CHAKWAL,DISTRICT,30 - 34,SEPERATION,268,134,134,0,210,103,107,0,58,31,27,0
CHAKWAL,DISTRICT,30 - 34,WIDOWED,766,564,202,0,596,434,162,0,170,130,40,0
CHAKWAL,DISTRICT,35 - 39,DIVORCED,1546,1169,377,0,1200,912,288,0,346,257,89,0
CHAKWAL,DISTRICT,35 - 39,MARRIED,107094,56394,50700,0,80118,42284,37834,0,26976,14110,12866,0
CHAKWAL,DISTRICT,35 - 39,NEVER MARRIED,10080,3630,6440,10,7681,2784,4893,4,2399,846,1547,6
CHAKWAL,DISTRICT,35 - 39,SEPERATION,371,190,181,0,288,142,146,0,83,48,35,0
CHAKWAL,DISTRICT,35 - 39,WIDOWED,1488,1198,290,0,1106,886,220,0,382,312,70,0
CHAKWAL,DISTRICT,40 - 44,DIVORCED,1450,1153,297,0,1161,930,231,0,289,223,66,0
CHAKWAL,DISTRICT,40 - 44,MARRIED,96882,48894,47988,0,72786,36773,36013,0,24096,12121,11975,0
CHAKWAL,DISTRICT,40 - 44,NEVER MARRIED,5395,2386,3003,6,4167,1868,2299,0,1228,518,704,6
CHAKWAL,DISTRICT,40 - 44,SEPERATION,320,157,163,0,268,130,138,0,52,27,25,0
CHAKWAL,DISTRICT,40 - 44,WIDOWED,2724,2274,450,0,2111,1758,353,0,613,516,97,0
CHAKWAL,DISTRICT,45 - 49,DIVORCED,1107,854,253,0,863,668,195,0,244,186,58,0
CHAKWAL,DISTRICT,45 - 49,MARRIED,76398,36583,39815,0,57124,27525,29599,0,19274,9058,10216,0
CHAKWAL,DISTRICT,45 - 49,NEVER MARRIED,3400,1566,1829,5,2640,1245,1394,1,760,321,435,4
CHAKWAL,DISTRICT,45 - 49,SEPERATION,281,142,139,0,238,119,119,0,43,23,20,0
CHAKWAL,DISTRICT,45 - 49,WIDOWED,3511,3019,492,0,2637,2258,379,0,874,761,113,0
CHAKWAL,DISTRICT,50 - 54,DIVORCED,896,712,184,0,737,594,143,0,159,118,41,0
CHAKWAL,DISTRICT,50 - 54,MARRIED,64177,30285,33892,0,48596,23159,25437,0,15581,7126,8455,0
CHAKWAL,DISTRICT,50 - 54,NEVER MARRIED,2343,1292,1047,4,1873,1062,811,0,470,230,236,4
CHAKWAL,DISTRICT,50 - 54,SEPERATION,216,110,106,0,176,82,94,0,40,28,12,0
CHAKWAL,DISTRICT,50 - 54,WIDOWED,5675,4821,854,0,4296,3619,677,0,1379,1202,177,0
CHAKWAL,DISTRICT,55 - 59,DIVORCED,760,594,166,0,631,495,136,0,129,99,30,0
CHAKWAL,DISTRICT,55 - 59,MARRIED,55216,24697,30519,0,42680,19218,23462,0,12536,5479,7057,0
CHAKWAL,DISTRICT,55 - 59,NEVER MARRIED,1946,1096,847,3,1548,869,678,1,398,227,169,2
CHAKWAL,DISTRICT,55 - 59,SEPERATION,194,106,88,0,162,89,73,0,32,17,15,0
CHAKWAL,DISTRICT,55 - 59,WIDOWED,7355,6153,1202,0,5741,4781,960,0,1614,1372,242,0
CHAKWAL,DISTRICT,60 - 64,DIVORCED,580,427,153,0,497,374,123,0,83,53,30,0
CHAKWAL,DISTRICT,60 - 64,MARRIED,43546,17876,25670,0,33658,13914,19744,0,9888,3962,5926,0
CHAKWAL,DISTRICT,60 - 64,NEVER MARRIED,1406,841,562,3,1157,694,463,0,249,147,99,3
CHAKWAL,DISTRICT,60 - 64,SEPERATION,179,87,92,0,150,71,79,0,29,16,13,0
CHAKWAL,DISTRICT,60 - 64,WIDOWED,8818,7151,1667,0,6846,5540,1306,0,1972,1611,361,0
CHAKWAL,DISTRICT,65 - 69,DIVORCED,436,325,111,0,362,271,91,0,74,54,20,0
CHAKWAL,DISTRICT,65 - 69,MARRIED,32020,12951,19069,0,24991,10258,14733,0,7029,2693,4336,0
CHAKWAL,DISTRICT,65 - 69,NEVER MARRIED,1056,652,403,1,853,531,321,1,203,121,82,0
CHAKWAL,DISTRICT,65 - 69,SEPERATION,119,73,46,0,101,62,39,0,18,11,7,0
CHAKWAL,DISTRICT,65 - 69,WIDOWED,10387,8254,2133,0,8214,6544,1670,0,2173,1710,463,0
CHAKWAL,DISTRICT,70 - 74,DIVORCED,232,162,70,0,206,146,60,0,26,16,10,0
CHAKWAL,DISTRICT,70 - 74,MARRIED,20645,6756,13889,0,16281,5458,10823,0,4364,1298,3066,0
CHAKWAL,DISTRICT,70 - 74,NEVER MARRIED,626,349,276,1,505,279,226,0,121,70,50,1
CHAKWAL,DISTRICT,70 - 74,SEPERATION,79,34,45,0,72,33,39,0,7,1,6,0
CHAKWAL,DISTRICT,70 - 74,WIDOWED,10230,7637,2593,0,8287,6231,2056,0,1943,1406,537,0
CHAKWAL,DISTRICT,75 & ABOVE,DIVORCED,193,138,55,0,167,119,48,0,26,19,7,0
CHAKWAL,DISTRICT,75 & ABOVE,MARRIED,19376,5761,13615,0,15743,4751,10992,0,3633,1010,2623,0
CHAKWAL,DISTRICT,75 & ABOVE,NEVER MARRIED,645,359,285,1,510,282,228,0,135,77,57,1
CHAKWAL,DISTRICT,75 & ABOVE,SEPERATION,68,23,45,0,54,18,36,0,14,5,9,0
CHAKWAL,DISTRICT,75 & ABOVE,WIDOWED,18008,12705,5303,0,14831,10534,4297,0,3177,2171,1006,0
CHINIOT,DISTRICT,15 &  ABOVE,DIVORCED,9951,6792,3159,0,7446,5159,2287,0,2505,1633,872,0
CHINIOT,DISTRICT,15 &  ABOVE,MARRIED,627064,315244,311820,0,428773,215344,213429,0,198291,99900,98391,0
CHINIOT,DISTRICT,15 &  ABOVE,NEVER MARRIED,263771,110292,153313,166,169660,70323,99289,48,94111,39969,54024,118
CHINIOT,DISTRICT,15 &  ABOVE,SEPERATION,4742,2478,2264,0,3820,1991,1829,0,922,487,435,0
CHINIOT,DISTRICT,15 &  ABOVE,WIDOWED,54274,38221,16053,0,37976,26423,11553,0,16298,11798,4500,0
CHINIOT,DISTRICT,15 - 19,DIVORCED,270,207,63,0,214,163,51,0,56,44,12,0
CHINIOT,DISTRICT,15 - 19,MARRIED,19320,13629,5691,0,15615,10874,4741,0,3705,2755,950,0
CHINIOT,DISTRICT,15 - 19,NEVER MARRIED,135137,62435,72677,25,87794,39865,47919,10,47343,22570,24758,15
CHINIOT,DISTRICT,15 - 19,SEPERATION,161,103,58,0,136,85,51,0,25,18,7,0
CHINIOT,DISTRICT,15 - 19,WIDOWED,71,39,32,0,52,31,21,0,19,8,11,0
CHINIOT,DISTRICT,20 - 24,DIVORCED,727,515,212,0,543,381,162,0,184,134,50,0
CHINIOT,DISTRICT,20 - 24,MARRIED,56923,36620,20303,0,41701,26101,15600,0,15222,10519,4703,0
CHINIOT,DISTRICT,20 - 24,NEVER MARRIED,68394,26001,42368,25,41515,15308,26200,7,26879,10693,16168,18
CHINIOT,DISTRICT,20 - 24,SEPERATION,384,230,154,0,325,193,132,0,59,37,22,0
CHINIOT,DISTRICT,20 - 24,WIDOWED,285,157,128,0,226,124,102,0,59,33,26,0
CHINIOT,DISTRICT,25 - 29,DIVORCED,1137,768,369,0,811,541,270,0,326,227,99,0
CHINIOT,DISTRICT,25 - 29,MARRIED,82460,47367,35093,0,56193,31741,24452,0,26267,15626,10641,0
CHINIOT,DISTRICT,25 - 29,NEVER MARRIED,30220,10129,20055,36,18761,6330,12421,10,11459,3799,7634,26
CHINIOT,DISTRICT,25 - 29,SEPERATION,483,241,242,0,373,190,183,0,110,51,59,0
CHINIOT,DISTRICT,25 - 29,WIDOWED,680,398,282,0,505,299,206,0,175,99,76,0
CHINIOT,DISTRICT,30 - 34,DIVORCED,1345,944,401,0,953,679,274,0,392,265,127,0
CHINIOT,DISTRICT,30 - 34,MARRIED,89034,46826,42208,0,58841,30920,27921,0,30193,15906,14287,0
CHINIOT,DISTRICT,30 - 34,NEVER MARRIED,12106,4978,7104,24,7994,3421,4569,4,4112,1557,2535,20
CHINIOT,DISTRICT,30 - 34,SEPERATION,593,322,271,0,464,257,207,0,129,65,64,0
CHINIOT,DISTRICT,30 - 34,WIDOWED,1106,770,336,0,801,553,248,0,305,217,88,0
CHINIOT,DISTRICT,35 - 39,DIVORCED,1268,857,411,0,921,636,285,0,347,221,126,0
CHINIOT,DISTRICT,35 - 39,MARRIED,83378,41858,41520,0,54203,27297,26906,0,29175,14561,14614,0
CHINIOT,DISTRICT,35 - 39,NEVER MARRIED,6000,1890,4087,23,4167,1368,2795,4,1833,522,1292,19
CHINIOT,DISTRICT,35 - 39,SEPERATION,574,294,280,0,448,224,224,0,126,70,56,0
CHINIOT,DISTRICT,35 - 39,WIDOWED,1817,1313,504,0,1292,928,364,0,525,385,140,0
CHINIOT,DISTRICT,40 - 44,DIVORCED,1238,854,384,0,910,643,267,0,328,211,117,0
CHINIOT,DISTRICT,40 - 44,MARRIED,75770,36495,39275,0,50856,24708,26148,0,24914,11787,13127,0
CHINIOT,DISTRICT,40 - 44,NEVER MARRIED,3541,1274,2258,9,2614,997,1615,2,927,277,643,7
CHINIOT,DISTRICT,40 - 44,SEPERATION,572,303,269,0,452,239,213,0,120,64,56,0
CHINIOT,DISTRICT,40 - 44,WIDOWED,2961,2274,687,0,2076,1567,509,0,885,707,178,0
CHINIOT,DISTRICT,45 - 49,DIVORCED,1105,762,343,0,843,591,252,0,262,171,91,0
CHINIOT,DISTRICT,45 - 49,MARRIED,57919,27003,30916,0,38658,18225,20433,0,19261,8778,10483,0
CHINIOT,DISTRICT,45 - 49,NEVER MARRIED,2468,1007,1455,6,1922,830,1090,2,546,177,365,4
CHINIOT,DISTRICT,45 - 49,SEPERATION,477,240,237,0,385,198,187,0,92,42,50,0
CHINIOT,DISTRICT,45 - 49,WIDOWED,3748,2932,816,0,2548,1967,581,0,1200,965,235,0
CHINIOT,DISTRICT,50 - 54,DIVORCED,919,639,280,0,711,497,214,0,208,142,66,0
CHINIOT,DISTRICT,50 - 54,MARRIED,49093,22102,26991,0,33361,15046,18315,0,15732,7056,8676,0
CHINIOT,DISTRICT,50 - 54,NEVER MARRIED,1758,769,984,5,1378,641,733,4,380,128,251,1
CHINIOT,DISTRICT,50 - 54,SEPERATION,441,235,206,0,359,184,175,0,82,51,31,0
CHINIOT,DISTRICT,50 - 54,WIDOWED,5529,4224,1305,0,3752,2818,934,0,1777,1406,371,0
CHINIOT,DISTRICT,55 - 59,DIVORCED,699,465,234,0,542,374,168,0,157,91,66,0
CHINIOT,DISTRICT,55 - 59,MARRIED,38731,15948,22783,0,26325,10765,15560,0,12406,5183,7223,0
CHINIOT,DISTRICT,55 - 59,NEVER MARRIED,1302,582,716,4,1077,492,582,3,225,90,134,1
CHINIOT,DISTRICT,55 - 59,SEPERATION,364,181,183,0,299,147,152,0,65,34,31,0
CHINIOT,DISTRICT,55 - 59,WIDOWED,6310,4697,1613,0,4238,3064,1174,0,2072,1633,439,0
CHINIOT,DISTRICT,60 - 64,DIVORCED,537,349,188,0,419,283,136,0,118,66,52,0
CHINIOT,DISTRICT,60 - 64,MARRIED,29667,12075,17592,0,20597,8489,12108,0,9070,3586,5484,0
CHINIOT,DISTRICT,60 - 64,NEVER MARRIED,1111,487,621,3,916,417,499,0,195,70,122,3
CHINIOT,DISTRICT,60 - 64,SEPERATION,286,158,128,0,243,133,110,0,43,25,18,0
CHINIOT,DISTRICT,60 - 64,WIDOWED,7440,5438,2002,0,5094,3682,1412,0,2346,1756,590,0
CHINIOT,DISTRICT,65 - 69,DIVORCED,351,224,127,0,280,185,95,0,71,39,32,0
CHINIOT,DISTRICT,65 - 69,MARRIED,19913,7725,12188,0,13942,5430,8512,0,5971,2295,3676,0
CHINIOT,DISTRICT,65 - 69,NEVER MARRIED,709,308,399,2,625,270,355,0,84,38,44,2
CHINIOT,DISTRICT,65 - 69,SEPERATION,192,91,101,0,153,69,84,0,39,22,17,0
CHINIOT,DISTRICT,65 - 69,WIDOWED,7067,4998,2069,0,4816,3388,1428,0,2251,1610,641,0
CHINIOT,DISTRICT,70 - 74,DIVORCED,190,107,83,0,167,98,69,0,23,9,14,0
CHINIOT,DISTRICT,70 - 74,MARRIED,13068,4119,8949,0,9530,3073,6457,0,3538,1046,2492,0
CHINIOT,DISTRICT,70 - 74,NEVER MARRIED,510,218,289,3,445,188,255,2,65,30,34,1
CHINIOT,DISTRICT,70 - 74,SEPERATION,108,46,62,0,94,43,51,0,14,3,11,0
CHINIOT,DISTRICT,70 - 74,WIDOWED,6822,4516,2306,0,4926,3257,1669,0,1896,1259,637,0
CHINIOT,DISTRICT,75 & ABOVE,DIVORCED,165,101,64,0,132,88,44,0,33,13,20,0
CHINIOT,DISTRICT,75 & ABOVE,MARRIED,11788,3477,8311,0,8951,2675,6276,0,2837,802,2035,0
CHINIOT,DISTRICT,75 & ABOVE,NEVER MARRIED,515,214,300,1,452,196,256,0,63,18,44,1
CHINIOT,DISTRICT,75 & ABOVE,SEPERATION,107,34,73,0,89,29,60,0,18,5,13,0
CHINIOT,DISTRICT,75 & ABOVE,WIDOWED,10438,6465,3973,0,7650,4745,2905,0,2788,1720,1068,0
DERA GHAZI KHAN,DISTRICT,15 &  ABOVE,DIVORCED,2792,2168,624,0,1755,1397,358,0,1037,771,266,0
DERA GHAZI KHAN,DISTRICT,15 &  ABOVE,MARRIED,1300268,673133,627135,0,984113,511532,472581,0,316155,161601,154554,0
DERA GHAZI KHAN,DISTRICT,15 &  ABOVE,NEVER MARRIED,448282,177289,270876,117,311755,120695,191027,33,136527,56594,79849,84
DERA GHAZI KHAN,DISTRICT,15 &  ABOVE,SEPERATION,1650,907,743,0,1210,665,545,0,440,242,198,0
DERA GHAZI KHAN,DISTRICT,15 &  ABOVE,WIDOWED,50764,40452,10312,0,36030,28752,7278,0,14734,11700,3034,0
DERA GHAZI KHAN,DISTRICT,15 - 19,DIVORCED,77,69,8,0,59,53,6,0,18,16,2,0
DERA GHAZI KHAN,DISTRICT,15 - 19,MARRIED,52677,37465,15212,0,43969,31036,12933,0,8708,6429,2279,0
DERA GHAZI KHAN,DISTRICT,15 - 19,NEVER MARRIED,269501,120975,148509,17,197749,88039,109703,7,71752,32936,38806,10
DERA GHAZI KHAN,DISTRICT,15 - 19,SEPERATION,83,39,44,0,66,31,35,0,17,8,9,0
DERA GHAZI KHAN,DISTRICT,15 - 19,WIDOWED,95,61,34,0,82,53,29,0,13,8,5,0
DERA GHAZI KHAN,DISTRICT,20 - 24,DIVORCED,292,239,53,0,212,172,40,0,80,67,13,0
DERA GHAZI KHAN,DISTRICT,20 - 24,MARRIED,159920,100866,59054,0,129049,80455,48594,0,30871,20411,10460,0
DERA GHAZI KHAN,DISTRICT,20 - 24,NEVER MARRIED,113109,36193,76877,39,74984,21929,53049,6,38125,14264,23828,33
DERA GHAZI KHAN,DISTRICT,20 - 24,SEPERATION,135,79,56,0,108,60,48,0,27,19,8,0
DERA GHAZI KHAN,DISTRICT,20 - 24,WIDOWED,396,267,129,0,311,213,98,0,85,54,31,0
DERA GHAZI KHAN,DISTRICT,25 - 29,DIVORCED,404,320,84,0,261,209,52,0,143,111,32,0
DERA GHAZI KHAN,DISTRICT,25 - 29,MARRIED,185486,103099,82387,0,142754,78472,64282,0,42732,24627,18105,0
DERA GHAZI KHAN,DISTRICT,25 - 29,NEVER MARRIED,40597,12126,28447,24,24759,6614,18140,5,15838,5512,10307,19
DERA GHAZI KHAN,DISTRICT,25 - 29,SEPERATION,185,108,77,0,140,83,57,0,45,25,20,0
DERA GHAZI KHAN,DISTRICT,25 - 29,WIDOWED,740,502,238,0,565,368,197,0,175,134,41,0
DERA GHAZI KHAN,DISTRICT,30 - 34,DIVORCED,431,339,92,0,241,194,47,0,190,145,45,0
DERA GHAZI KHAN,DISTRICT,30 - 34,MARRIED,176944,93617,83327,0,132060,69545,62515,0,44884,24072,20812,0
DERA GHAZI KHAN,DISTRICT,30 - 34,NEVER MARRIED,13128,4171,8947,10,7629,2157,5469,3,5499,2014,3478,7
DERA GHAZI KHAN,DISTRICT,30 - 34,SEPERATION,195,120,75,0,129,85,44,0,66,35,31,0
DERA GHAZI KHAN,DISTRICT,30 - 34,WIDOWED,1105,838,267,0,823,635,188,0,282,203,79,0
DERA GHAZI KHAN,DISTRICT,35 - 39,DIVORCED,413,319,94,0,249,202,47,0,164,117,47,0
DERA GHAZI KHAN,DISTRICT,35 - 39,MARRIED,165630,83880,81750,0,121520,61823,59697,0,44110,22057,22053,0
DERA GHAZI KHAN,DISTRICT,35 - 39,NEVER MARRIED,5664,1667,3989,8,3189,859,2327,3,2475,808,1662,5
DERA GHAZI KHAN,DISTRICT,35 - 39,SEPERATION,194,98,96,0,126,63,63,0,68,35,33,0
DERA GHAZI KHAN,DISTRICT,35 - 39,WIDOWED,1704,1325,379,0,1222,951,271,0,482,374,108,0
DERA GHAZI KHAN,DISTRICT,40 - 44,DIVORCED,372,300,72,0,228,195,33,0,144,105,39,0
DERA GHAZI KHAN,DISTRICT,40 - 44,MARRIED,151606,74490,77116,0,112157,55408,56749,0,39449,19082,20367,0
DERA GHAZI KHAN,DISTRICT,40 - 44,NEVER MARRIED,2759,898,1852,9,1558,466,1088,4,1201,432,764,5
DERA GHAZI KHAN,DISTRICT,40 - 44,SEPERATION,200,123,77,0,144,94,50,0,56,29,27,0
DERA GHAZI KHAN,DISTRICT,40 - 44,WIDOWED,2758,2344,414,0,1933,1648,285,0,825,696,129,0
DERA GHAZI KHAN,DISTRICT,45 - 49,DIVORCED,249,180,69,0,148,105,43,0,101,75,26,0
DERA GHAZI KHAN,DISTRICT,45 - 49,MARRIED,109464,52017,57447,0,79726,38367,41359,0,29738,13650,16088,0
DERA GHAZI KHAN,DISTRICT,45 - 49,NEVER MARRIED,1431,475,956,0,754,241,513,0,677,234,443,0
DERA GHAZI KHAN,DISTRICT,45 - 49,SEPERATION,148,90,58,0,105,63,42,0,43,27,16,0
DERA GHAZI KHAN,DISTRICT,45 - 49,WIDOWED,3396,2899,497,0,2316,1955,361,0,1080,944,136,0
DERA GHAZI KHAN,DISTRICT,50 - 54,DIVORCED,197,160,37,0,126,113,13,0,71,47,24,0
DERA GHAZI KHAN,DISTRICT,50 - 54,MARRIED,89251,42450,46801,0,65550,31682,33868,0,23701,10768,12933,0
DERA GHAZI KHAN,DISTRICT,50 - 54,NEVER MARRIED,846,305,537,4,434,145,288,1,412,160,249,3
DERA GHAZI KHAN,DISTRICT,50 - 54,SEPERATION,129,81,48,0,85,58,27,0,44,23,21,0
DERA GHAZI KHAN,DISTRICT,50 - 54,WIDOWED,4752,4103,649,0,3265,2848,417,0,1487,1255,232,0
DERA GHAZI KHAN,DISTRICT,55 - 59,DIVORCED,112,83,29,0,64,47,17,0,48,36,12,0
DERA GHAZI KHAN,DISTRICT,55 - 59,MARRIED,69288,29721,39567,0,50925,22059,28866,0,18363,7662,10701,0
DERA GHAZI KHAN,DISTRICT,55 - 59,NEVER MARRIED,488,175,311,2,265,85,179,1,223,90,132,1
DERA GHAZI KHAN,DISTRICT,55 - 59,SEPERATION,100,47,53,0,75,36,39,0,25,11,14,0
DERA GHAZI KHAN,DISTRICT,55 - 59,WIDOWED,5080,4231,849,0,3360,2802,558,0,1720,1429,291,0
DERA GHAZI KHAN,DISTRICT,60 - 64,DIVORCED,97,64,33,0,59,36,23,0,38,28,10,0
DERA GHAZI KHAN,DISTRICT,60 - 64,MARRIED,52443,22160,30283,0,38745,16629,22116,0,13698,5531,8167,0
DERA GHAZI KHAN,DISTRICT,60 - 64,NEVER MARRIED,318,133,183,2,164,63,99,2,154,70,84,0
DERA GHAZI KHAN,DISTRICT,60 - 64,SEPERATION,95,54,41,0,71,40,31,0,24,14,10,0
DERA GHAZI KHAN,DISTRICT,60 - 64,WIDOWED,6245,5109,1136,0,4262,3491,771,0,1983,1618,365,0
DERA GHAZI KHAN,DISTRICT,65 - 69,DIVORCED,64,44,20,0,44,33,11,0,20,11,9,0
DERA GHAZI KHAN,DISTRICT,65 - 69,MARRIED,37403,16404,20999,0,27986,12484,15502,0,9417,3920,5497,0
DERA GHAZI KHAN,DISTRICT,65 - 69,NEVER MARRIED,203,90,113,0,116,55,61,0,87,35,52,0
DERA GHAZI KHAN,DISTRICT,65 - 69,SEPERATION,71,38,33,0,57,27,30,0,14,11,3,0
DERA GHAZI KHAN,DISTRICT,65 - 69,WIDOWED,6695,5524,1171,0,4561,3788,773,0,2134,1736,398,0
DERA GHAZI KHAN,DISTRICT,70 - 74,DIVORCED,45,25,20,0,35,19,16,0,10,6,4,0
DERA GHAZI KHAN,DISTRICT,70 - 74,MARRIED,25994,9350,16644,0,20236,7435,12801,0,5758,1915,3843,0
DERA GHAZI KHAN,DISTRICT,70 - 74,NEVER MARRIED,139,50,88,1,91,29,62,0,48,21,26,1
DERA GHAZI KHAN,DISTRICT,70 - 74,SEPERATION,51,13,38,0,46,11,35,0,5,2,3,0
DERA GHAZI KHAN,DISTRICT,70 - 74,WIDOWED,6814,5303,1511,0,4909,3857,1052,0,1905,1446,459,0
DERA GHAZI KHAN,DISTRICT,75 & ABOVE,DIVORCED,39,26,13,0,29,19,10,0,10,7,3,0
DERA GHAZI KHAN,DISTRICT,75 & ABOVE,MARRIED,24162,7614,16548,0,19436,6137,13299,0,4726,1477,3249,0
DERA GHAZI KHAN,DISTRICT,75 & ABOVE,NEVER MARRIED,99,31,67,1,63,13,49,1,36,18,18,0
DERA GHAZI KHAN,DISTRICT,75 & ABOVE,SEPERATION,64,17,47,0,58,14,44,0,6,3,3,0
DERA GHAZI KHAN,DISTRICT,75 & ABOVE,WIDOWED,10984,7946,3038,0,8421,6143,2278,0,2563,1803,760,0
FAISALABAD,DISTRICT,15 &  ABOVE,DIVORCED,30738,18565,12173,0,17380,10339,7041,0,13358,8226,5132,0
FAISALABAD,DISTRICT,15 &  ABOVE,MARRIED,3690452,1837477,1852975,0,1897836,948993,948843,0,1792616,888484,904132,0
FAISALABAD,DISTRICT,15 &  ABOVE,NEVER MARRIED,1855968,748566,1106467,935,891267,355595,535395,277,964701,392971,571072,658
FAISALABAD,DISTRICT,15 &  ABOVE,SEPERATION,11732,5997,5735,0,7489,3897,3592,0,4243,2100,2143,0
FAISALABAD,DISTRICT,15 &  ABOVE,WIDOWED,269515,184068,85447,0,143149,95354,47795,0,126366,88714,37652,0
FAISALABAD,DISTRICT,15 - 19,DIVORCED,515,423,92,0,365,293,72,0,150,130,20,0
FAISALABAD,DISTRICT,15 - 19,MARRIED,47498,34789,12709,0,31494,22881,8613,0,16004,11908,4096,0
FAISALABAD,DISTRICT,15 - 19,NEVER MARRIED,839706,384900,454710,96,426337,194312,231987,38,413369,190588,222723,58
FAISALABAD,DISTRICT,15 - 19,SEPERATION,258,182,76,0,197,142,55,0,61,40,21,0
FAISALABAD,DISTRICT,15 - 19,WIDOWED,187,108,79,0,108,63,45,0,79,45,34,0
FAISALABAD,DISTRICT,20 - 24,DIVORCED,2278,1638,640,0,1374,959,415,0,904,679,225,0
FAISALABAD,DISTRICT,20 - 24,MARRIED,249413,170716,78697,0,141464,95053,46411,0,107949,75663,32286,0
FAISALABAD,DISTRICT,20 - 24,NEVER MARRIED,586105,232253,353702,150,263613,100860,162711,42,322492,131393,190991,108
FAISALABAD,DISTRICT,20 - 24,SEPERATION,766,480,286,0,565,339,226,0,201,141,60,0
FAISALABAD,DISTRICT,20 - 24,WIDOWED,976,571,405,0,587,333,254,0,389,238,151,0
FAISALABAD,DISTRICT,25 - 29,DIVORCED,4160,2613,1547,0,2330,1392,938,0,1830,1221,609,0
FAISALABAD,DISTRICT,25 - 29,MARRIED,480617,280366,200251,0,251389,145227,106162,0,229228,135139,94089,0
FAISALABAD,DISTRICT,25 - 29,NEVER MARRIED,258165,82477,175544,144,117868,36035,81797,36,140297,46442,93747,108
FAISALABAD,DISTRICT,25 - 29,SEPERATION,1384,786,598,0,861,487,374,0,523,299,224,0
FAISALABAD,DISTRICT,25 - 29,WIDOWED,2501,1453,1048,0,1454,824,630,0,1047,629,418,0
FAISALABAD,DISTRICT,30 - 34,DIVORCED,5004,2989,2015,0,2564,1472,1092,0,2440,1517,923,0
FAISALABAD,DISTRICT,30 - 34,MARRIED,560312,294452,265860,0,281059,147464,133595,0,279253,146988,132265,0
FAISALABAD,DISTRICT,30 - 34,NEVER MARRIED,84127,22518,61478,131,38916,10143,28751,22,45211,12375,32727,109
FAISALABAD,DISTRICT,30 - 34,SEPERATION,1531,798,733,0,899,494,405,0,632,304,328,0
FAISALABAD,DISTRICT,30 - 34,WIDOWED,4396,2927,1469,0,2482,1623,859,0,1914,1304,610,0
FAISALABAD,DISTRICT,35 - 39,DIVORCED,4811,2836,1975,0,2490,1463,1027,0,2321,1373,948,0
FAISALABAD,DISTRICT,35 - 39,MARRIED,541678,268297,273381,0,268568,133998,134570,0,273110,134299,138811,0
FAISALABAD,DISTRICT,35 - 39,NEVER MARRIED,36713,9647,26940,126,16949,4502,12413,34,19764,5145,14527,92
FAISALABAD,DISTRICT,35 - 39,SEPERATION,1664,777,887,0,1043,507,536,0,621,270,351,0
FAISALABAD,DISTRICT,35 - 39,WIDOWED,7959,5797,2162,0,4249,3034,1215,0,3710,2763,947,0
FAISALABAD,DISTRICT,40 - 44,DIVORCED,4309,2560,1749,0,2366,1366,1000,0,1943,1194,749,0
FAISALABAD,DISTRICT,40 - 44,MARRIED,489125,232978,256147,0,245228,116718,128510,0,243897,116260,127637,0
FAISALABAD,DISTRICT,40 - 44,NEVER MARRIED,18996,5654,13260,82,9254,2893,6331,30,9742,2761,6929,52
FAISALABAD,DISTRICT,40 - 44,SEPERATION,1534,789,745,0,951,505,446,0,583,284,299,0
FAISALABAD,DISTRICT,40 - 44,WIDOWED,14359,11189,3170,0,7742,5896,1846,0,6617,5293,1324,0
FAISALABAD,DISTRICT,45 - 49,DIVORCED,3090,1792,1298,0,1688,990,698,0,1402,802,600,0
FAISALABAD,DISTRICT,45 - 49,MARRIED,375772,172312,203460,0,184035,85511,98524,0,191737,86801,104936,0
FAISALABAD,DISTRICT,45 - 49,NEVER MARRIED,11288,3454,7766,68,5704,1886,3795,23,5584,1568,3971,45
FAISALABAD,DISTRICT,45 - 49,SEPERATION,1326,696,630,0,807,434,373,0,519,262,257,0
FAISALABAD,DISTRICT,45 - 49,WIDOWED,19781,15524,4257,0,10148,7748,2400,0,9633,7776,1857,0
FAISALABAD,DISTRICT,50 - 54,DIVORCED,2363,1409,954,0,1374,816,558,0,989,593,396,0
FAISALABAD,DISTRICT,50 - 54,MARRIED,300896,134510,166386,0,150508,68232,82276,0,150388,66278,84110,0
FAISALABAD,DISTRICT,50 - 54,NEVER MARRIED,7151,2480,4617,54,3896,1496,2382,18,3255,984,2235,36
FAISALABAD,DISTRICT,50 - 54,SEPERATION,1103,549,554,0,677,338,339,0,426,211,215,0
FAISALABAD,DISTRICT,50 - 54,WIDOWED,28453,21982,6471,0,14455,10930,3525,0,13998,11052,2946,0
FAISALABAD,DISTRICT,55 - 59,DIVORCED,1656,907,749,0,1052,581,471,0,604,326,278,0
FAISALABAD,DISTRICT,55 - 59,MARRIED,238390,99830,138560,0,122128,51157,70971,0,116262,48673,67589,0
FAISALABAD,DISTRICT,55 - 59,NEVER MARRIED,4996,1761,3200,35,2895,1078,1803,14,2101,683,1397,21
FAISALABAD,DISTRICT,55 - 59,SEPERATION,744,333,411,0,476,205,271,0,268,128,140,0
FAISALABAD,DISTRICT,55 - 59,WIDOWED,33618,24461,9157,0,17126,12148,4978,0,16492,12313,4179,0
FAISALABAD,DISTRICT,60 - 64,DIVORCED,1152,626,526,0,764,421,343,0,388,205,183,0
FAISALABAD,DISTRICT,60 - 64,MARRIED,177518,70318,107200,0,92255,37071,55184,0,85263,33247,52016,0
FAISALABAD,DISTRICT,60 - 64,NEVER MARRIED,3660,1417,2220,23,2301,945,1351,5,1359,472,869,18
FAISALABAD,DISTRICT,60 - 64,SEPERATION,626,288,338,0,426,196,230,0,200,92,108,0
FAISALABAD,DISTRICT,60 - 64,WIDOWED,40088,28021,12067,0,20226,13824,6402,0,19862,14197,5665,0
FAISALABAD,DISTRICT,65 - 69,DIVORCED,687,395,292,0,468,292,176,0,219,103,116,0
FAISALABAD,DISTRICT,65 - 69,MARRIED,113187,42826,70361,0,61091,23645,37446,0,52096,19181,32915,0
FAISALABAD,DISTRICT,65 - 69,NEVER MARRIED,2337,955,1370,12,1547,669,874,4,790,286,496,8
FAISALABAD,DISTRICT,65 - 69,SEPERATION,384,168,216,0,282,128,154,0,102,40,62,0
FAISALABAD,DISTRICT,65 - 69,WIDOWED,37826,25295,12531,0,19614,12799,6815,0,18212,12496,5716,0
FAISALABAD,DISTRICT,70 - 74,DIVORCED,393,200,193,0,304,157,147,0,89,43,46,0
FAISALABAD,DISTRICT,70 - 74,MARRIED,61693,19362,42331,0,35226,11570,23656,0,26467,7792,18675,0
FAISALABAD,DISTRICT,70 - 74,NEVER MARRIED,1362,505,850,7,981,366,610,5,381,139,240,2
FAISALABAD,DISTRICT,70 - 74,SEPERATION,218,81,137,0,162,62,100,0,56,19,37,0
FAISALABAD,DISTRICT,70 - 74,WIDOWED,31315,19117,12198,0,17181,10404,6777,0,14134,8713,5421,0
FAISALABAD,DISTRICT,75 & ABOVE,DIVORCED,320,177,143,0,241,137,104,0,79,40,39,0
FAISALABAD,DISTRICT,75 & ABOVE,MARRIED,54353,16721,37632,0,33391,10466,22925,0,20962,6255,14707,0
FAISALABAD,DISTRICT,75 & ABOVE,NEVER MARRIED,1362,545,810,7,1006,410,590,6,356,135,220,1
FAISALABAD,DISTRICT,75 & ABOVE,SEPERATION,194,70,124,0,143,60,83,0,51,10,41,0
FAISALABAD,DISTRICT,75 & ABOVE,WIDOWED,48056,27623,20433,0,27777,15728,12049,0,20279,11895,8384,0
GUJRANWALA,DISTRICT,15 &  ABOVE,DIVORCED,12443,7708,4735,0,4794,2949,1845,0,7649,4759,2890,0
GUJRANWALA,DISTRICT,15 &  ABOVE,MARRIED,2308399,1171333,1137066,0,917123,470144,446979,0,1391276,701189,690087,0
GUJRANWALA,DISTRICT,15 &  ABOVE,NEVER MARRIED,1194627,517867,676242,518,467865,206352,261366,147,726762,311515,414876,371
GUJRANWALA,DISTRICT,15 &  ABOVE,SEPERATION,4190,1950,2240,0,1442,686,756,0,2748,1264,1484,0
GUJRANWALA,DISTRICT,15 &  ABOVE,WIDOWED,140183,92084,48099,0,57069,36251,20818,0,83114,55833,27281,0
GUJRANWALA,DISTRICT,15 - 19,DIVORCED,145,122,23,0,61,51,10,0,84,71,13,0
GUJRANWALA,DISTRICT,15 - 19,MARRIED,20820,14963,5857,0,9108,6588,2520,0,11712,8375,3337,0
GUJRANWALA,DISTRICT,15 - 19,NEVER MARRIED,575258,278949,296237,72,231131,113613,117496,22,344127,165336,178741,50
GUJRANWALA,DISTRICT,15 - 19,SEPERATION,61,40,21,0,23,18,5,0,38,22,16,0
GUJRANWALA,DISTRICT,15 - 19,WIDOWED,87,52,35,0,37,23,14,0,50,29,21,0
GUJRANWALA,DISTRICT,20 - 24,DIVORCED,954,731,223,0,409,303,106,0,545,428,117,0
GUJRANWALA,DISTRICT,20 - 24,MARRIED,150307,105542,44765,0,61415,42937,18478,0,88892,62605,26287,0
GUJRANWALA,DISTRICT,20 - 24,NEVER MARRIED,377890,158483,219310,97,148158,63088,85040,30,229732,95395,134270,67
GUJRANWALA,DISTRICT,20 - 24,SEPERATION,219,128,91,0,81,43,38,0,138,85,53,0
GUJRANWALA,DISTRICT,20 - 24,WIDOWED,511,309,202,0,210,125,85,0,301,184,117,0
GUJRANWALA,DISTRICT,25 - 29,DIVORCED,1888,1274,614,0,770,520,250,0,1118,754,364,0
GUJRANWALA,DISTRICT,25 - 29,MARRIED,309256,186100,123156,0,120635,73146,47489,0,188621,112954,75667,0
GUJRANWALA,DISTRICT,25 - 29,NEVER MARRIED,155198,52508,102574,116,58810,20258,38520,32,96388,32250,64054,84
GUJRANWALA,DISTRICT,25 - 29,SEPERATION,449,257,192,0,168,106,62,0,281,151,130,0
GUJRANWALA,DISTRICT,25 - 29,WIDOWED,1291,802,489,0,544,323,221,0,747,479,268,0
GUJRANWALA,DISTRICT,30 - 34,DIVORCED,2273,1464,809,0,829,534,295,0,1444,930,514,0
GUJRANWALA,DISTRICT,30 - 34,MARRIED,354837,190752,164085,0,138015,74642,63373,0,216822,116110,100712,0
GUJRANWALA,DISTRICT,30 - 34,NEVER MARRIED,47264,16933,30270,61,16704,5788,10906,10,30560,11145,19364,51
GUJRANWALA,DISTRICT,30 - 34,SEPERATION,572,259,313,0,203,96,107,0,369,163,206,0
GUJRANWALA,DISTRICT,30 - 34,WIDOWED,2528,1669,859,0,1017,665,352,0,1511,1004,507,0
GUJRANWALA,DISTRICT,35 - 39,DIVORCED,2047,1222,825,0,730,431,299,0,1317,791,526,0
GUJRANWALA,DISTRICT,35 - 39,MARRIED,339759,171415,168344,0,129086,66004,63082,0,210673,105411,105262,0
GUJRANWALA,DISTRICT,35 - 39,NEVER MARRIED,18261,4917,13287,57,5871,1480,4378,13,12390,3437,8909,44
GUJRANWALA,DISTRICT,35 - 39,SEPERATION,673,300,373,0,202,92,110,0,471,208,263,0
GUJRANWALA,DISTRICT,35 - 39,WIDOWED,4259,2951,1308,0,1670,1133,537,0,2589,1818,771,0
GUJRANWALA,DISTRICT,40 - 44,DIVORCED,1674,1007,667,0,609,363,246,0,1065,644,421,0
GUJRANWALA,DISTRICT,40 - 44,MARRIED,298630,145614,153016,0,117683,58204,59479,0,180947,87410,93537,0
GUJRANWALA,DISTRICT,40 - 44,NEVER MARRIED,8514,2373,6109,32,2753,765,1982,6,5761,1608,4127,26
GUJRANWALA,DISTRICT,40 - 44,SEPERATION,570,268,302,0,199,99,100,0,371,169,202,0
GUJRANWALA,DISTRICT,40 - 44,WIDOWED,7195,5436,1759,0,2802,2087,715,0,4393,3349,1044,0
GUJRANWALA,DISTRICT,45 - 49,DIVORCED,1249,703,546,0,463,252,211,0,786,451,335,0
GUJRANWALA,DISTRICT,45 - 49,MARRIED,237575,110954,126621,0,92387,43960,48427,0,145188,66994,78194,0
GUJRANWALA,DISTRICT,45 - 49,NEVER MARRIED,4869,1379,3467,23,1569,444,1115,10,3300,935,2352,13
GUJRANWALA,DISTRICT,45 - 49,SEPERATION,521,234,287,0,179,81,98,0,342,153,189,0
GUJRANWALA,DISTRICT,45 - 49,WIDOWED,9957,7556,2401,0,3674,2713,961,0,6283,4843,1440,0
GUJRANWALA,DISTRICT,50 - 54,DIVORCED,850,474,376,0,335,177,158,0,515,297,218,0
GUJRANWALA,DISTRICT,50 - 54,MARRIED,188794,85106,103688,0,75680,34823,40857,0,113114,50283,62831,0
GUJRANWALA,DISTRICT,50 - 54,NEVER MARRIED,2762,864,1880,18,1011,331,675,5,1751,533,1205,13
GUJRANWALA,DISTRICT,50 - 54,SEPERATION,372,163,209,0,131,59,72,0,241,104,137,0
GUJRANWALA,DISTRICT,50 - 54,WIDOWED,14387,10747,3640,0,5470,3977,1493,0,8917,6770,2147,0
GUJRANWALA,DISTRICT,55 - 59,DIVORCED,590,323,267,0,249,134,115,0,341,189,152,0
GUJRANWALA,DISTRICT,55 - 59,MARRIED,148667,63982,84685,0,61585,26660,34925,0,87082,37322,49760,0
GUJRANWALA,DISTRICT,55 - 59,NEVER MARRIED,1793,542,1231,20,683,202,471,10,1110,340,760,10
GUJRANWALA,DISTRICT,55 - 59,SEPERATION,273,110,163,0,96,36,60,0,177,74,103,0
GUJRANWALA,DISTRICT,55 - 59,WIDOWED,16651,11893,4758,0,6330,4328,2002,0,10321,7565,2756,0
GUJRANWALA,DISTRICT,60 - 64,DIVORCED,379,199,180,0,166,91,75,0,213,108,105,0
GUJRANWALA,DISTRICT,60 - 64,MARRIED,112311,45270,67041,0,45968,19121,26847,0,66343,26149,40194,0
GUJRANWALA,DISTRICT,60 - 64,NEVER MARRIED,1146,360,774,12,418,148,266,4,728,212,508,8
GUJRANWALA,DISTRICT,60 - 64,SEPERATION,213,86,127,0,65,27,38,0,148,59,89,0
GUJRANWALA,DISTRICT,60 - 64,WIDOWED,20473,13928,6545,0,7638,5002,2636,0,12835,8926,3909,0
GUJRANWALA,DISTRICT,65 - 69,DIVORCED,202,105,97,0,83,49,34,0,119,56,63,0
GUJRANWALA,DISTRICT,65 - 69,MARRIED,72062,27918,44144,0,30268,12164,18104,0,41794,15754,26040,0
GUJRANWALA,DISTRICT,65 - 69,NEVER MARRIED,764,274,484,6,314,112,200,2,450,162,284,4
GUJRANWALA,DISTRICT,65 - 69,SEPERATION,137,63,74,0,51,19,32,0,86,44,42,0
GUJRANWALA,DISTRICT,65 - 69,WIDOWED,19587,12545,7042,0,7563,4752,2811,0,12024,7793,4231,0
GUJRANWALA,DISTRICT,70 - 74,DIVORCED,100,46,54,0,47,27,20,0,53,19,34,0
GUJRANWALA,DISTRICT,70 - 74,MARRIED,38359,12147,26212,0,16994,5929,11065,0,21365,6218,15147,0
GUJRANWALA,DISTRICT,70 - 74,NEVER MARRIED,407,125,281,1,177,46,130,1,230,79,151,0
GUJRANWALA,DISTRICT,70 - 74,SEPERATION,60,23,37,0,17,4,13,0,43,19,24,0
GUJRANWALA,DISTRICT,70 - 74,WIDOWED,16226,9544,6682,0,6933,4072,2861,0,9293,5472,3821,0
GUJRANWALA,DISTRICT,75 & ABOVE,DIVORCED,92,38,54,0,43,17,26,0,49,21,28,0
GUJRANWALA,DISTRICT,75 & ABOVE,MARRIED,37022,11570,25452,0,18299,5966,12333,0,18723,5604,13119,0
GUJRANWALA,DISTRICT,75 & ABOVE,NEVER MARRIED,501,160,338,3,266,77,187,2,235,83,151,1
GUJRANWALA,DISTRICT,75 & ABOVE,SEPERATION,70,19,51,0,27,6,21,0,43,13,30,0
GUJRANWALA,DISTRICT,75 & ABOVE,WIDOWED,27031,14652,12379,0,13181,7051,6130,0,13850,7601,6249,0
GUJRAT,DISTRICT,15 &  ABOVE,DIVORCED,14412,9433,4979,0,9326,6075,3251,0,5086,3358,1728,0
GUJRAT,DISTRICT,15 &  ABOVE,MARRIED,1370053,697357,672696,0,804076,417490,386586,0,565977,279867,286110,0
GUJRAT,DISTRICT,15 &  ABOVE,NEVER MARRIED,651117,286890,364041,186,376369,166782,209546,41,274748,120108,154495,145
GUJRAT,DISTRICT,15 &  ABOVE,SEPERATION,3223,1738,1485,0,1970,1058,912,0,1253,680,573,0
GUJRAT,DISTRICT,15 &  ABOVE,WIDOWED,109104,78103,31001,0,69024,49803,19221,0,40080,28300,11780,0
GUJRAT,DISTRICT,15 - 19,DIVORCED,92,75,17,0,65,55,10,0,27,20,7,0
GUJRAT,DISTRICT,15 - 19,MARRIED,12103,8877,3226,0,7137,5300,1837,0,4966,3577,1389,0
GUJRAT,DISTRICT,15 - 19,NEVER MARRIED,295654,144963,150669,22,175028,86443,88576,9,120626,58520,62093,13
GUJRAT,DISTRICT,15 - 19,SEPERATION,28,17,11,0,11,7,4,0,17,10,7,0
GUJRAT,DISTRICT,15 - 19,WIDOWED,45,24,21,0,30,16,14,0,15,8,7,0
GUJRAT,DISTRICT,20 - 24,DIVORCED,762,598,164,0,491,387,104,0,271,211,60,0
GUJRAT,DISTRICT,20 - 24,MARRIED,78212,55552,22660,0,47293,34090,13203,0,30919,21462,9457,0
GUJRAT,DISTRICT,20 - 24,NEVER MARRIED,203521,87521,115977,23,117576,50555,67020,1,85945,36966,48957,22
GUJRAT,DISTRICT,20 - 24,SEPERATION,180,115,65,0,110,71,39,0,70,44,26,0
GUJRAT,DISTRICT,20 - 24,WIDOWED,257,154,103,0,144,84,60,0,113,70,43,0
GUJRAT,DISTRICT,25 - 29,DIVORCED,1749,1201,548,0,1142,770,372,0,607,431,176,0
GUJRAT,DISTRICT,25 - 29,MARRIED,163437,100128,63309,0,95882,59976,35906,0,67555,40152,27403,0
GUJRAT,DISTRICT,25 - 29,NEVER MARRIED,89494,30794,58679,21,49641,17014,32624,3,39853,13780,26055,18
GUJRAT,DISTRICT,25 - 29,SEPERATION,281,156,125,0,178,99,79,0,103,57,46,0
GUJRAT,DISTRICT,25 - 29,WIDOWED,711,455,256,0,421,266,155,0,290,189,101,0
GUJRAT,DISTRICT,30 - 34,DIVORCED,2268,1509,759,0,1435,943,492,0,833,566,267,0
GUJRAT,DISTRICT,30 - 34,MARRIED,206770,111680,95090,0,118567,66242,52325,0,88203,45438,42765,0
GUJRAT,DISTRICT,30 - 34,NEVER MARRIED,30396,10072,20305,19,16224,5179,11040,5,14172,4893,9265,14
GUJRAT,DISTRICT,30 - 34,SEPERATION,407,222,185,0,247,127,120,0,160,95,65,0
GUJRAT,DISTRICT,30 - 34,WIDOWED,1429,991,438,0,877,610,267,0,552,381,171,0
GUJRAT,DISTRICT,35 - 39,DIVORCED,2358,1515,843,0,1434,900,534,0,924,615,309,0
GUJRAT,DISTRICT,35 - 39,MARRIED,205467,103029,102438,0,116579,60645,55934,0,88888,42384,46504,0
GUJRAT,DISTRICT,35 - 39,NEVER MARRIED,12845,6194,6629,22,6835,3279,3553,3,6010,2915,3076,19
GUJRAT,DISTRICT,35 - 39,SEPERATION,454,245,209,0,271,152,119,0,183,93,90,0
GUJRAT,DISTRICT,35 - 39,WIDOWED,2537,1916,621,0,1487,1126,361,0,1050,790,260,0
GUJRAT,DISTRICT,40 - 44,DIVORCED,1933,1263,670,0,1184,783,401,0,749,480,269,0
GUJRAT,DISTRICT,40 - 44,MARRIED,171740,86057,85683,0,98687,50471,48216,0,73053,35586,37467,0
GUJRAT,DISTRICT,40 - 44,NEVER MARRIED,6381,2304,4050,27,3385,1241,2141,3,2996,1063,1909,24
GUJRAT,DISTRICT,40 - 44,SEPERATION,396,212,184,0,228,125,103,0,168,87,81,0
GUJRAT,DISTRICT,40 - 44,WIDOWED,4478,3650,828,0,2599,2149,450,0,1879,1501,378,0
GUJRAT,DISTRICT,45 - 49,DIVORCED,1434,897,537,0,910,559,351,0,524,338,186,0
GUJRAT,DISTRICT,45 - 49,MARRIED,135853,64950,70903,0,78600,38227,40373,0,57253,26723,30530,0
GUJRAT,DISTRICT,45 - 49,NEVER MARRIED,4044,1504,2528,12,2187,840,1345,2,1857,664,1183,10
GUJRAT,DISTRICT,45 - 49,SEPERATION,360,189,171,0,206,107,99,0,154,82,72,0
GUJRAT,DISTRICT,45 - 49,WIDOWED,5979,4888,1091,0,3532,2891,641,0,2447,1997,450,0
GUJRAT,DISTRICT,50 - 54,DIVORCED,1191,781,410,0,768,517,251,0,423,264,159,0
GUJRAT,DISTRICT,50 - 54,MARRIED,113585,53213,60372,0,66610,31504,35106,0,46975,21709,25266,0
GUJRAT,DISTRICT,50 - 54,NEVER MARRIED,2621,1036,1574,11,1557,629,925,3,1064,407,649,8
GUJRAT,DISTRICT,50 - 54,SEPERATION,315,173,142,0,202,106,96,0,113,67,46,0
GUJRAT,DISTRICT,50 - 54,WIDOWED,9281,7406,1875,0,5506,4412,1094,0,3775,2994,781,0
GUJRAT,DISTRICT,55 - 59,DIVORCED,923,587,336,0,643,423,220,0,280,164,116,0
GUJRAT,DISTRICT,55 - 59,MARRIED,92261,41163,51098,0,55279,24972,30307,0,36982,16191,20791,0
GUJRAT,DISTRICT,55 - 59,NEVER MARRIED,2022,841,1168,13,1217,515,696,6,805,326,472,7
GUJRAT,DISTRICT,55 - 59,SEPERATION,223,113,110,0,146,74,72,0,77,39,38,0
GUJRAT,DISTRICT,55 - 59,WIDOWED,11624,9052,2572,0,6988,5457,1531,0,4636,3595,1041,0
GUJRAT,DISTRICT,60 - 64,DIVORCED,744,457,287,0,532,332,200,0,212,125,87,0
GUJRAT,DISTRICT,60 - 64,MARRIED,73852,31327,42525,0,44724,19295,25429,0,29128,12032,17096,0
GUJRAT,DISTRICT,60 - 64,NEVER MARRIED,1475,580,889,6,940,384,555,1,535,196,334,5
GUJRAT,DISTRICT,60 - 64,SEPERATION,214,117,97,0,142,75,67,0,72,42,30,0
GUJRAT,DISTRICT,60 - 64,WIDOWED,15076,11304,3772,0,9251,7022,2229,0,5825,4282,1543,0
GUJRAT,DISTRICT,65 - 69,DIVORCED,473,289,184,0,352,212,140,0,121,77,44,0
GUJRAT,DISTRICT,65 - 69,MARRIED,53733,21118,32615,0,33427,13312,20115,0,20306,7806,12500,0
GUJRAT,DISTRICT,65 - 69,NEVER MARRIED,1107,494,609,4,769,349,417,3,338,145,192,1
GUJRAT,DISTRICT,65 - 69,SEPERATION,158,86,72,0,115,63,52,0,43,23,20,0
GUJRAT,DISTRICT,65 - 69,WIDOWED,16022,11429,4593,0,9965,7193,2772,0,6057,4236,1821,0
GUJRAT,DISTRICT,70 - 74,DIVORCED,254,133,121,0,191,98,93,0,63,35,28,0
GUJRAT,DISTRICT,70 - 74,MARRIED,31944,10386,21558,0,20601,6828,13773,0,11343,3558,7785,0
GUJRAT,DISTRICT,70 - 74,NEVER MARRIED,702,249,451,2,467,156,310,1,235,93,141,1
GUJRAT,DISTRICT,70 - 74,SEPERATION,85,35,50,0,54,25,29,0,31,10,21,0
GUJRAT,DISTRICT,70 - 74,WIDOWED,14683,9729,4954,0,9630,6539,3091,0,5053,3190,1863,0
GUJRAT,DISTRICT,75 & ABOVE,DIVORCED,231,128,103,0,179,96,83,0,52,32,20,0
GUJRAT,DISTRICT,75 & ABOVE,MARRIED,31096,9877,21219,0,20690,6628,14062,0,10406,3249,7157,0
GUJRAT,DISTRICT,75 & ABOVE,NEVER MARRIED,855,338,513,4,543,198,344,1,312,140,169,3
GUJRAT,DISTRICT,75 & ABOVE,SEPERATION,122,58,64,0,60,27,33,0,62,31,31,0
GUJRAT,DISTRICT,75 & ABOVE,WIDOWED,26982,17105,9877,0,18594,12038,6556,0,8388,5067,3321,0
HAFIZABAD,DISTRICT,15 &  ABOVE,DIVORCED,4473,2680,1793,0,2894,1756,1138,0,1579,924,655,0
HAFIZABAD,DISTRICT,15 &  ABOVE,MARRIED,537960,271621,266339,0,335675,169616,166059,0,202285,102005,100280,0
HAFIZABAD,DISTRICT,15 &  ABOVE,NEVER MARRIED,254988,109409,145521,58,152631,64961,87652,18,102357,44448,57869,40
HAFIZABAD,DISTRICT,15 &  ABOVE,SEPERATION,1727,910,817,0,1099,566,533,0,628,344,284,0
HAFIZABAD,DISTRICT,15 &  ABOVE,WIDOWED,36030,23912,12118,0,21715,14320,7395,0,14315,9592,4723,0
HAFIZABAD,DISTRICT,15 - 19,DIVORCED,89,65,24,0,58,42,16,0,31,23,8,0
HAFIZABAD,DISTRICT,15 - 19,MARRIED,8480,6009,2471,0,5937,4188,1749,0,2543,1821,722,0
HAFIZABAD,DISTRICT,15 - 19,NEVER MARRIED,126197,60701,65486,10,76606,36585,40015,6,49591,24116,25471,4
HAFIZABAD,DISTRICT,15 - 19,SEPERATION,32,24,8,0,18,13,5,0,14,11,3,0
HAFIZABAD,DISTRICT,15 - 19,WIDOWED,19,10,9,0,12,4,8,0,7,6,1,0
HAFIZABAD,DISTRICT,20 - 24,DIVORCED,376,259,117,0,228,158,70,0,148,101,47,0
HAFIZABAD,DISTRICT,20 - 24,MARRIED,38986,26252,12734,0,25226,16770,8456,0,13760,9482,4278,0
HAFIZABAD,DISTRICT,20 - 24,NEVER MARRIED,75067,30649,44412,6,43803,17502,26301,0,31264,13147,18111,6
HAFIZABAD,DISTRICT,20 - 24,SEPERATION,124,77,47,0,87,50,37,0,37,27,10,0
HAFIZABAD,DISTRICT,20 - 24,WIDOWED,147,97,50,0,99,63,36,0,48,34,14,0
HAFIZABAD,DISTRICT,25 - 29,DIVORCED,615,408,207,0,395,262,133,0,220,146,74,0
HAFIZABAD,DISTRICT,25 - 29,MARRIED,69442,41239,28203,0,42795,25445,17350,0,26647,15794,10853,0
HAFIZABAD,DISTRICT,25 - 29,NEVER MARRIED,32588,11037,21546,5,18991,6357,12633,1,13597,4680,8913,4
HAFIZABAD,DISTRICT,25 - 29,SEPERATION,181,101,80,0,118,63,55,0,63,38,25,0
HAFIZABAD,DISTRICT,25 - 29,WIDOWED,344,210,134,0,216,129,87,0,128,81,47,0
HAFIZABAD,DISTRICT,30 - 34,DIVORCED,641,366,275,0,389,217,172,0,252,149,103,0
HAFIZABAD,DISTRICT,30 - 34,MARRIED,76711,41390,35321,0,46343,24912,21431,0,30368,16478,13890,0
HAFIZABAD,DISTRICT,30 - 34,NEVER MARRIED,10460,3681,6770,9,6250,2201,4046,3,4210,1480,2724,6
HAFIZABAD,DISTRICT,30 - 34,SEPERATION,198,112,86,0,120,67,53,0,78,45,33,0
HAFIZABAD,DISTRICT,30 - 34,WIDOWED,672,466,206,0,397,277,120,0,275,189,86,0
HAFIZABAD,DISTRICT,35 - 39,DIVORCED,639,377,262,0,395,235,160,0,244,142,102,0
HAFIZABAD,DISTRICT,35 - 39,MARRIED,75116,38388,36728,0,45059,23209,21850,0,30057,15179,14878,0
HAFIZABAD,DISTRICT,35 - 39,NEVER MARRIED,4291,1188,3094,9,2583,733,1847,3,1708,455,1247,6
HAFIZABAD,DISTRICT,35 - 39,SEPERATION,216,114,102,0,119,68,51,0,97,46,51,0
HAFIZABAD,DISTRICT,35 - 39,WIDOWED,1149,823,326,0,686,479,207,0,463,344,119,0
HAFIZABAD,DISTRICT,40 - 44,DIVORCED,585,342,243,0,350,218,132,0,235,124,111,0
HAFIZABAD,DISTRICT,40 - 44,MARRIED,68578,33162,35416,0,42201,20409,21792,0,26377,12753,13624,0
HAFIZABAD,DISTRICT,40 - 44,NEVER MARRIED,2171,659,1504,8,1406,454,948,4,765,205,556,4
HAFIZABAD,DISTRICT,40 - 44,SEPERATION,243,126,117,0,149,75,74,0,94,51,43,0
HAFIZABAD,DISTRICT,40 - 44,WIDOWED,1968,1512,456,0,1191,899,292,0,777,613,164,0
HAFIZABAD,DISTRICT,45 - 49,DIVORCED,472,279,193,0,307,185,122,0,165,94,71,0
HAFIZABAD,DISTRICT,45 - 49,MARRIED,55396,25680,29716,0,34007,15922,18085,0,21389,9758,11631,0
HAFIZABAD,DISTRICT,45 - 49,NEVER MARRIED,1374,447,925,2,869,308,561,0,505,139,364,2
HAFIZABAD,DISTRICT,45 - 49,SEPERATION,196,87,109,0,122,52,70,0,74,35,39,0
HAFIZABAD,DISTRICT,45 - 49,WIDOWED,2470,1872,598,0,1417,1073,344,0,1053,799,254,0
HAFIZABAD,DISTRICT,50 - 54,DIVORCED,370,229,141,0,260,164,96,0,110,65,45,0
HAFIZABAD,DISTRICT,50 - 54,MARRIED,44042,19866,24176,0,27413,12451,14962,0,16629,7415,9214,0
HAFIZABAD,DISTRICT,50 - 54,NEVER MARRIED,898,358,536,4,625,272,353,0,273,86,183,4
HAFIZABAD,DISTRICT,50 - 54,SEPERATION,163,94,69,0,108,62,46,0,55,32,23,0
HAFIZABAD,DISTRICT,50 - 54,WIDOWED,3570,2638,932,0,2029,1465,564,0,1541,1173,368,0
HAFIZABAD,DISTRICT,55 - 59,DIVORCED,237,118,119,0,171,88,83,0,66,30,36,0
HAFIZABAD,DISTRICT,55 - 59,MARRIED,34184,14293,19891,0,21409,8945,12464,0,12775,5348,7427,0
HAFIZABAD,DISTRICT,55 - 59,NEVER MARRIED,679,246,429,4,486,191,294,1,193,55,135,3
HAFIZABAD,DISTRICT,55 - 59,SEPERATION,132,71,61,0,81,36,45,0,51,35,16,0
HAFIZABAD,DISTRICT,55 - 59,WIDOWED,3943,2776,1167,0,2147,1507,640,0,1796,1269,527,0
HAFIZABAD,DISTRICT,60 - 64,DIVORCED,189,106,83,0,132,79,53,0,57,27,30,0
HAFIZABAD,DISTRICT,60 - 64,MARRIED,26084,10724,15360,0,16717,6984,9733,0,9367,3740,5627,0
HAFIZABAD,DISTRICT,60 - 64,NEVER MARRIED,470,177,292,1,353,142,211,0,117,35,81,1
HAFIZABAD,DISTRICT,60 - 64,SEPERATION,101,48,53,0,75,39,36,0,26,9,17,0
HAFIZABAD,DISTRICT,60 - 64,WIDOWED,4801,3315,1486,0,2731,1914,817,0,2070,1401,669,0
HAFIZABAD,DISTRICT,65 - 69,DIVORCED,123,68,55,0,98,53,45,0,25,15,10,0
HAFIZABAD,DISTRICT,65 - 69,MARRIED,17993,7201,10792,0,11994,4914,7080,0,5999,2287,3712,0
HAFIZABAD,DISTRICT,65 - 69,NEVER MARRIED,315,114,201,0,250,91,159,0,65,23,42,0
HAFIZABAD,DISTRICT,65 - 69,SEPERATION,59,25,34,0,40,17,23,0,19,8,11,0
HAFIZABAD,DISTRICT,65 - 69,WIDOWED,4866,3181,1685,0,2868,1880,988,0,1998,1301,697,0
HAFIZABAD,DISTRICT,70 - 74,DIVORCED,72,29,43,0,62,27,35,0,10,2,8,0
HAFIZABAD,DISTRICT,70 - 74,MARRIED,11060,3596,7464,0,7679,2580,5099,0,3381,1016,2365,0
HAFIZABAD,DISTRICT,70 - 74,NEVER MARRIED,204,61,143,0,178,54,124,0,26,7,19,0
HAFIZABAD,DISTRICT,70 - 74,SEPERATION,36,14,22,0,27,10,17,0,9,4,5,0
HAFIZABAD,DISTRICT,70 - 74,WIDOWED,4350,2589,1761,0,2755,1641,1114,0,1595,948,647,0
HAFIZABAD,DISTRICT,75 & ABOVE,DIVORCED,65,34,31,0,49,28,21,0,16,6,10,0
HAFIZABAD,DISTRICT,75 & ABOVE,MARRIED,11888,3821,8067,0,8895,2887,6008,0,2993,934,2059,0
HAFIZABAD,DISTRICT,75 & ABOVE,NEVER MARRIED,274,91,183,0,231,71,160,0,43,20,23,0
HAFIZABAD,DISTRICT,75 & ABOVE,SEPERATION,46,17,29,0,35,14,21,0,11,3,8,0
HAFIZABAD,DISTRICT,75 & ABOVE,WIDOWED,7731,4423,3308,0,5167,2989,2178,0,2564,1434,1130,0
JHANG,DISTRICT,15 &  ABOVE,DIVORCED,11497,7771,3726,0,8407,5698,2709,0,3090,2073,1017,0
JHANG,DISTRICT,15 &  ABOVE,MARRIED,1241399,626726,614673,0,920263,464765,455498,0,321136,161961,159175,0
JHANG,DISTRICT,15 &  ABOVE,NEVER MARRIED,513995,202123,311623,249,354093,137248,216768,77,159902,64875,94855,172
JHANG,DISTRICT,15 &  ABOVE,SEPERATION,4977,2742,2235,0,3914,2204,1710,0,1063,538,525,0
JHANG,DISTRICT,15 &  ABOVE,WIDOWED,88214,63091,25123,0,63584,44944,18640,0,24630,18147,6483,0
JHANG,DISTRICT,15 - 19,DIVORCED,248,195,53,0,200,156,44,0,48,39,9,0
JHANG,DISTRICT,15 - 19,MARRIED,37412,27067,10345,0,31206,22288,8918,0,6206,4779,1427,0
JHANG,DISTRICT,15 - 19,NEVER MARRIED,265959,116389,149545,25,189463,82033,107421,9,76496,34356,42124,16
JHANG,DISTRICT,15 - 19,SEPERATION,173,115,58,0,148,97,51,0,25,18,7,0
JHANG,DISTRICT,15 - 19,WIDOWED,107,54,53,0,90,44,46,0,17,10,7,0
JHANG,DISTRICT,20 - 24,DIVORCED,924,657,267,0,694,490,204,0,230,167,63,0
JHANG,DISTRICT,20 - 24,MARRIED,111793,71425,40368,0,88302,55278,33024,0,23491,16147,7344,0
JHANG,DISTRICT,20 - 24,NEVER MARRIED,138436,50208,88180,48,91954,31770,60176,8,46482,18438,28004,40
JHANG,DISTRICT,20 - 24,SEPERATION,456,283,173,0,371,240,131,0,85,43,42,0
JHANG,DISTRICT,20 - 24,WIDOWED,447,267,180,0,350,201,149,0,97,66,31,0
JHANG,DISTRICT,25 - 29,DIVORCED,1330,888,442,0,936,611,325,0,394,277,117,0
JHANG,DISTRICT,25 - 29,MARRIED,161660,91928,69732,0,121292,68078,53214,0,40368,23850,16518,0
JHANG,DISTRICT,25 - 29,NEVER MARRIED,58243,18009,40185,49,37402,11034,26359,9,20841,6975,13826,40
JHANG,DISTRICT,25 - 29,SEPERATION,525,308,217,0,420,254,166,0,105,54,51,0
JHANG,DISTRICT,25 - 29,WIDOWED,900,536,364,0,709,429,280,0,191,107,84,0
JHANG,DISTRICT,30 - 34,DIVORCED,1574,1041,533,0,1108,708,400,0,466,333,133,0
JHANG,DISTRICT,30 - 34,MARRIED,175466,92473,82993,0,126683,66386,60297,0,48783,26087,22696,0
JHANG,DISTRICT,30 - 34,NEVER MARRIED,22751,6681,16036,34,14905,4355,10538,12,7846,2326,5498,22
JHANG,DISTRICT,30 - 34,SEPERATION,637,354,283,0,484,273,211,0,153,81,72,0
JHANG,DISTRICT,30 - 34,WIDOWED,1707,1145,562,0,1287,843,444,0,420,302,118,0
JHANG,DISTRICT,35 - 39,DIVORCED,1676,1151,525,0,1181,843,338,0,495,308,187,0
JHANG,DISTRICT,35 - 39,MARRIED,167899,84100,83799,0,120278,60373,59905,0,47621,23727,23894,0
JHANG,DISTRICT,35 - 39,NEVER MARRIED,10818,3488,7307,23,7414,2474,4937,3,3404,1014,2370,20
JHANG,DISTRICT,35 - 39,SEPERATION,628,335,293,0,487,269,218,0,141,66,75,0
JHANG,DISTRICT,35 - 39,WIDOWED,2797,2064,733,0,2000,1444,556,0,797,620,177,0
JHANG,DISTRICT,40 - 44,DIVORCED,1649,1127,522,0,1214,822,392,0,435,305,130,0
JHANG,DISTRICT,40 - 44,MARRIED,153380,74546,78834,0,111064,54232,56832,0,42316,20314,22002,0
JHANG,DISTRICT,40 - 44,NEVER MARRIED,6114,2306,3776,32,4228,1698,2514,16,1886,608,1262,16
JHANG,DISTRICT,40 - 44,SEPERATION,587,323,264,0,466,265,201,0,121,58,63,0
JHANG,DISTRICT,40 - 44,WIDOWED,4830,3843,987,0,3377,2641,736,0,1453,1202,251,0
JHANG,DISTRICT,45 - 49,DIVORCED,1167,802,365,0,842,595,247,0,325,207,118,0
JHANG,DISTRICT,45 - 49,MARRIED,112394,53245,59149,0,81088,38909,42179,0,31306,14336,16970,0
JHANG,DISTRICT,45 - 49,NEVER MARRIED,3736,1502,2225,9,2668,1150,1513,5,1068,352,712,4
JHANG,DISTRICT,45 - 49,SEPERATION,500,273,227,0,384,218,166,0,116,55,61,0
JHANG,DISTRICT,45 - 49,WIDOWED,6137,4842,1295,0,4302,3358,944,0,1835,1484,351,0
JHANG,DISTRICT,50 - 54,DIVORCED,939,640,299,0,716,490,226,0,223,150,73,0
JHANG,DISTRICT,50 - 54,MARRIED,98262,45010,53252,0,71864,33137,38727,0,26398,11873,14525,0
JHANG,DISTRICT,50 - 54,NEVER MARRIED,2669,1214,1452,3,1947,923,1022,2,722,291,430,1
JHANG,DISTRICT,50 - 54,SEPERATION,474,263,211,0,362,203,159,0,112,60,52,0
JHANG,DISTRICT,50 - 54,WIDOWED,8885,7046,1839,0,6123,4785,1338,0,2762,2261,501,0
JHANG,DISTRICT,55 - 59,DIVORCED,744,502,242,0,555,380,175,0,189,122,67,0
JHANG,DISTRICT,55 - 59,MARRIED,78499,33024,45475,0,57813,24407,33406,0,20686,8617,12069,0
JHANG,DISTRICT,55 - 59,NEVER MARRIED,1967,849,1110,8,1499,664,830,5,468,185,280,3
JHANG,DISTRICT,55 - 59,SEPERATION,397,203,194,0,307,156,151,0,90,47,43,0
JHANG,DISTRICT,55 - 59,WIDOWED,10421,7853,2568,0,7145,5332,1813,0,3276,2521,755,0
JHANG,DISTRICT,60 - 64,DIVORCED,549,347,202,0,414,268,146,0,135,79,56,0
JHANG,DISTRICT,60 - 64,MARRIED,57061,23168,33893,0,42315,17491,24824,0,14746,5677,9069,0
JHANG,DISTRICT,60 - 64,NEVER MARRIED,1355,636,710,9,1035,483,549,3,320,153,161,6
JHANG,DISTRICT,60 - 64,SEPERATION,267,141,126,0,208,110,98,0,59,31,28,0
JHANG,DISTRICT,60 - 64,WIDOWED,11691,8602,3089,0,8218,6015,2203,0,3473,2587,886,0
JHANG,DISTRICT,65 - 69,DIVORCED,348,219,129,0,256,169,87,0,92,50,42,0
JHANG,DISTRICT,65 - 69,MARRIED,39309,15691,23618,0,29679,12018,17661,0,9630,3673,5957,0
JHANG,DISTRICT,65 - 69,NEVER MARRIED,869,416,451,2,686,313,371,2,183,103,80,0
JHANG,DISTRICT,65 - 69,SEPERATION,179,76,103,0,145,58,87,0,34,18,16,0
JHANG,DISTRICT,65 - 69,WIDOWED,12102,8699,3403,0,8560,6125,2435,0,3542,2574,968,0
JHANG,DISTRICT,70 - 74,DIVORCED,197,112,85,0,163,90,73,0,34,22,12,0
JHANG,DISTRICT,70 - 74,MARRIED,25671,8438,17233,0,20271,6754,13517,0,5400,1684,3716,0
JHANG,DISTRICT,70 - 74,NEVER MARRIED,568,216,347,5,460,176,282,2,108,40,65,3
JHANG,DISTRICT,70 - 74,SEPERATION,89,40,49,0,75,35,40,0,14,5,9,0
JHANG,DISTRICT,70 - 74,WIDOWED,11353,7589,3764,0,8429,5643,2786,0,2924,1946,978,0
JHANG,DISTRICT,75 & ABOVE,DIVORCED,152,90,62,0,128,76,52,0,24,14,10,0
JHANG,DISTRICT,75 & ABOVE,MARRIED,22593,6611,15982,0,18408,5414,12994,0,4185,1197,2988,0
JHANG,DISTRICT,75 & ABOVE,NEVER MARRIED,510,209,299,2,432,175,256,1,78,34,43,1
JHANG,DISTRICT,75 & ABOVE,SEPERATION,65,28,37,0,57,26,31,0,8,2,6,0
JHANG,DISTRICT,75 & ABOVE,WIDOWED,16837,10551,6286,0,12994,8084,4910,0,3843,2467,1376,0
JHELUM,DISTRICT,15 &  ABOVE,DIVORCED,7340,5170,2170,0,4749,3400,1349,0,2591,1770,821,0
JHELUM,DISTRICT,15 &  ABOVE,MARRIED,597017,302392,294625,0,367434,187156,180278,0,229583,115236,114347,0
JHELUM,DISTRICT,15 &  ABOVE,NEVER MARRIED,283400,116475,166828,97,170037,69852,100169,16,113363,46623,66659,81
JHELUM,DISTRICT,15 &  ABOVE,SEPERATION,1769,896,873,0,1113,564,549,0,656,332,324,0
JHELUM,DISTRICT,15 &  ABOVE,WIDOWED,51018,38680,12338,0,33335,24985,8350,0,17683,13695,3988,0
JHELUM,DISTRICT,15 - 19,DIVORCED,48,42,6,0,33,28,5,0,15,14,1,0
JHELUM,DISTRICT,15 - 19,MARRIED,5403,4069,1334,0,3459,2642,817,0,1944,1427,517,0
JHELUM,DISTRICT,15 - 19,NEVER MARRIED,120760,55878,64876,6,72864,33787,39073,4,47896,22091,25803,2
JHELUM,DISTRICT,15 - 19,SEPERATION,14,8,6,0,9,6,3,0,5,2,3,0
JHELUM,DISTRICT,15 - 19,WIDOWED,17,9,8,0,8,4,4,0,9,5,4,0
JHELUM,DISTRICT,20 - 24,DIVORCED,288,245,43,0,172,149,23,0,116,96,20,0
JHELUM,DISTRICT,20 - 24,MARRIED,31696,22994,8702,0,19995,14631,5364,0,11701,8363,3338,0
JHELUM,DISTRICT,20 - 24,NEVER MARRIED,84354,34289,50057,8,50387,20359,30027,1,33967,13930,20030,7
JHELUM,DISTRICT,20 - 24,SEPERATION,73,58,15,0,39,32,7,0,34,26,8,0
JHELUM,DISTRICT,20 - 24,WIDOWED,79,48,31,0,51,30,21,0,28,18,10,0
JHELUM,DISTRICT,25 - 29,DIVORCED,769,567,202,0,485,355,130,0,284,212,72,0
JHELUM,DISTRICT,25 - 29,MARRIED,66337,40957,25380,0,41163,25612,15551,0,25174,15345,9829,0
JHELUM,DISTRICT,25 - 29,NEVER MARRIED,43091,14316,28755,20,25967,8558,17407,2,17124,5758,11348,18
JHELUM,DISTRICT,25 - 29,SEPERATION,163,101,62,0,113,70,43,0,50,31,19,0
JHELUM,DISTRICT,25 - 29,WIDOWED,286,197,89,0,181,118,63,0,105,79,26,0
JHELUM,DISTRICT,30 - 34,DIVORCED,1132,776,356,0,691,478,213,0,441,298,143,0
JHELUM,DISTRICT,30 - 34,MARRIED,87316,47858,39458,0,53563,29425,24138,0,33753,18433,15320,0
JHELUM,DISTRICT,30 - 34,NEVER MARRIED,16636,4967,11648,21,9898,2882,7015,1,6738,2085,4633,20
JHELUM,DISTRICT,30 - 34,SEPERATION,207,95,112,0,130,64,66,0,77,31,46,0
JHELUM,DISTRICT,30 - 34,WIDOWED,659,461,198,0,390,271,119,0,269,190,79,0
JHELUM,DISTRICT,35 - 39,DIVORCED,1155,785,370,0,740,506,234,0,415,279,136,0
JHELUM,DISTRICT,35 - 39,MARRIED,87986,45049,42937,0,52739,27126,25613,0,35247,17923,17324,0
JHELUM,DISTRICT,35 - 39,NEVER MARRIED,7439,2286,5142,11,4264,1307,2954,3,3175,979,2188,8
JHELUM,DISTRICT,35 - 39,SEPERATION,218,106,112,0,131,66,65,0,87,40,47,0
JHELUM,DISTRICT,35 - 39,WIDOWED,1134,853,281,0,701,513,188,0,433,340,93,0
JHELUM,DISTRICT,40 - 44,DIVORCED,1065,741,324,0,666,466,200,0,399,275,124,0
JHELUM,DISTRICT,40 - 44,MARRIED,77654,38157,39497,0,47173,23187,23986,0,30481,14970,15511,0
JHELUM,DISTRICT,40 - 44,NEVER MARRIED,3899,1436,2454,9,2285,844,1439,2,1614,592,1015,7
JHELUM,DISTRICT,40 - 44,SEPERATION,246,108,138,0,158,68,90,0,88,40,48,0
JHELUM,DISTRICT,40 - 44,WIDOWED,2000,1650,350,0,1311,1070,241,0,689,580,109,0
JHELUM,DISTRICT,45 - 49,DIVORCED,804,563,241,0,509,373,136,0,295,190,105,0
JHELUM,DISTRICT,45 - 49,MARRIED,60915,28912,32003,0,36358,17337,19021,0,24557,11575,12982,0
JHELUM,DISTRICT,45 - 49,NEVER MARRIED,2338,933,1398,7,1341,569,771,1,997,364,627,6
JHELUM,DISTRICT,45 - 49,SEPERATION,232,121,111,0,138,74,64,0,94,47,47,0
JHELUM,DISTRICT,45 - 49,WIDOWED,2771,2320,451,0,1724,1435,289,0,1047,885,162,0
JHELUM,DISTRICT,50 - 54,DIVORCED,648,453,195,0,441,320,121,0,207,133,74,0
JHELUM,DISTRICT,50 - 54,MARRIED,51221,23737,27484,0,31031,14574,16457,0,20190,9163,11027,0
JHELUM,DISTRICT,50 - 54,NEVER MARRIED,1508,692,810,6,880,438,441,1,628,254,369,5
JHELUM,DISTRICT,50 - 54,SEPERATION,171,85,86,0,105,49,56,0,66,36,30,0
JHELUM,DISTRICT,50 - 54,WIDOWED,4387,3681,706,0,2773,2311,462,0,1614,1370,244,0
JHELUM,DISTRICT,55 - 59,DIVORCED,523,380,143,0,352,263,89,0,171,117,54,0
JHELUM,DISTRICT,55 - 59,MARRIED,42526,18955,23571,0,26680,11940,14740,0,15846,7015,8831,0
JHELUM,DISTRICT,55 - 59,NEVER MARRIED,1145,539,603,3,661,333,327,1,484,206,276,2
JHELUM,DISTRICT,55 - 59,SEPERATION,146,80,66,0,97,50,47,0,49,30,19,0
JHELUM,DISTRICT,55 - 59,WIDOWED,5673,4605,1068,0,3599,2908,691,0,2074,1697,377,0
JHELUM,DISTRICT,60 - 64,DIVORCED,417,295,122,0,294,213,81,0,123,82,41,0
JHELUM,DISTRICT,60 - 64,MARRIED,34199,14032,20167,0,21405,8876,12529,0,12794,5156,7638,0
JHELUM,DISTRICT,60 - 64,NEVER MARRIED,882,458,421,3,589,315,274,0,293,143,147,3
JHELUM,DISTRICT,60 - 64,SEPERATION,125,61,64,0,67,35,32,0,58,26,32,0
JHELUM,DISTRICT,60 - 64,WIDOWED,7091,5631,1460,0,4503,3518,985,0,2588,2113,475,0
JHELUM,DISTRICT,65 - 69,DIVORCED,259,179,80,0,189,139,50,0,70,40,30,0
JHELUM,DISTRICT,65 - 69,MARRIED,24103,9417,14686,0,15279,6113,9166,0,8824,3304,5520,0
JHELUM,DISTRICT,65 - 69,NEVER MARRIED,578,308,268,2,381,213,168,0,197,95,100,2
JHELUM,DISTRICT,65 - 69,SEPERATION,76,37,39,0,53,24,29,0,23,13,10,0
JHELUM,DISTRICT,65 - 69,WIDOWED,7377,5638,1739,0,4729,3581,1148,0,2648,2057,591,0
JHELUM,DISTRICT,70 - 74,DIVORCED,132,79,53,0,101,62,39,0,31,17,14,0
JHELUM,DISTRICT,70 - 74,MARRIED,14528,4419,10109,0,9516,2972,6544,0,5012,1447,3565,0
JHELUM,DISTRICT,70 - 74,NEVER MARRIED,375,190,184,1,250,121,129,0,125,69,55,1
JHELUM,DISTRICT,70 - 74,SEPERATION,53,17,36,0,39,14,25,0,14,3,11,0
JHELUM,DISTRICT,70 - 74,WIDOWED,7132,5153,1979,0,4729,3410,1319,0,2403,1743,660,0
JHELUM,DISTRICT,75 & ABOVE,DIVORCED,100,65,35,0,76,48,28,0,24,17,7,0
JHELUM,DISTRICT,75 & ABOVE,MARRIED,13133,3836,9297,0,9073,2721,6352,0,4060,1115,2945,0
JHELUM,DISTRICT,75 & ABOVE,NEVER MARRIED,395,183,212,0,270,126,144,0,125,57,68,0
JHELUM,DISTRICT,75 & ABOVE,SEPERATION,45,19,26,0,34,12,22,0,11,7,4,0
JHELUM,DISTRICT,75 & ABOVE,WIDOWED,12412,8434,3978,0,8636,5816,2820,0,3776,2618,1158,0
KASUR,DISTRICT,15 &  ABOVE,DIVORCED,10280,6316,3964,0,6658,4098,2560,0,3622,2218,1404,0
KASUR,DISTRICT,15 &  ABOVE,MARRIED,1596156,795339,800817,0,1105104,550522,554582,0,491052,244817,246235,0
KASUR,DISTRICT,15 &  ABOVE,NEVER MARRIED,754267,323161,430724,382,513659,217704,295823,132,240608,105457,134901,250
KASUR,DISTRICT,15 &  ABOVE,SEPERATION,4318,1833,2485,0,2517,1210,1307,0,1801,623,1178,0
KASUR,DISTRICT,15 &  ABOVE,WIDOWED,91504,62240,29264,0,61489,41063,20426,0,30015,21177,8838,0
KASUR,DISTRICT,15 - 19,DIVORCED,190,157,33,0,146,118,28,0,44,39,5,0
KASUR,DISTRICT,15 - 19,MARRIED,22121,16280,5841,0,16569,12118,4451,0,5552,4162,1390,0
KASUR,DISTRICT,15 - 19,NEVER MARRIED,387709,186121,201528,60,271179,129567,141591,21,116530,56554,59937,39
KASUR,DISTRICT,15 - 19,SEPERATION,114,68,46,0,69,53,16,0,45,15,30,0
KASUR,DISTRICT,15 - 19,WIDOWED,81,48,33,0,59,33,26,0,22,15,7,0
KASUR,DISTRICT,20 - 24,DIVORCED,929,671,258,0,632,453,179,0,297,218,79,0
KASUR,DISTRICT,20 - 24,MARRIED,123951,84205,39746,0,90152,60694,29458,0,33799,23511,10288,0
KASUR,DISTRICT,20 - 24,NEVER MARRIED,224802,88523,136209,70,151782,57933,93826,23,73020,30590,42383,47
KASUR,DISTRICT,20 - 24,SEPERATION,377,185,192,0,180,122,58,0,197,63,134,0
KASUR,DISTRICT,20 - 24,WIDOWED,435,247,188,0,334,187,147,0,101,60,41,0
KASUR,DISTRICT,25 - 29,DIVORCED,1530,979,551,0,1008,631,377,0,522,348,174,0
KASUR,DISTRICT,25 - 29,MARRIED,224857,127785,97072,0,158260,88630,69630,0,66597,39155,27442,0
KASUR,DISTRICT,25 - 29,NEVER MARRIED,91377,30717,60597,63,59177,19074,40085,18,32200,11643,20512,45
KASUR,DISTRICT,25 - 29,SEPERATION,593,227,366,0,303,153,150,0,290,74,216,0
KASUR,DISTRICT,25 - 29,WIDOWED,967,506,461,0,714,341,373,0,253,165,88,0
KASUR,DISTRICT,30 - 34,DIVORCED,1716,1081,635,0,1090,663,427,0,626,418,208,0
KASUR,DISTRICT,30 - 34,MARRIED,243524,125827,117697,0,167302,85458,81844,0,76222,40369,35853,0
KASUR,DISTRICT,30 - 34,NEVER MARRIED,26863,11237,15581,45,16935,6920,10002,13,9928,4317,5579,32
KASUR,DISTRICT,30 - 34,SEPERATION,661,265,396,0,362,185,177,0,299,80,219,0
KASUR,DISTRICT,30 - 34,WIDOWED,1688,1053,635,0,1193,736,457,0,495,317,178,0
KASUR,DISTRICT,35 - 39,DIVORCED,1547,901,646,0,956,574,382,0,591,327,264,0
KASUR,DISTRICT,35 - 39,MARRIED,232028,111827,120201,0,156916,75205,81711,0,75112,36622,38490,0
KASUR,DISTRICT,35 - 39,NEVER MARRIED,10578,2775,7758,45,6508,1699,4792,17,4070,1076,2966,28
KASUR,DISTRICT,35 - 39,SEPERATION,600,257,343,0,337,145,192,0,263,112,151,0
KASUR,DISTRICT,35 - 39,WIDOWED,2858,1919,939,0,1930,1271,659,0,928,648,280,0
KASUR,DISTRICT,40 - 44,DIVORCED,1341,806,535,0,822,490,332,0,519,316,203,0
KASUR,DISTRICT,40 - 44,MARRIED,203245,94891,108354,0,138397,64713,73684,0,64848,30178,34670,0
KASUR,DISTRICT,40 - 44,NEVER MARRIED,5053,1355,3661,37,3085,860,2207,18,1968,495,1454,19
KASUR,DISTRICT,40 - 44,SEPERATION,539,211,328,0,325,142,183,0,214,69,145,0
KASUR,DISTRICT,40 - 44,WIDOWED,4631,3381,1250,0,3150,2248,902,0,1481,1133,348,0
KASUR,DISTRICT,45 - 49,DIVORCED,979,572,407,0,595,363,232,0,384,209,175,0
KASUR,DISTRICT,45 - 49,MARRIED,154169,69992,84177,0,103885,47582,56303,0,50284,22410,27874,0
KASUR,DISTRICT,45 - 49,NEVER MARRIED,2857,774,2059,24,1750,519,1222,9,1107,255,837,15
KASUR,DISTRICT,45 - 49,SEPERATION,420,202,218,0,279,145,134,0,141,57,84,0
KASUR,DISTRICT,45 - 49,WIDOWED,6110,4510,1600,0,4012,2888,1124,0,2098,1622,476,0
KASUR,DISTRICT,50 - 54,DIVORCED,776,470,306,0,520,324,196,0,256,146,110,0
KASUR,DISTRICT,50 - 54,MARRIED,123966,56414,67552,0,84706,38865,45841,0,39260,17549,21711,0
KASUR,DISTRICT,50 - 54,NEVER MARRIED,1869,624,1235,10,1169,440,725,4,700,184,510,6
KASUR,DISTRICT,50 - 54,SEPERATION,313,128,185,0,194,77,117,0,119,51,68,0
KASUR,DISTRICT,50 - 54,WIDOWED,8983,6743,2240,0,5794,4268,1526,0,3189,2475,714,0
KASUR,DISTRICT,55 - 59,DIVORCED,526,295,231,0,363,201,162,0,163,94,69,0
KASUR,DISTRICT,55 - 59,MARRIED,96738,41474,55264,0,66610,28860,37750,0,30128,12614,17514,0
KASUR,DISTRICT,55 - 59,NEVER MARRIED,1178,395,770,13,742,255,484,3,436,140,286,10
KASUR,DISTRICT,55 - 59,SEPERATION,250,101,149,0,164,69,95,0,86,32,54,0
KASUR,DISTRICT,55 - 59,WIDOWED,10391,7450,2941,0,6760,4705,2055,0,3631,2745,886,0
KASUR,DISTRICT,60 - 64,DIVORCED,349,188,161,0,246,137,109,0,103,51,52,0
KASUR,DISTRICT,60 - 64,MARRIED,71940,29743,42197,0,50268,21211,29057,0,21672,8532,13140,0
KASUR,DISTRICT,60 - 64,NEVER MARRIED,801,273,526,2,505,171,334,0,296,102,192,2
KASUR,DISTRICT,60 - 64,SEPERATION,191,84,107,0,132,52,80,0,59,32,27,0
KASUR,DISTRICT,60 - 64,WIDOWED,13078,9240,3838,0,8546,5960,2586,0,4532,3280,1252,0
KASUR,DISTRICT,65 - 69,DIVORCED,199,104,95,0,136,76,60,0,63,28,35,0
KASUR,DISTRICT,65 - 69,MARRIED,46416,19036,27380,0,32595,13627,18968,0,13821,5409,8412,0
KASUR,DISTRICT,65 - 69,NEVER MARRIED,510,175,331,4,343,121,220,2,167,54,111,2
KASUR,DISTRICT,65 - 69,SEPERATION,116,52,64,0,66,26,40,0,50,26,24,0
KASUR,DISTRICT,65 - 69,WIDOWED,12461,8638,3823,0,8207,5605,2602,0,4254,3033,1221,0
KASUR,DISTRICT,70 - 74,DIVORCED,112,49,63,0,81,38,43,0,31,11,20,0
KASUR,DISTRICT,70 - 74,MARRIED,27497,9605,17892,0,20116,7231,12885,0,7381,2374,5007,0
KASUR,DISTRICT,70 - 74,NEVER MARRIED,330,92,235,3,218,62,156,0,112,30,79,3
KASUR,DISTRICT,70 - 74,SEPERATION,76,34,42,0,54,26,28,0,22,8,14,0
KASUR,DISTRICT,70 - 74,WIDOWED,11434,7380,4054,0,7860,5047,2813,0,3574,2333,1241,0
KASUR,DISTRICT,75 & ABOVE,DIVORCED,86,43,43,0,63,30,33,0,23,13,10,0
KASUR,DISTRICT,75 & ABOVE,MARRIED,25704,8260,17444,0,19328,6328,13000,0,6376,1932,4444,0
KASUR,DISTRICT,75 & ABOVE,NEVER MARRIED,340,100,234,6,266,83,179,4,74,17,55,2
KASUR,DISTRICT,75 & ABOVE,SEPERATION,68,19,49,0,52,15,37,0,16,4,12,0
KASUR,DISTRICT,75 & ABOVE,WIDOWED,18387,11125,7262,0,12930,7774,5156,0,5457,3351,2106,0
KHANEWAL,DISTRICT,15 &  ABOVE,DIVORCED,11470,7543,3927,0,8818,5771,3047,0,2652,1772,880,0
KHANEWAL,DISTRICT,15 &  ABOVE,MARRIED,1344577,680760,663817,0,1057002,535306,521696,0,287575,145454,142121,0
KHANEWAL,DISTRICT,15 &  ABOVE,NEVER MARRIED,596201,240109,355716,376,451491,180129,271225,137,144710,59980,84491,239
KHANEWAL,DISTRICT,15 &  ABOVE,SEPERATION,4761,2659,2102,0,3972,2219,1753,0,789,440,349,0
KHANEWAL,DISTRICT,15 &  ABOVE,WIDOWED,100670,72055,28615,0,78111,55417,22694,0,22559,16638,5921,0
KHANEWAL,DISTRICT,15 - 19,DIVORCED,195,165,30,0,148,124,24,0,47,41,6,0
KHANEWAL,DISTRICT,15 - 19,MARRIED,28737,20989,7748,0,24753,17969,6784,0,3984,3020,964,0
KHANEWAL,DISTRICT,15 - 19,NEVER MARRIED,303439,137491,165895,53,235236,105852,129362,22,68203,31639,36533,31
KHANEWAL,DISTRICT,15 - 19,SEPERATION,118,85,33,0,99,72,27,0,19,13,6,0
KHANEWAL,DISTRICT,15 - 19,WIDOWED,96,60,36,0,88,55,33,0,8,5,3,0
KHANEWAL,DISTRICT,20 - 24,DIVORCED,964,713,251,0,773,558,215,0,191,155,36,0
KHANEWAL,DISTRICT,20 - 24,MARRIED,114438,75533,38905,0,94697,61766,32931,0,19741,13767,5974,0
KHANEWAL,DISTRICT,20 - 24,NEVER MARRIED,166097,62549,103482,66,123088,45017,78052,19,43009,17532,25430,47
KHANEWAL,DISTRICT,20 - 24,SEPERATION,363,245,118,0,301,200,101,0,62,45,17,0
KHANEWAL,DISTRICT,20 - 24,WIDOWED,459,240,219,0,382,199,183,0,77,41,36,0
KHANEWAL,DISTRICT,25 - 29,DIVORCED,1469,972,497,0,1145,747,398,0,324,225,99,0
KHANEWAL,DISTRICT,25 - 29,MARRIED,178023,102373,75650,0,141224,80178,61046,0,36799,22195,14604,0
KHANEWAL,DISTRICT,25 - 29,NEVER MARRIED,72147,22624,49444,79,52189,15886,36273,30,19958,6738,13171,49
KHANEWAL,DISTRICT,25 - 29,SEPERATION,545,311,234,0,472,267,205,0,73,44,29,0
KHANEWAL,DISTRICT,25 - 29,WIDOWED,1062,650,412,0,857,523,334,0,205,127,78,0
KHANEWAL,DISTRICT,30 - 34,DIVORCED,1738,1115,623,0,1314,840,474,0,424,275,149,0
KHANEWAL,DISTRICT,30 - 34,MARRIED,196481,103901,92580,0,152953,80643,72310,0,43528,23258,20270,0
KHANEWAL,DISTRICT,30 - 34,NEVER MARRIED,25673,7331,18289,53,18819,5412,13394,13,6854,1919,4895,40
KHANEWAL,DISTRICT,30 - 34,SEPERATION,632,345,287,0,528,288,240,0,104,57,47,0
KHANEWAL,DISTRICT,30 - 34,WIDOWED,1860,1255,605,0,1481,979,502,0,379,276,103,0
KHANEWAL,DISTRICT,35 - 39,DIVORCED,1775,1165,610,0,1311,842,469,0,464,323,141,0
KHANEWAL,DISTRICT,35 - 39,MARRIED,188557,94767,93790,0,145433,73095,72338,0,43124,21672,21452,0
KHANEWAL,DISTRICT,35 - 39,NEVER MARRIED,11876,3619,8219,38,8863,2705,6147,11,3013,914,2072,27
KHANEWAL,DISTRICT,35 - 39,SEPERATION,675,356,319,0,533,277,256,0,142,79,63,0
KHANEWAL,DISTRICT,35 - 39,WIDOWED,3215,2341,874,0,2523,1810,713,0,692,531,161,0
KHANEWAL,DISTRICT,40 - 44,DIVORCED,1635,1083,552,0,1241,823,418,0,394,260,134,0
KHANEWAL,DISTRICT,40 - 44,MARRIED,176960,86346,90614,0,138435,67601,70834,0,38525,18745,19780,0
KHANEWAL,DISTRICT,40 - 44,NEVER MARRIED,6426,2272,4120,34,4935,1806,3114,15,1491,466,1006,19
KHANEWAL,DISTRICT,40 - 44,SEPERATION,651,369,282,0,552,320,232,0,99,49,50,0
KHANEWAL,DISTRICT,40 - 44,WIDOWED,5754,4542,1212,0,4482,3485,997,0,1272,1057,215,0
KHANEWAL,DISTRICT,45 - 49,DIVORCED,1209,767,442,0,936,602,334,0,273,165,108,0
KHANEWAL,DISTRICT,45 - 49,MARRIED,130995,60516,70479,0,101068,46695,54373,0,29927,13821,16106,0
KHANEWAL,DISTRICT,45 - 49,NEVER MARRIED,3795,1382,2397,16,2910,1104,1799,7,885,278,598,9
KHANEWAL,DISTRICT,45 - 49,SEPERATION,536,276,260,0,438,228,210,0,98,48,50,0
KHANEWAL,DISTRICT,45 - 49,WIDOWED,7380,5729,1651,0,5654,4312,1342,0,1726,1417,309,0
KHANEWAL,DISTRICT,50 - 54,DIVORCED,895,595,300,0,695,468,227,0,200,127,73,0
KHANEWAL,DISTRICT,50 - 54,MARRIED,103806,47290,56516,0,79887,36630,43257,0,23919,10660,13259,0
KHANEWAL,DISTRICT,50 - 54,NEVER MARRIED,2282,913,1356,13,1796,747,1042,7,486,166,314,6
KHANEWAL,DISTRICT,50 - 54,SEPERATION,401,224,177,0,332,181,151,0,69,43,26,0
KHANEWAL,DISTRICT,50 - 54,WIDOWED,10497,8263,2234,0,8025,6236,1789,0,2472,2027,445,0
KHANEWAL,DISTRICT,55 - 59,DIVORCED,612,385,227,0,454,287,167,0,158,98,60,0
KHANEWAL,DISTRICT,55 - 59,MARRIED,82685,34693,47992,0,63802,26950,36852,0,18883,7743,11140,0
KHANEWAL,DISTRICT,55 - 59,NEVER MARRIED,1659,702,947,10,1331,575,750,6,328,127,197,4
KHANEWAL,DISTRICT,55 - 59,SEPERATION,300,175,125,0,246,146,100,0,54,29,25,0
KHANEWAL,DISTRICT,55 - 59,WIDOWED,12337,9269,3068,0,9366,6952,2414,0,2971,2317,654,0
KHANEWAL,DISTRICT,60 - 64,DIVORCED,487,289,198,0,395,237,158,0,92,52,40,0
KHANEWAL,DISTRICT,60 - 64,MARRIED,60623,24519,36104,0,47493,19451,28042,0,13130,5068,8062,0
KHANEWAL,DISTRICT,60 - 64,NEVER MARRIED,1280,562,712,6,1058,476,578,4,222,86,134,2
KHANEWAL,DISTRICT,60 - 64,SEPERATION,238,120,118,0,202,103,99,0,36,17,19,0
KHANEWAL,DISTRICT,60 - 64,WIDOWED,14277,10452,3825,0,10927,7957,2970,0,3350,2495,855,0
KHANEWAL,DISTRICT,65 - 69,DIVORCED,258,174,84,0,210,140,70,0,48,34,14,0
KHANEWAL,DISTRICT,65 - 69,MARRIED,40684,16489,24195,0,32267,13263,19004,0,8417,3226,5191,0
KHANEWAL,DISTRICT,65 - 69,NEVER MARRIED,694,320,370,4,593,273,319,1,101,47,51,3
KHANEWAL,DISTRICT,65 - 69,SEPERATION,156,83,73,0,140,77,63,0,16,6,10,0
KHANEWAL,DISTRICT,65 - 69,WIDOWED,14157,10230,3927,0,10889,7868,3021,0,3268,2362,906,0
KHANEWAL,DISTRICT,70 - 74,DIVORCED,125,67,58,0,104,55,49,0,21,12,9,0
KHANEWAL,DISTRICT,70 - 74,MARRIED,23617,7724,15893,0,19334,6424,12910,0,4283,1300,2983,0
KHANEWAL,DISTRICT,70 - 74,NEVER MARRIED,425,177,246,2,337,142,194,1,88,35,52,1
KHANEWAL,DISTRICT,70 - 74,SEPERATION,73,36,37,0,66,34,32,0,7,2,5,0
KHANEWAL,DISTRICT,70 - 74,WIDOWED,12570,8392,4178,0,9948,6628,3320,0,2622,1764,858,0
KHANEWAL,DISTRICT,75 & ABOVE,DIVORCED,108,53,55,0,92,48,44,0,16,5,11,0
KHANEWAL,DISTRICT,75 & ABOVE,MARRIED,18971,5620,13351,0,15656,4641,11015,0,3315,979,2336,0
KHANEWAL,DISTRICT,75 & ABOVE,NEVER MARRIED,408,167,239,2,336,134,201,1,72,33,38,1
KHANEWAL,DISTRICT,75 & ABOVE,SEPERATION,73,34,39,0,63,26,37,0,10,8,2,0
KHANEWAL,DISTRICT,75 & ABOVE,WIDOWED,17006,10632,6374,0,13489,8413,5076,0,3517,2219,1298,0
KHUSHAB,DISTRICT,15 &  ABOVE,DIVORCED,6518,4785,1733,0,4843,3568,1275,0,1675,1217,458,0
KHUSHAB,DISTRICT,15 &  ABOVE,MARRIED,623489,316106,307383,0,454193,230169,224024,0,169296,85937,83359,0
KHUSHAB,DISTRICT,15 &  ABOVE,NEVER MARRIED,288541,122378,166115,48,203381,86174,117192,15,85160,36204,48923,33
KHUSHAB,DISTRICT,15 &  ABOVE,SEPERATION,3156,1840,1316,0,2504,1483,1021,0,652,357,295,0
KHUSHAB,DISTRICT,15 &  ABOVE,WIDOWED,49134,35681,13453,0,35964,25790,10174,0,13170,9891,3279,0
KHUSHAB,DISTRICT,15 - 19,DIVORCED,91,77,14,0,63,51,12,0,28,26,2,0
KHUSHAB,DISTRICT,15 - 19,MARRIED,10656,7672,2984,0,8496,6058,2438,0,2160,1614,546,0
KHUSHAB,DISTRICT,15 - 19,NEVER MARRIED,129180,59162,70014,4,91638,41835,49801,2,37542,17327,20213,2
KHUSHAB,DISTRICT,15 - 19,SEPERATION,49,32,17,0,39,24,15,0,10,8,2,0
KHUSHAB,DISTRICT,15 - 19,WIDOWED,27,11,16,0,24,10,14,0,3,1,2,0
KHUSHAB,DISTRICT,20 - 24,DIVORCED,368,277,91,0,264,201,63,0,104,76,28,0
KHUSHAB,DISTRICT,20 - 24,MARRIED,42274,28025,14249,0,32325,21095,11230,0,9949,6930,3019,0
KHUSHAB,DISTRICT,20 - 24,NEVER MARRIED,82704,33821,48873,10,57159,23094,34062,3,25545,10727,14811,7
KHUSHAB,DISTRICT,20 - 24,SEPERATION,192,119,73,0,154,95,59,0,38,24,14,0
KHUSHAB,DISTRICT,20 - 24,WIDOWED,158,96,62,0,112,69,43,0,46,27,19,0
KHUSHAB,DISTRICT,25 - 29,DIVORCED,673,470,203,0,482,327,155,0,191,143,48,0
KHUSHAB,DISTRICT,25 - 29,MARRIED,74769,43744,31025,0,54789,31768,23021,0,19980,11976,8004,0
KHUSHAB,DISTRICT,25 - 29,NEVER MARRIED,40663,14833,25819,11,27966,10110,17855,1,12697,4723,7964,10
KHUSHAB,DISTRICT,25 - 29,SEPERATION,297,170,127,0,231,131,100,0,66,39,27,0
KHUSHAB,DISTRICT,25 - 29,WIDOWED,417,257,160,0,311,193,118,0,106,64,42,0
KHUSHAB,DISTRICT,30 - 34,DIVORCED,840,610,230,0,608,439,169,0,232,171,61,0
KHUSHAB,DISTRICT,30 - 34,MARRIED,88736,48073,40663,0,63546,34271,29275,0,25190,13802,11388,0
KHUSHAB,DISTRICT,30 - 34,NEVER MARRIED,15711,5574,10129,8,11288,4074,7213,1,4423,1500,2916,7
KHUSHAB,DISTRICT,30 - 34,SEPERATION,372,217,155,0,281,162,119,0,91,55,36,0
KHUSHAB,DISTRICT,30 - 34,WIDOWED,721,521,200,0,513,368,145,0,208,153,55,0
KHUSHAB,DISTRICT,35 - 39,DIVORCED,939,665,274,0,666,476,190,0,273,189,84,0
KHUSHAB,DISTRICT,35 - 39,MARRIED,85049,43902,41147,0,60529,31311,29218,0,24520,12591,11929,0
KHUSHAB,DISTRICT,35 - 39,NEVER MARRIED,7355,2768,4582,5,5326,2085,3239,2,2029,683,1343,3
KHUSHAB,DISTRICT,35 - 39,SEPERATION,361,207,154,0,270,162,108,0,91,45,46,0
KHUSHAB,DISTRICT,35 - 39,WIDOWED,1244,925,319,0,877,640,237,0,367,285,82,0
KHUSHAB,DISTRICT,40 - 44,DIVORCED,892,677,215,0,662,507,155,0,230,170,60,0
KHUSHAB,DISTRICT,40 - 44,MARRIED,78663,39212,39451,0,56736,28291,28445,0,21927,10921,11006,0
KHUSHAB,DISTRICT,40 - 44,NEVER MARRIED,4333,1841,2489,3,3262,1429,1831,2,1071,412,658,1
KHUSHAB,DISTRICT,40 - 44,SEPERATION,394,238,156,0,320,197,123,0,74,41,33,0
KHUSHAB,DISTRICT,40 - 44,WIDOWED,2144,1736,408,0,1526,1215,311,0,618,521,97,0
KHUSHAB,DISTRICT,45 - 49,DIVORCED,745,541,204,0,566,416,150,0,179,125,54,0
KHUSHAB,DISTRICT,45 - 49,MARRIED,60244,29015,31229,0,43216,20925,22291,0,17028,8090,8938,0
KHUSHAB,DISTRICT,45 - 49,NEVER MARRIED,2617,1164,1449,4,2037,958,1077,2,580,206,372,2
KHUSHAB,DISTRICT,45 - 49,SEPERATION,344,197,147,0,277,164,113,0,67,33,34,0
KHUSHAB,DISTRICT,45 - 49,WIDOWED,2894,2319,575,0,2043,1614,429,0,851,705,146,0
KHUSHAB,DISTRICT,50 - 54,DIVORCED,627,481,146,0,479,375,104,0,148,106,42,0
KHUSHAB,DISTRICT,50 - 54,MARRIED,53553,25129,28424,0,38721,18317,20404,0,14832,6812,8020,0
KHUSHAB,DISTRICT,50 - 54,NEVER MARRIED,1899,961,936,2,1490,777,712,1,409,184,224,1
KHUSHAB,DISTRICT,50 - 54,SEPERATION,338,221,117,0,271,179,92,0,67,42,25,0
KHUSHAB,DISTRICT,50 - 54,WIDOWED,4451,3568,883,0,3127,2494,633,0,1324,1074,250,0
KHUSHAB,DISTRICT,55 - 59,DIVORCED,533,384,149,0,432,312,120,0,101,72,29,0
KHUSHAB,DISTRICT,55 - 59,MARRIED,45239,19577,25662,0,32932,14272,18660,0,12307,5305,7002,0
KHUSHAB,DISTRICT,55 - 59,NEVER MARRIED,1492,785,707,0,1174,633,541,0,318,152,166,0
KHUSHAB,DISTRICT,55 - 59,SEPERATION,288,166,122,0,232,136,96,0,56,30,26,0
KHUSHAB,DISTRICT,55 - 59,WIDOWED,5606,4359,1247,0,3984,3061,923,0,1622,1298,324,0
KHUSHAB,DISTRICT,60 - 64,DIVORCED,353,267,86,0,267,205,62,0,86,62,24,0
KHUSHAB,DISTRICT,60 - 64,MARRIED,33379,13430,19949,0,24423,9951,14472,0,8956,3479,5477,0
KHUSHAB,DISTRICT,60 - 64,NEVER MARRIED,1065,622,442,1,831,505,325,1,234,117,117,0
KHUSHAB,DISTRICT,60 - 64,SEPERATION,234,130,104,0,190,107,83,0,44,23,21,0
KHUSHAB,DISTRICT,60 - 64,WIDOWED,6404,4735,1669,0,4585,3347,1238,0,1819,1388,431,0
KHUSHAB,DISTRICT,65 - 69,DIVORCED,227,172,55,0,167,125,42,0,60,47,13,0
KHUSHAB,DISTRICT,65 - 69,MARRIED,22792,9227,13565,0,16808,6851,9957,0,5984,2376,3608,0
KHUSHAB,DISTRICT,65 - 69,NEVER MARRIED,715,421,294,0,555,335,220,0,160,86,74,0
KHUSHAB,DISTRICT,65 - 69,SEPERATION,131,74,57,0,108,62,46,0,23,12,11,0
KHUSHAB,DISTRICT,65 - 69,WIDOWED,6899,5094,1805,0,5017,3664,1353,0,1882,1430,452,0
KHUSHAB,DISTRICT,70 - 74,DIVORCED,133,97,36,0,112,82,30,0,21,15,6,0
KHUSHAB,DISTRICT,70 - 74,MARRIED,14739,5026,9713,0,11275,3898,7377,0,3464,1128,2336,0
KHUSHAB,DISTRICT,70 - 74,NEVER MARRIED,443,228,215,0,357,180,177,0,86,48,38,0
KHUSHAB,DISTRICT,70 - 74,SEPERATION,87,43,44,0,69,39,30,0,18,4,14,0
KHUSHAB,DISTRICT,70 - 74,WIDOWED,6823,4726,2097,0,5139,3537,1602,0,1684,1189,495,0
KHUSHAB,DISTRICT,75 & ABOVE,DIVORCED,97,67,30,0,75,52,23,0,22,15,7,0
KHUSHAB,DISTRICT,75 & ABOVE,MARRIED,13396,4074,9322,0,10397,3161,7236,0,2999,913,2086,0
KHUSHAB,DISTRICT,75 & ABOVE,NEVER MARRIED,364,198,166,0,298,159,139,0,66,39,27,0
KHUSHAB,DISTRICT,75 & ABOVE,SEPERATION,69,26,43,0,62,25,37,0,7,1,6,0
KHUSHAB,DISTRICT,75 & ABOVE,WIDOWED,11346,7334,4012,0,8706,5578,3128,0,2640,1756,884,0
LAHORE,DISTRICT,15 &  ABOVE,DIVORCED,32171,20497,11674,0,0,0,0,0,32171,20497,11674,0
LAHORE,DISTRICT,15 &  ABOVE,MARRIED,5278345,2568830,2709515,0,0,0,0,0,5278345,2568830,2709515,0
LAHORE,DISTRICT,15 &  ABOVE,NEVER MARRIED,2709923,1069873,1636768,3282,0,0,0,0,2709923,1069873,1636768,3282
LAHORE,DISTRICT,15 &  ABOVE,SEPERATION,11877,6086,5791,0,0,0,0,0,11877,6086,5791,0
LAHORE,DISTRICT,15 &  ABOVE,WIDOWED,295912,208578,87334,0,0,0,0,0,295912,208578,87334,0
LAHORE,DISTRICT,15 - 19,DIVORCED,330,261,69,0,0,0,0,0,330,261,69,0
LAHORE,DISTRICT,15 - 19,MARRIED,51934,37122,14812,0,0,0,0,0,51934,37122,14812,0
LAHORE,DISTRICT,15 - 19,NEVER MARRIED,1197694,543038,654373,283,0,0,0,0,1197694,543038,654373,283
LAHORE,DISTRICT,15 - 19,SEPERATION,164,101,63,0,0,0,0,0,164,101,63,0
LAHORE,DISTRICT,15 - 19,WIDOWED,218,123,95,0,0,0,0,0,218,123,95,0
LAHORE,DISTRICT,20 - 24,DIVORCED,2057,1554,503,0,0,0,0,0,2057,1554,503,0
LAHORE,DISTRICT,20 - 24,MARRIED,339246,232322,106924,0,0,0,0,0,339246,232322,106924,0
LAHORE,DISTRICT,20 - 24,NEVER MARRIED,844629,327286,516803,540,0,0,0,0,844629,327286,516803,540
LAHORE,DISTRICT,20 - 24,SEPERATION,691,411,280,0,0,0,0,0,691,411,280,0
LAHORE,DISTRICT,20 - 24,WIDOWED,1066,666,400,0,0,0,0,0,1066,666,400,0
LAHORE,DISTRICT,25 - 29,DIVORCED,4398,3049,1349,0,0,0,0,0,4398,3049,1349,0
LAHORE,DISTRICT,25 - 29,MARRIED,706524,408150,298374,0,0,0,0,0,706524,408150,298374,0
LAHORE,DISTRICT,25 - 29,NEVER MARRIED,399777,122313,276749,715,0,0,0,0,399777,122313,276749,715
LAHORE,DISTRICT,25 - 29,SEPERATION,1367,768,599,0,0,0,0,0,1367,768,599,0
LAHORE,DISTRICT,25 - 29,WIDOWED,2919,1813,1106,0,0,0,0,0,2919,1813,1106,0
LAHORE,DISTRICT,30 - 34,DIVORCED,5599,3680,1919,0,0,0,0,0,5599,3680,1919,0
LAHORE,DISTRICT,30 - 34,MARRIED,818880,424095,394785,0,0,0,0,0,818880,424095,394785,0
LAHORE,DISTRICT,30 - 34,NEVER MARRIED,131108,36422,94174,512,0,0,0,0,131108,36422,94174,512
LAHORE,DISTRICT,30 - 34,SEPERATION,1662,905,757,0,0,0,0,0,1662,905,757,0
LAHORE,DISTRICT,30 - 34,WIDOWED,5437,3654,1783,0,0,0,0,0,5437,3654,1783,0
LAHORE,DISTRICT,35 - 39,DIVORCED,5814,3670,2144,0,0,0,0,0,5814,3670,2144,0
LAHORE,DISTRICT,35 - 39,MARRIED,815984,392330,423654,0,0,0,0,0,815984,392330,423654,0
LAHORE,DISTRICT,35 - 39,NEVER MARRIED,64160,17798,45823,539,0,0,0,0,64160,17798,45823,539
LAHORE,DISTRICT,35 - 39,SEPERATION,2009,987,1022,0,0,0,0,0,2009,987,1022,0
LAHORE,DISTRICT,35 - 39,WIDOWED,9815,7068,2747,0,0,0,0,0,9815,7068,2747,0
LAHORE,DISTRICT,40 - 44,DIVORCED,4838,3025,1813,0,0,0,0,0,4838,3025,1813,0
LAHORE,DISTRICT,40 - 44,MARRIED,679074,313211,365863,0,0,0,0,0,679074,313211,365863,0
LAHORE,DISTRICT,40 - 44,NEVER MARRIED,28876,8762,19839,275,0,0,0,0,28876,8762,19839,275
LAHORE,DISTRICT,40 - 44,SEPERATION,1576,824,752,0,0,0,0,0,1576,824,752,0
LAHORE,DISTRICT,40 - 44,WIDOWED,15492,11804,3688,0,0,0,0,0,15492,11804,3688,0
LAHORE,DISTRICT,45 - 49,DIVORCED,3477,2081,1396,0,0,0,0,0,3477,2081,1396,0
LAHORE,DISTRICT,45 - 49,MARRIED,558689,245816,312873,0,0,0,0,0,558689,245816,312873,0
LAHORE,DISTRICT,45 - 49,NEVER MARRIED,17927,5264,12501,162,0,0,0,0,17927,5264,12501,162
LAHORE,DISTRICT,45 - 49,SEPERATION,1475,714,761,0,0,0,0,0,1475,714,761,0
LAHORE,DISTRICT,45 - 49,WIDOWED,22583,17517,5066,0,0,0,0,0,22583,17517,5066,0
LAHORE,DISTRICT,50 - 54,DIVORCED,2233,1309,924,0,0,0,0,0,2233,1309,924,0
LAHORE,DISTRICT,50 - 54,MARRIED,420151,180317,239834,0,0,0,0,0,420151,180317,239834,0
LAHORE,DISTRICT,50 - 54,NEVER MARRIED,9775,3266,6395,114,0,0,0,0,9775,3266,6395,114
LAHORE,DISTRICT,50 - 54,SEPERATION,1060,509,551,0,0,0,0,0,1060,509,551,0
LAHORE,DISTRICT,50 - 54,WIDOWED,32432,25013,7419,0,0,0,0,0,32432,25013,7419,0
LAHORE,DISTRICT,55 - 59,DIVORCED,1521,832,689,0,0,0,0,0,1521,832,689,0
LAHORE,DISTRICT,55 - 59,MARRIED,318167,134241,183926,0,0,0,0,0,318167,134241,183926,0
LAHORE,DISTRICT,55 - 59,NEVER MARRIED,6642,2246,4327,69,0,0,0,0,6642,2246,4327,69
LAHORE,DISTRICT,55 - 59,SEPERATION,718,345,373,0,0,0,0,0,718,345,373,0
LAHORE,DISTRICT,55 - 59,WIDOWED,37318,28132,9186,0,0,0,0,0,37318,28132,9186,0
LAHORE,DISTRICT,60 - 64,DIVORCED,880,506,374,0,0,0,0,0,880,506,374,0
LAHORE,DISTRICT,60 - 64,MARRIED,248509,95809,152700,0,0,0,0,0,248509,95809,152700,0
LAHORE,DISTRICT,60 - 64,NEVER MARRIED,4286,1490,2761,35,0,0,0,0,4286,1490,2761,35
LAHORE,DISTRICT,60 - 64,SEPERATION,542,274,268,0,0,0,0,0,542,274,268,0
LAHORE,DISTRICT,60 - 64,WIDOWED,46179,33724,12455,0,0,0,0,0,46179,33724,12455,0
LAHORE,DISTRICT,65 - 69,DIVORCED,570,309,261,0,0,0,0,0,570,309,261,0
LAHORE,DISTRICT,65 - 69,MARRIED,159951,59750,100201,0,0,0,0,0,159951,59750,100201,0
LAHORE,DISTRICT,65 - 69,NEVER MARRIED,2663,1028,1616,19,0,0,0,0,2663,1028,1616,19
LAHORE,DISTRICT,65 - 69,SEPERATION,306,147,159,0,0,0,0,0,306,147,159,0
LAHORE,DISTRICT,65 - 69,WIDOWED,42566,29975,12591,0,0,0,0,0,42566,29975,12591,0
LAHORE,DISTRICT,70 - 74,DIVORCED,237,112,125,0,0,0,0,0,237,112,125,0
LAHORE,DISTRICT,70 - 74,MARRIED,88201,25078,63123,0,0,0,0,0,88201,25078,63123,0
LAHORE,DISTRICT,70 - 74,NEVER MARRIED,1232,473,750,9,0,0,0,0,1232,473,750,9
LAHORE,DISTRICT,70 - 74,SEPERATION,184,65,119,0,0,0,0,0,184,65,119,0
LAHORE,DISTRICT,70 - 74,WIDOWED,33379,21226,12153,0,0,0,0,0,33379,21226,12153,0
LAHORE,DISTRICT,75 & ABOVE,DIVORCED,217,109,108,0,0,0,0,0,217,109,108,0
LAHORE,DISTRICT,75 & ABOVE,MARRIED,73035,20589,52446,0,0,0,0,0,73035,20589,52446,0
LAHORE,DISTRICT,75 & ABOVE,NEVER MARRIED,1154,487,657,10,0,0,0,0,1154,487,657,10
LAHORE,DISTRICT,75 & ABOVE,SEPERATION,123,36,87,0,0,0,0,0,123,36,87,0
LAHORE,DISTRICT,75 & ABOVE,WIDOWED,46508,27863,18645,0,0,0,0,0,46508,27863,18645,0
LAYYAH,DISTRICT,15 &  ABOVE,DIVORCED,3347,2325,1022,0,2521,1747,774,0,826,578,248,0
LAYYAH,DISTRICT,15 &  ABOVE,MARRIED,836661,421310,415351,0,678794,341826,336968,0,157867,79484,78383,0
LAYYAH,DISTRICT,15 &  ABOVE,NEVER MARRIED,358245,148094,210062,89,283446,116129,167282,35,74799,31965,42780,54
LAYYAH,DISTRICT,15 &  ABOVE,SEPERATION,1506,858,648,0,1215,683,532,0,291,175,116,0
LAYYAH,DISTRICT,15 &  ABOVE,WIDOWED,43115,31769,11346,0,33767,24709,9058,0,9348,7060,2288,0
LAYYAH,DISTRICT,15 - 19,DIVORCED,58,43,15,0,49,36,13,0,9,7,2,0
LAYYAH,DISTRICT,15 - 19,MARRIED,18683,13505,5178,0,16401,11822,4579,0,2282,1683,599,0
LAYYAH,DISTRICT,15 - 19,NEVER MARRIED,191795,87461,104330,4,156259,70870,85388,1,35536,16591,18942,3
LAYYAH,DISTRICT,15 - 19,SEPERATION,32,25,7,0,27,23,4,0,5,2,3,0
LAYYAH,DISTRICT,15 - 19,WIDOWED,34,18,16,0,29,16,13,0,5,2,3,0
LAYYAH,DISTRICT,20 - 24,DIVORCED,290,213,77,0,219,156,63,0,71,57,14,0
LAYYAH,DISTRICT,20 - 24,MARRIED,73620,46931,26689,0,63044,39774,23270,0,10576,7157,3419,0
LAYYAH,DISTRICT,20 - 24,NEVER MARRIED,102228,39230,62983,15,79455,29688,49762,5,22773,9542,13221,10
LAYYAH,DISTRICT,20 - 24,SEPERATION,109,67,42,0,92,55,37,0,17,12,5,0
LAYYAH,DISTRICT,20 - 24,WIDOWED,193,104,89,0,163,86,77,0,30,18,12,0
LAYYAH,DISTRICT,25 - 29,DIVORCED,452,288,164,0,353,225,128,0,99,63,36,0
LAYYAH,DISTRICT,25 - 29,MARRIED,116993,64750,52243,0,97070,53139,43931,0,19923,11611,8312,0
LAYYAH,DISTRICT,25 - 29,NEVER MARRIED,40257,13205,27030,22,30109,9499,20602,8,10148,3706,6428,14
LAYYAH,DISTRICT,25 - 29,SEPERATION,163,73,90,0,135,59,76,0,28,14,14,0
LAYYAH,DISTRICT,25 - 29,WIDOWED,447,263,184,0,357,215,142,0,90,48,42,0
LAYYAH,DISTRICT,30 - 34,DIVORCED,510,347,163,0,377,254,123,0,133,93,40,0
LAYYAH,DISTRICT,30 - 34,MARRIED,127161,65407,61754,0,103035,52603,50432,0,24126,12804,11322,0
LAYYAH,DISTRICT,30 - 34,NEVER MARRIED,12453,3779,8664,10,9137,2743,6389,5,3316,1036,2275,5
LAYYAH,DISTRICT,30 - 34,SEPERATION,215,108,107,0,180,89,91,0,35,19,16,0
LAYYAH,DISTRICT,30 - 34,WIDOWED,754,527,227,0,604,413,191,0,150,114,36,0
LAYYAH,DISTRICT,35 - 39,DIVORCED,427,298,129,0,310,214,96,0,117,84,33,0
LAYYAH,DISTRICT,35 - 39,MARRIED,109197,54735,54462,0,86826,43413,43413,0,22371,11322,11049,0
LAYYAH,DISTRICT,35 - 39,NEVER MARRIED,4689,1604,3077,8,3405,1193,2210,2,1284,411,867,6
LAYYAH,DISTRICT,35 - 39,SEPERATION,182,102,80,0,139,80,59,0,43,22,21,0
LAYYAH,DISTRICT,35 - 39,WIDOWED,1211,919,292,0,924,694,230,0,287,225,62,0
LAYYAH,DISTRICT,40 - 44,DIVORCED,486,347,139,0,354,245,109,0,132,102,30,0
LAYYAH,DISTRICT,40 - 44,MARRIED,108864,54213,54651,0,87711,43768,43943,0,21153,10445,10708,0
LAYYAH,DISTRICT,40 - 44,NEVER MARRIED,2594,1032,1548,14,1904,790,1106,8,690,242,442,6
LAYYAH,DISTRICT,40 - 44,SEPERATION,199,128,71,0,165,106,59,0,34,22,12,0
LAYYAH,DISTRICT,40 - 44,WIDOWED,2278,1853,425,0,1785,1445,340,0,493,408,85,0
LAYYAH,DISTRICT,45 - 49,DIVORCED,343,251,92,0,258,190,68,0,85,61,24,0
LAYYAH,DISTRICT,45 - 49,MARRIED,75089,35583,39506,0,59217,28109,31108,0,15872,7474,8398,0
LAYYAH,DISTRICT,45 - 49,NEVER MARRIED,1499,606,888,5,1110,465,643,2,389,141,245,3
LAYYAH,DISTRICT,45 - 49,SEPERATION,154,96,58,0,121,75,46,0,33,21,12,0
LAYYAH,DISTRICT,45 - 49,WIDOWED,2826,2342,484,0,2192,1810,382,0,634,532,102,0
LAYYAH,DISTRICT,50 - 54,DIVORCED,278,203,75,0,220,167,53,0,58,36,22,0
LAYYAH,DISTRICT,50 - 54,MARRIED,66714,30962,35752,0,53301,24843,28458,0,13413,6119,7294,0
LAYYAH,DISTRICT,50 - 54,NEVER MARRIED,1004,437,562,5,742,328,412,2,262,109,150,3
LAYYAH,DISTRICT,50 - 54,SEPERATION,159,99,60,0,123,75,48,0,36,24,12,0
LAYYAH,DISTRICT,50 - 54,WIDOWED,4289,3517,772,0,3307,2686,621,0,982,831,151,0
LAYYAH,DISTRICT,55 - 59,DIVORCED,219,141,78,0,166,108,58,0,53,33,20,0
LAYYAH,DISTRICT,55 - 59,MARRIED,52381,21677,30704,0,41543,17246,24297,0,10838,4431,6407,0
LAYYAH,DISTRICT,55 - 59,NEVER MARRIED,693,286,404,3,527,217,309,1,166,69,95,2
LAYYAH,DISTRICT,55 - 59,SEPERATION,115,69,46,0,89,50,39,0,26,19,7,0
LAYYAH,DISTRICT,55 - 59,WIDOWED,4910,3828,1082,0,3801,2944,857,0,1109,884,225,0
LAYYAH,DISTRICT,60 - 64,DIVORCED,140,103,37,0,104,80,24,0,36,23,13,0
LAYYAH,DISTRICT,60 - 64,MARRIED,35599,14184,21415,0,28073,11241,16832,0,7526,2943,4583,0
LAYYAH,DISTRICT,60 - 64,NEVER MARRIED,487,226,259,2,360,163,196,1,127,63,63,1
LAYYAH,DISTRICT,60 - 64,SEPERATION,82,51,31,0,69,41,28,0,13,10,3,0
LAYYAH,DISTRICT,60 - 64,WIDOWED,5456,4111,1345,0,4173,3100,1073,0,1283,1011,272,0
LAYYAH,DISTRICT,65 - 69,DIVORCED,77,53,24,0,60,43,17,0,17,10,7,0
LAYYAH,DISTRICT,65 - 69,MARRIED,23519,9749,13770,0,18798,7905,10893,0,4721,1844,2877,0
LAYYAH,DISTRICT,65 - 69,NEVER MARRIED,239,119,120,0,187,89,98,0,52,30,22,0
LAYYAH,DISTRICT,65 - 69,SEPERATION,47,21,26,0,35,13,22,0,12,8,4,0
LAYYAH,DISTRICT,65 - 69,WIDOWED,5662,4136,1526,0,4354,3158,1196,0,1308,978,330,0
LAYYAH,DISTRICT,70 - 74,DIVORCED,35,20,15,0,30,18,12,0,5,2,3,0
LAYYAH,DISTRICT,70 - 74,MARRIED,15457,5600,9857,0,12694,4651,8043,0,2763,949,1814,0
LAYYAH,DISTRICT,70 - 74,NEVER MARRIED,158,56,101,1,124,42,82,0,34,14,19,1
LAYYAH,DISTRICT,70 - 74,SEPERATION,21,11,10,0,19,10,9,0,2,1,1,0
LAYYAH,DISTRICT,70 - 74,WIDOWED,5983,4309,1674,0,4788,3480,1308,0,1195,829,366,0
LAYYAH,DISTRICT,75 & ABOVE,DIVORCED,32,18,14,0,21,11,10,0,11,7,4,0
LAYYAH,DISTRICT,75 & ABOVE,MARRIED,13384,4014,9370,0,11081,3312,7769,0,2303,702,1601,0
LAYYAH,DISTRICT,75 & ABOVE,NEVER MARRIED,149,53,96,0,127,42,85,0,22,11,11,0
LAYYAH,DISTRICT,75 & ABOVE,SEPERATION,28,8,20,0,21,7,14,0,7,1,6,0
LAYYAH,DISTRICT,75 & ABOVE,WIDOWED,9072,5842,3230,0,7290,4662,2628,0,1782,1180,602,0
LODHRAN,DISTRICT,15 &  ABOVE,DIVORCED,5100,3467,1633,0,4152,2839,1313,0,948,628,320,0
LODHRAN,DISTRICT,15 &  ABOVE,MARRIED,781143,395552,385591,0,651557,330057,321500,0,129586,65495,64091,0
LODHRAN,DISTRICT,15 &  ABOVE,NEVER MARRIED,311001,121933,188953,115,250396,97270,153077,49,60605,24663,35876,66
LODHRAN,DISTRICT,15 &  ABOVE,SEPERATION,2600,1431,1169,0,2169,1178,991,0,431,253,178,0
LODHRAN,DISTRICT,15 &  ABOVE,WIDOWED,50159,36669,13490,0,40970,29761,11209,0,9189,6908,2281,0
LODHRAN,DISTRICT,15 - 19,DIVORCED,103,82,21,0,84,65,19,0,19,17,2,0
LODHRAN,DISTRICT,15 - 19,MARRIED,20932,15270,5662,0,18267,13265,5002,0,2665,2005,660,0
LODHRAN,DISTRICT,15 - 19,NEVER MARRIED,172295,76334,95957,4,141150,62208,78940,2,31145,14126,17017,2
LODHRAN,DISTRICT,15 - 19,SEPERATION,61,42,19,0,57,39,18,0,4,3,1,0
LODHRAN,DISTRICT,15 - 19,WIDOWED,64,34,30,0,55,28,27,0,9,6,3,0
LODHRAN,DISTRICT,20 - 24,DIVORCED,461,339,122,0,394,289,105,0,67,50,17,0
LODHRAN,DISTRICT,20 - 24,MARRIED,75122,48321,26801,0,64437,41033,23404,0,10685,7288,3397,0
LODHRAN,DISTRICT,20 - 24,NEVER MARRIED,84162,29190,54955,17,66839,22562,44272,5,17323,6628,10683,12
LODHRAN,DISTRICT,20 - 24,SEPERATION,221,128,93,0,184,107,77,0,37,21,16,0
LODHRAN,DISTRICT,20 - 24,WIDOWED,281,161,120,0,253,143,110,0,28,18,10,0
LODHRAN,DISTRICT,25 - 29,DIVORCED,679,467,212,0,559,375,184,0,120,92,28,0
LODHRAN,DISTRICT,25 - 29,MARRIED,107615,60085,47530,0,90312,49958,40354,0,17303,10127,7176,0
LODHRAN,DISTRICT,25 - 29,NEVER MARRIED,32902,9728,23151,23,25565,7295,18262,8,7337,2433,4889,15
LODHRAN,DISTRICT,25 - 29,SEPERATION,330,165,165,0,284,134,150,0,46,31,15,0
LODHRAN,DISTRICT,25 - 29,WIDOWED,627,354,273,0,548,299,249,0,79,55,24,0
LODHRAN,DISTRICT,30 - 34,DIVORCED,775,504,271,0,610,396,214,0,165,108,57,0
LODHRAN,DISTRICT,30 - 34,MARRIED,110570,57742,52828,0,90993,47418,43575,0,19577,10324,9253,0
LODHRAN,DISTRICT,30 - 34,NEVER MARRIED,10834,3030,7788,16,8316,2294,6013,9,2518,736,1775,7
LODHRAN,DISTRICT,30 - 34,SEPERATION,369,207,162,0,304,172,132,0,65,35,30,0
LODHRAN,DISTRICT,30 - 34,WIDOWED,962,658,304,0,797,531,266,0,165,127,38,0
LODHRAN,DISTRICT,35 - 39,DIVORCED,770,506,264,0,600,398,202,0,170,108,62,0
LODHRAN,DISTRICT,35 - 39,MARRIED,104101,52258,51843,0,85168,42789,42379,0,18933,9469,9464,0
LODHRAN,DISTRICT,35 - 39,NEVER MARRIED,4764,1392,3358,14,3728,1093,2628,7,1036,299,730,7
LODHRAN,DISTRICT,35 - 39,SEPERATION,339,179,160,0,280,138,142,0,59,41,18,0
LODHRAN,DISTRICT,35 - 39,WIDOWED,1615,1141,474,0,1316,919,397,0,299,222,77,0
LODHRAN,DISTRICT,40 - 44,DIVORCED,732,487,245,0,583,395,188,0,149,92,57,0
LODHRAN,DISTRICT,40 - 44,MARRIED,102888,49452,53436,0,85246,41069,44177,0,17642,8383,9259,0
LODHRAN,DISTRICT,40 - 44,NEVER MARRIED,2573,906,1653,14,2016,710,1300,6,557,196,353,8
LODHRAN,DISTRICT,40 - 44,SEPERATION,348,203,145,0,286,167,119,0,62,36,26,0
LODHRAN,DISTRICT,40 - 44,WIDOWED,2942,2296,646,0,2421,1886,535,0,521,410,111,0
LODHRAN,DISTRICT,45 - 49,DIVORCED,496,355,141,0,402,294,108,0,94,61,33,0
LODHRAN,DISTRICT,45 - 49,MARRIED,74989,34775,40214,0,61966,28873,33093,0,13023,5902,7121,0
LODHRAN,DISTRICT,45 - 49,NEVER MARRIED,1438,538,892,8,1112,415,694,3,326,123,198,5
LODHRAN,DISTRICT,45 - 49,SEPERATION,285,162,123,0,240,133,107,0,45,29,16,0
LODHRAN,DISTRICT,45 - 49,WIDOWED,3806,2917,889,0,3123,2361,762,0,683,556,127,0
LODHRAN,DISTRICT,50 - 54,DIVORCED,429,281,148,0,360,238,122,0,69,43,26,0
LODHRAN,DISTRICT,50 - 54,MARRIED,60140,27569,32571,0,49999,23130,26869,0,10141,4439,5702,0
LODHRAN,DISTRICT,50 - 54,NEVER MARRIED,851,340,502,9,683,296,385,2,168,44,117,7
LODHRAN,DISTRICT,50 - 54,SEPERATION,219,129,90,0,179,106,73,0,40,23,17,0
LODHRAN,DISTRICT,50 - 54,WIDOWED,5250,4176,1074,0,4263,3384,879,0,987,792,195,0
LODHRAN,DISTRICT,55 - 59,DIVORCED,265,187,78,0,222,163,59,0,43,24,19,0
LODHRAN,DISTRICT,55 - 59,MARRIED,45588,19241,26347,0,37851,16076,21775,0,7737,3165,4572,0
LODHRAN,DISTRICT,55 - 59,NEVER MARRIED,504,201,300,3,419,169,249,1,85,32,51,2
LODHRAN,DISTRICT,55 - 59,SEPERATION,176,87,89,0,142,73,69,0,34,14,20,0
LODHRAN,DISTRICT,55 - 59,WIDOWED,5913,4535,1378,0,4693,3591,1102,0,1220,944,276,0
LODHRAN,DISTRICT,60 - 64,DIVORCED,183,124,59,0,158,109,49,0,25,15,10,0
LODHRAN,DISTRICT,60 - 64,MARRIED,32058,13350,18708,0,26904,11352,15552,0,5154,1998,3156,0
LODHRAN,DISTRICT,60 - 64,NEVER MARRIED,313,134,174,5,256,111,141,4,57,23,33,1
LODHRAN,DISTRICT,60 - 64,SEPERATION,107,56,51,0,89,48,41,0,18,8,10,0
LODHRAN,DISTRICT,60 - 64,WIDOWED,6682,5044,1638,0,5383,4074,1309,0,1299,970,329,0
LODHRAN,DISTRICT,65 - 69,DIVORCED,100,73,27,0,91,66,25,0,9,7,2,0
LODHRAN,DISTRICT,65 - 69,MARRIED,22220,9362,12858,0,18786,7962,10824,0,3434,1400,2034,0
LODHRAN,DISTRICT,65 - 69,NEVER MARRIED,176,80,94,2,153,70,81,2,23,10,13,0
LODHRAN,DISTRICT,65 - 69,SEPERATION,66,40,26,0,54,31,23,0,12,9,3,0
LODHRAN,DISTRICT,65 - 69,WIDOWED,6960,5239,1721,0,5619,4206,1413,0,1341,1033,308,0
LODHRAN,DISTRICT,70 - 74,DIVORCED,64,34,30,0,52,28,24,0,12,6,6,0
LODHRAN,DISTRICT,70 - 74,MARRIED,13439,4564,8875,0,11573,3988,7585,0,1866,576,1290,0
LODHRAN,DISTRICT,70 - 74,NEVER MARRIED,90,30,60,0,73,22,51,0,17,8,9,0
LODHRAN,DISTRICT,70 - 74,SEPERATION,46,24,22,0,40,21,19,0,6,3,3,0
LODHRAN,DISTRICT,70 - 74,WIDOWED,6359,4486,1873,0,5230,3661,1569,0,1129,825,304,0
LODHRAN,DISTRICT,75 & ABOVE,DIVORCED,43,28,15,0,37,23,14,0,6,5,1,0
LODHRAN,DISTRICT,75 & ABOVE,MARRIED,11481,3563,7918,0,10055,3144,6911,0,1426,419,1007,0
LODHRAN,DISTRICT,75 & ABOVE,NEVER MARRIED,99,30,69,0,86,25,61,0,13,5,8,0
LODHRAN,DISTRICT,75 & ABOVE,SEPERATION,33,9,24,0,30,9,21,0,3,0,3,0
LODHRAN,DISTRICT,75 & ABOVE,WIDOWED,8698,5628,3070,0,7269,4678,2591,0,1429,950,479,0
MANDI BAHAUDDIN,DISTRICT,15 &  ABOVE,DIVORCED,5487,3735,1752,0,4244,2857,1387,0,1243,878,365,0
MANDI BAHAUDDIN,DISTRICT,15 &  ABOVE,MARRIED,747615,391932,355683,0,610126,320413,289713,0,137489,71519,65970,0
MANDI BAHAUDDIN,DISTRICT,15 &  ABOVE,NEVER MARRIED,353529,156392,197000,137,282787,125384,157323,80,70742,31008,39677,57
MANDI BAHAUDDIN,DISTRICT,15 &  ABOVE,SEPERATION,2062,1052,1010,0,1686,830,856,0,376,222,154,0
MANDI BAHAUDDIN,DISTRICT,15 &  ABOVE,WIDOWED,58185,39088,19097,0,47110,31024,16086,0,11075,8064,3011,0
MANDI BAHAUDDIN,DISTRICT,15 - 19,DIVORCED,58,50,8,0,48,42,6,0,10,8,2,0
MANDI BAHAUDDIN,DISTRICT,15 - 19,MARRIED,9018,6424,2594,0,7596,5406,2190,0,1422,1018,404,0
MANDI BAHAUDDIN,DISTRICT,15 - 19,NEVER MARRIED,167944,80111,87824,9,135854,64698,71148,8,32090,15413,16676,1
MANDI BAHAUDDIN,DISTRICT,15 - 19,SEPERATION,47,25,22,0,39,20,19,0,8,5,3,0
MANDI BAHAUDDIN,DISTRICT,15 - 19,WIDOWED,35,19,16,0,33,17,16,0,2,2,0,0
MANDI BAHAUDDIN,DISTRICT,20 - 24,DIVORCED,348,265,83,0,271,204,67,0,77,61,16,0
MANDI BAHAUDDIN,DISTRICT,20 - 24,MARRIED,44921,31427,13494,0,37409,26027,11382,0,7512,5400,2112,0
MANDI BAHAUDDIN,DISTRICT,20 - 24,NEVER MARRIED,107387,48334,59019,34,85712,38793,46896,23,21675,9541,12123,11
MANDI BAHAUDDIN,DISTRICT,20 - 24,SEPERATION,97,59,38,0,85,55,30,0,12,4,8,0
MANDI BAHAUDDIN,DISTRICT,20 - 24,WIDOWED,227,144,83,0,191,123,68,0,36,21,15,0
MANDI BAHAUDDIN,DISTRICT,25 - 29,DIVORCED,683,508,175,0,504,375,129,0,179,133,46,0
MANDI BAHAUDDIN,DISTRICT,25 - 29,MARRIED,88847,56549,32298,0,72357,46069,26288,0,16490,10480,6010,0
MANDI BAHAUDDIN,DISTRICT,25 - 29,NEVER MARRIED,46754,18356,28366,32,36587,14472,22098,17,10167,3884,6268,15
MANDI BAHAUDDIN,DISTRICT,25 - 29,SEPERATION,186,107,79,0,144,78,66,0,42,29,13,0
MANDI BAHAUDDIN,DISTRICT,25 - 29,WIDOWED,496,292,204,0,425,245,180,0,71,47,24,0
MANDI BAHAUDDIN,DISTRICT,30 - 34,DIVORCED,823,578,245,0,609,418,191,0,214,160,54,0
MANDI BAHAUDDIN,DISTRICT,30 - 34,MARRIED,108079,62299,45780,0,86985,50406,36579,0,21094,11893,9201,0
MANDI BAHAUDDIN,DISTRICT,30 - 34,NEVER MARRIED,15496,4597,10884,15,11864,3479,8377,8,3632,1118,2507,7
MANDI BAHAUDDIN,DISTRICT,30 - 34,SEPERATION,243,131,112,0,191,104,87,0,52,27,25,0
MANDI BAHAUDDIN,DISTRICT,30 - 34,WIDOWED,941,628,313,0,751,496,255,0,190,132,58,0
MANDI BAHAUDDIN,DISTRICT,35 - 39,DIVORCED,860,556,304,0,637,409,228,0,223,147,76,0
MANDI BAHAUDDIN,DISTRICT,35 - 39,MARRIED,104546,56385,48161,0,83816,45362,38454,0,20730,11023,9707,0
MANDI BAHAUDDIN,DISTRICT,35 - 39,NEVER MARRIED,6404,1881,4508,15,4993,1440,3543,10,1411,441,965,5
MANDI BAHAUDDIN,DISTRICT,35 - 39,SEPERATION,276,140,136,0,216,103,113,0,60,37,23,0
MANDI BAHAUDDIN,DISTRICT,35 - 39,WIDOWED,1661,1182,479,0,1372,945,427,0,289,237,52,0
MANDI BAHAUDDIN,DISTRICT,40 - 44,DIVORCED,775,528,247,0,590,399,191,0,185,129,56,0
MANDI BAHAUDDIN,DISTRICT,40 - 44,MARRIED,93309,48389,44920,0,75109,39088,36021,0,18200,9301,8899,0
MANDI BAHAUDDIN,DISTRICT,40 - 44,NEVER MARRIED,3110,991,2111,8,2435,778,1655,2,675,213,456,6
MANDI BAHAUDDIN,DISTRICT,40 - 44,SEPERATION,273,150,123,0,211,112,99,0,62,38,24,0
MANDI BAHAUDDIN,DISTRICT,40 - 44,WIDOWED,2768,2125,643,0,2167,1626,541,0,601,499,102,0
MANDI BAHAUDDIN,DISTRICT,45 - 49,DIVORCED,582,406,176,0,447,311,136,0,135,95,40,0
MANDI BAHAUDDIN,DISTRICT,45 - 49,MARRIED,73923,36656,37267,0,59645,29721,29924,0,14278,6935,7343,0
MANDI BAHAUDDIN,DISTRICT,45 - 49,NEVER MARRIED,2025,648,1371,6,1610,512,1096,2,415,136,275,4
MANDI BAHAUDDIN,DISTRICT,45 - 49,SEPERATION,240,123,117,0,203,102,101,0,37,21,16,0
MANDI BAHAUDDIN,DISTRICT,45 - 49,WIDOWED,3746,2820,926,0,2942,2142,800,0,804,678,126,0
MANDI BAHAUDDIN,DISTRICT,50 - 54,DIVORCED,440,287,153,0,365,239,126,0,75,48,27,0
MANDI BAHAUDDIN,DISTRICT,50 - 54,MARRIED,65487,30717,34770,0,53429,25164,28265,0,12058,5553,6505,0
MANDI BAHAUDDIN,DISTRICT,50 - 54,NEVER MARRIED,1297,463,823,11,1045,374,665,6,252,89,158,5
MANDI BAHAUDDIN,DISTRICT,50 - 54,SEPERATION,219,99,120,0,178,74,104,0,41,25,16,0
MANDI BAHAUDDIN,DISTRICT,50 - 54,WIDOWED,5405,4076,1329,0,4250,3135,1115,0,1155,941,214,0
MANDI BAHAUDDIN,DISTRICT,55 - 59,DIVORCED,350,232,118,0,286,188,98,0,64,44,20,0
MANDI BAHAUDDIN,DISTRICT,55 - 59,MARRIED,54014,23225,30789,0,44445,19104,25341,0,9569,4121,5448,0
MANDI BAHAUDDIN,DISTRICT,55 - 59,NEVER MARRIED,997,333,663,1,808,264,543,1,189,69,120,0
MANDI BAHAUDDIN,DISTRICT,55 - 59,SEPERATION,177,82,95,0,150,68,82,0,27,14,13,0
MANDI BAHAUDDIN,DISTRICT,55 - 59,WIDOWED,6451,4692,1759,0,5047,3583,1464,0,1404,1109,295,0
MANDI BAHAUDDIN,DISTRICT,60 - 64,DIVORCED,248,151,97,0,206,128,78,0,42,23,19,0
MANDI BAHAUDDIN,DISTRICT,60 - 64,MARRIED,40728,16637,24091,0,33675,13921,19754,0,7053,2716,4337,0
MANDI BAHAUDDIN,DISTRICT,60 - 64,NEVER MARRIED,887,293,591,3,782,251,530,1,105,42,61,2
MANDI BAHAUDDIN,DISTRICT,60 - 64,SEPERATION,134,61,73,0,116,48,68,0,18,13,5,0
MANDI BAHAUDDIN,DISTRICT,60 - 64,WIDOWED,7593,5311,2282,0,5918,4066,1852,0,1675,1245,430,0
MANDI BAHAUDDIN,DISTRICT,65 - 69,DIVORCED,174,104,70,0,151,84,67,0,23,20,3,0
MANDI BAHAUDDIN,DISTRICT,65 - 69,MARRIED,29525,11452,18073,0,24802,9694,15108,0,4723,1758,2965,0
MANDI BAHAUDDIN,DISTRICT,65 - 69,NEVER MARRIED,551,180,368,3,479,144,333,2,72,36,35,1
MANDI BAHAUDDIN,DISTRICT,65 - 69,SEPERATION,80,42,38,0,67,34,33,0,13,8,5,0
MANDI BAHAUDDIN,DISTRICT,65 - 69,WIDOWED,8094,5365,2729,0,6455,4237,2218,0,1639,1128,511,0
MANDI BAHAUDDIN,DISTRICT,70 - 74,DIVORCED,68,34,34,0,62,31,31,0,6,3,3,0
MANDI BAHAUDDIN,DISTRICT,70 - 74,MARRIED,17563,5928,11635,0,15149,5213,9936,0,2414,715,1699,0
MANDI BAHAUDDIN,DISTRICT,70 - 74,NEVER MARRIED,321,104,217,0,292,91,201,0,29,13,16,0
MANDI BAHAUDDIN,DISTRICT,70 - 74,SEPERATION,50,18,32,0,48,17,31,0,2,1,1,0
MANDI BAHAUDDIN,DISTRICT,70 - 74,WIDOWED,7361,4510,2851,0,6090,3696,2394,0,1271,814,457,0
MANDI BAHAUDDIN,DISTRICT,75 & ABOVE,DIVORCED,78,36,42,0,68,29,39,0,10,7,3,0
MANDI BAHAUDDIN,DISTRICT,75 & ABOVE,MARRIED,17655,5844,11811,0,15709,5238,10471,0,1946,606,1340,0
MANDI BAHAUDDIN,DISTRICT,75 & ABOVE,NEVER MARRIED,356,101,255,0,326,88,238,0,30,13,17,0
MANDI BAHAUDDIN,DISTRICT,75 & ABOVE,SEPERATION,40,15,25,0,38,15,23,0,2,0,2,0
MANDI BAHAUDDIN,DISTRICT,75 & ABOVE,WIDOWED,13407,7924,5483,0,11469,6713,4756,0,1938,1211,727,0
MIANWALI,DISTRICT,15 &  ABOVE,DIVORCED,4791,3742,1049,0,3695,2934,761,0,1096,808,288,0
MIANWALI,DISTRICT,15 &  ABOVE,MARRIED,743182,378234,364948,0,589909,301036,288873,0,153273,77198,76075,0
MIANWALI,DISTRICT,15 &  ABOVE,NEVER MARRIED,343364,143733,199568,63,269579,112764,156791,24,73785,30969,42777,39
MIANWALI,DISTRICT,15 &  ABOVE,SEPERATION,1835,1092,743,0,1460,894,566,0,375,198,177,0
MIANWALI,DISTRICT,15 &  ABOVE,WIDOWED,49088,37674,11414,0,37933,28948,8985,0,11155,8726,2429,0
MIANWALI,DISTRICT,15 - 19,DIVORCED,56,45,11,0,48,40,8,0,8,5,3,0
MIANWALI,DISTRICT,15 - 19,MARRIED,12378,9208,3170,0,10382,7696,2686,0,1996,1512,484,0
MIANWALI,DISTRICT,15 - 19,NEVER MARRIED,162765,74115,88640,10,131266,59582,71678,6,31499,14533,16962,4
MIANWALI,DISTRICT,15 - 19,SEPERATION,27,20,7,0,24,18,6,0,3,2,1,0
MIANWALI,DISTRICT,15 - 19,WIDOWED,44,24,20,0,37,18,19,0,7,6,1,0
MIANWALI,DISTRICT,20 - 24,DIVORCED,278,226,52,0,231,184,47,0,47,42,5,0
MIANWALI,DISTRICT,20 - 24,MARRIED,54434,36417,18017,0,44847,29710,15137,0,9587,6707,2880,0
MIANWALI,DISTRICT,20 - 24,NEVER MARRIED,97696,38463,59218,15,76556,29811,46738,7,21140,8652,12480,8
MIANWALI,DISTRICT,20 - 24,SEPERATION,102,70,32,0,86,57,29,0,16,13,3,0
MIANWALI,DISTRICT,20 - 24,WIDOWED,198,121,77,0,164,102,62,0,34,19,15,0
MIANWALI,DISTRICT,25 - 29,DIVORCED,601,461,140,0,472,364,108,0,129,97,32,0
MIANWALI,DISTRICT,25 - 29,MARRIED,96222,55599,40623,0,77917,44708,33209,0,18305,10891,7414,0
MIANWALI,DISTRICT,25 - 29,NEVER MARRIED,45950,15848,30092,10,34932,11957,22975,0,11018,3891,7117,10
MIANWALI,DISTRICT,25 - 29,SEPERATION,197,106,91,0,152,81,71,0,45,25,20,0
MIANWALI,DISTRICT,25 - 29,WIDOWED,455,273,182,0,363,213,150,0,92,60,32,0
MIANWALI,DISTRICT,30 - 34,DIVORCED,699,534,165,0,531,407,124,0,168,127,41,0
MIANWALI,DISTRICT,30 - 34,MARRIED,109270,58857,50413,0,86372,46318,40054,0,22898,12539,10359,0
MIANWALI,DISTRICT,30 - 34,NEVER MARRIED,16635,5841,10790,4,12229,4333,7894,2,4406,1508,2896,2
MIANWALI,DISTRICT,30 - 34,SEPERATION,243,141,102,0,195,119,76,0,48,22,26,0
MIANWALI,DISTRICT,30 - 34,WIDOWED,775,575,200,0,612,454,158,0,163,121,42,0
MIANWALI,DISTRICT,35 - 39,DIVORCED,715,563,152,0,547,438,109,0,168,125,43,0
MIANWALI,DISTRICT,35 - 39,MARRIED,105569,53372,52197,0,82721,41838,40883,0,22848,11534,11314,0
MIANWALI,DISTRICT,35 - 39,NEVER MARRIED,7678,3022,4648,8,5529,2273,3254,2,2149,749,1394,6
MIANWALI,DISTRICT,35 - 39,SEPERATION,241,143,98,0,185,112,73,0,56,31,25,0
MIANWALI,DISTRICT,35 - 39,WIDOWED,1335,1039,296,0,1044,810,234,0,291,229,62,0
MIANWALI,DISTRICT,40 - 44,DIVORCED,624,502,122,0,484,395,89,0,140,107,33,0
MIANWALI,DISTRICT,40 - 44,MARRIED,90362,44640,45722,0,70717,35168,35549,0,19645,9472,10173,0
MIANWALI,DISTRICT,40 - 44,NEVER MARRIED,4259,1919,2336,4,3082,1436,1644,2,1177,483,692,2
MIANWALI,DISTRICT,40 - 44,SEPERATION,232,125,107,0,183,103,80,0,49,22,27,0
MIANWALI,DISTRICT,40 - 44,WIDOWED,2166,1829,337,0,1700,1430,270,0,466,399,67,0
MIANWALI,DISTRICT,45 - 49,DIVORCED,542,426,116,0,418,338,80,0,124,88,36,0
MIANWALI,DISTRICT,45 - 49,MARRIED,70577,33781,36796,0,54973,26575,28398,0,15604,7206,8398,0
MIANWALI,DISTRICT,45 - 49,NEVER MARRIED,2627,1224,1398,5,1843,899,942,2,784,325,456,3
MIANWALI,DISTRICT,45 - 49,SEPERATION,193,104,89,0,148,85,63,0,45,19,26,0
MIANWALI,DISTRICT,45 - 49,WIDOWED,2868,2414,454,0,2212,1855,357,0,656,559,97,0
MIANWALI,DISTRICT,50 - 54,DIVORCED,416,320,96,0,302,241,61,0,114,79,35,0
MIANWALI,DISTRICT,50 - 54,MARRIED,59903,28238,31665,0,47186,22503,24683,0,12717,5735,6982,0
MIANWALI,DISTRICT,50 - 54,NEVER MARRIED,1847,1020,824,3,1314,758,554,2,533,262,270,1
MIANWALI,DISTRICT,50 - 54,SEPERATION,185,113,72,0,152,95,57,0,33,18,15,0
MIANWALI,DISTRICT,50 - 54,WIDOWED,4504,3832,672,0,3439,2919,520,0,1065,913,152,0
MIANWALI,DISTRICT,55 - 59,DIVORCED,305,235,70,0,237,188,49,0,68,47,21,0
MIANWALI,DISTRICT,55 - 59,MARRIED,50596,22395,28201,0,39976,17825,22151,0,10620,4570,6050,0
MIANWALI,DISTRICT,55 - 59,NEVER MARRIED,1344,766,576,2,977,583,394,0,367,183,182,2
MIANWALI,DISTRICT,55 - 59,SEPERATION,146,96,50,0,116,80,36,0,30,16,14,0
MIANWALI,DISTRICT,55 - 59,WIDOWED,5390,4411,979,0,4079,3314,765,0,1311,1097,214,0
MIANWALI,DISTRICT,60 - 64,DIVORCED,249,190,59,0,181,145,36,0,68,45,23,0
MIANWALI,DISTRICT,60 - 64,MARRIED,38002,15539,22463,0,30153,12420,17733,0,7849,3119,4730,0
MIANWALI,DISTRICT,60 - 64,NEVER MARRIED,1055,614,440,1,784,490,294,0,271,124,146,1
MIANWALI,DISTRICT,60 - 64,SEPERATION,118,81,37,0,95,66,29,0,23,15,8,0
MIANWALI,DISTRICT,60 - 64,WIDOWED,6826,5452,1374,0,5209,4149,1060,0,1617,1303,314,0
MIANWALI,DISTRICT,65 - 69,DIVORCED,162,137,25,0,127,112,15,0,35,25,10,0
MIANWALI,DISTRICT,65 - 69,MARRIED,25723,10582,15141,0,20215,8376,11839,0,5508,2206,3302,0
MIANWALI,DISTRICT,65 - 69,NEVER MARRIED,743,469,274,0,497,315,182,0,246,154,92,0
MIANWALI,DISTRICT,65 - 69,SEPERATION,69,44,25,0,58,39,19,0,11,5,6,0
MIANWALI,DISTRICT,65 - 69,WIDOWED,6991,5446,1545,0,5218,4033,1185,0,1773,1413,360,0
MIANWALI,DISTRICT,70 - 74,DIVORCED,88,61,27,0,70,48,22,0,18,13,5,0
MIANWALI,DISTRICT,70 - 74,MARRIED,16323,5440,10883,0,13079,4459,8620,0,3244,981,2263,0
MIANWALI,DISTRICT,70 - 74,NEVER MARRIED,427,235,191,1,318,176,141,1,109,59,50,0
MIANWALI,DISTRICT,70 - 74,SEPERATION,46,30,16,0,34,22,12,0,12,8,4,0
MIANWALI,DISTRICT,70 - 74,WIDOWED,6790,4926,1864,0,5248,3792,1456,0,1542,1134,408,0
MIANWALI,DISTRICT,75 & ABOVE,DIVORCED,56,42,14,0,47,34,13,0,9,8,1,0
MIANWALI,DISTRICT,75 & ABOVE,MARRIED,13823,4166,9657,0,11371,3440,7931,0,2452,726,1726,0
MIANWALI,DISTRICT,75 & ABOVE,NEVER MARRIED,338,197,141,0,252,151,101,0,86,46,40,0
MIANWALI,DISTRICT,75 & ABOVE,SEPERATION,36,19,17,0,32,17,15,0,4,2,2,0
MIANWALI,DISTRICT,75 & ABOVE,WIDOWED,10746,7332,3414,0,8608,5859,2749,0,2138,1473,665,0
MULTAN,DISTRICT,15 &  ABOVE,DIVORCED,14058,9254,4804,0,6878,4571,2307,0,7180,4683,2497,0
MULTAN,DISTRICT,15 &  ABOVE,MARRIED,2186181,1092730,1093451,0,1166396,585769,580627,0,1019785,506961,512824,0
MULTAN,DISTRICT,15 &  ABOVE,NEVER MARRIED,957437,400519,556522,396,453268,187048,266092,128,504169,213471,290430,268
MULTAN,DISTRICT,15 &  ABOVE,SEPERATION,7343,4080,3263,0,4290,2452,1838,0,3053,1628,1425,0
MULTAN,DISTRICT,15 &  ABOVE,WIDOWED,143991,105755,38236,0,75963,55550,20413,0,68028,50205,17823,0
MULTAN,DISTRICT,15 - 19,DIVORCED,212,174,38,0,139,113,26,0,73,61,12,0
MULTAN,DISTRICT,15 - 19,MARRIED,47338,35315,12023,0,32348,23820,8528,0,14990,11495,3495,0
MULTAN,DISTRICT,15 - 19,NEVER MARRIED,486393,227246,259095,52,252061,116603,135442,16,234332,110643,123653,36
MULTAN,DISTRICT,15 - 19,SEPERATION,187,122,65,0,122,84,38,0,65,38,27,0
MULTAN,DISTRICT,15 - 19,WIDOWED,107,67,40,0,63,39,24,0,44,28,16,0
MULTAN,DISTRICT,20 - 24,DIVORCED,1118,834,284,0,614,446,168,0,504,388,116,0
MULTAN,DISTRICT,20 - 24,MARRIED,192065,127186,64879,0,118491,76316,42175,0,73574,50870,22704,0
MULTAN,DISTRICT,20 - 24,NEVER MARRIED,279055,106930,172058,67,124608,45328,79262,18,154447,61602,92796,49
MULTAN,DISTRICT,20 - 24,SEPERATION,591,385,206,0,403,263,140,0,188,122,66,0
MULTAN,DISTRICT,20 - 24,WIDOWED,655,384,271,0,429,248,181,0,226,136,90,0
MULTAN,DISTRICT,25 - 29,DIVORCED,1863,1260,603,0,922,605,317,0,941,655,286,0
MULTAN,DISTRICT,25 - 29,MARRIED,291105,162781,128324,0,160871,86759,74112,0,130234,76022,54212,0
MULTAN,DISTRICT,25 - 29,NEVER MARRIED,113158,39212,73881,65,46006,14629,31357,20,67152,24583,42524,45
MULTAN,DISTRICT,25 - 29,SEPERATION,842,466,376,0,545,293,252,0,297,173,124,0
MULTAN,DISTRICT,25 - 29,WIDOWED,1527,934,593,0,905,535,370,0,622,399,223,0
MULTAN,DISTRICT,30 - 34,DIVORCED,2328,1573,755,0,1104,732,372,0,1224,841,383,0
MULTAN,DISTRICT,30 - 34,MARRIED,326240,171143,155097,0,171514,89064,82450,0,154726,82079,72647,0
MULTAN,DISTRICT,30 - 34,NEVER MARRIED,39580,14353,25177,50,15735,5557,10160,18,23845,8796,15017,32
MULTAN,DISTRICT,30 - 34,SEPERATION,1058,625,433,0,639,376,263,0,419,249,170,0
MULTAN,DISTRICT,30 - 34,WIDOWED,2854,1982,872,0,1577,1069,508,0,1277,913,364,0
MULTAN,DISTRICT,35 - 39,DIVORCED,2441,1594,847,0,1153,763,390,0,1288,831,457,0
MULTAN,DISTRICT,35 - 39,MARRIED,319101,157629,161472,0,162508,80376,82132,0,156593,77253,79340,0
MULTAN,DISTRICT,35 - 39,NEVER MARRIED,17850,5453,12348,49,6834,2052,4766,16,11016,3401,7582,33
MULTAN,DISTRICT,35 - 39,SEPERATION,1105,604,501,0,597,323,274,0,508,281,227,0
MULTAN,DISTRICT,35 - 39,WIDOWED,4907,3604,1303,0,2694,1967,727,0,2213,1637,576,0
MULTAN,DISTRICT,40 - 44,DIVORCED,2013,1303,710,0,962,630,332,0,1051,673,378,0
MULTAN,DISTRICT,40 - 44,MARRIED,289126,137419,151707,0,151509,72255,79254,0,137617,65164,72453,0
MULTAN,DISTRICT,40 - 44,NEVER MARRIED,8908,2838,6035,35,3454,1126,2311,17,5454,1712,3724,18
MULTAN,DISTRICT,40 - 44,SEPERATION,1025,563,462,0,564,334,230,0,461,229,232,0
MULTAN,DISTRICT,40 - 44,WIDOWED,8186,6465,1721,0,4462,3477,985,0,3724,2988,736,0
MULTAN,DISTRICT,45 - 49,DIVORCED,1409,881,528,0,638,424,214,0,771,457,314,0
MULTAN,DISTRICT,45 - 49,MARRIED,215616,97720,117896,0,108343,49601,58742,0,107273,48119,59154,0
MULTAN,DISTRICT,45 - 49,NEVER MARRIED,5069,1647,3398,24,1843,626,1210,7,3226,1021,2188,17
MULTAN,DISTRICT,45 - 49,SEPERATION,784,412,372,0,413,229,184,0,371,183,188,0
MULTAN,DISTRICT,45 - 49,WIDOWED,11295,8904,2391,0,5932,4609,1323,0,5363,4295,1068,0
MULTAN,DISTRICT,50 - 54,DIVORCED,1041,665,376,0,515,342,173,0,526,323,203,0
MULTAN,DISTRICT,50 - 54,MARRIED,168715,74768,93947,0,85776,38950,46826,0,82939,35818,47121,0
MULTAN,DISTRICT,50 - 54,NEVER MARRIED,2765,1041,1701,23,1037,432,597,8,1728,609,1104,15
MULTAN,DISTRICT,50 - 54,SEPERATION,618,327,291,0,358,199,159,0,260,128,132,0
MULTAN,DISTRICT,50 - 54,WIDOWED,16173,12804,3369,0,8284,6515,1769,0,7889,6289,1600,0
MULTAN,DISTRICT,55 - 59,DIVORCED,677,393,284,0,331,208,123,0,346,185,161,0
MULTAN,DISTRICT,55 - 59,MARRIED,126820,51895,74925,0,64181,26609,37572,0,62639,25286,37353,0
MULTAN,DISTRICT,55 - 59,NEVER MARRIED,1915,670,1231,14,645,250,391,4,1270,420,840,10
MULTAN,DISTRICT,55 - 59,SEPERATION,460,243,217,0,259,145,114,0,201,98,103,0
MULTAN,DISTRICT,55 - 59,WIDOWED,17912,13772,4140,0,8984,6789,2195,0,8928,6983,1945,0
MULTAN,DISTRICT,60 - 64,DIVORCED,461,289,172,0,223,141,82,0,238,148,90,0
MULTAN,DISTRICT,60 - 64,MARRIED,90699,35629,55070,0,46070,18668,27402,0,44629,16961,27668,0
MULTAN,DISTRICT,60 - 64,NEVER MARRIED,1240,500,733,7,476,219,257,0,764,281,476,7
MULTAN,DISTRICT,60 - 64,SEPERATION,310,167,143,0,174,104,70,0,136,63,73,0
MULTAN,DISTRICT,60 - 64,WIDOWED,20867,15693,5174,0,10512,7940,2572,0,10355,7753,2602,0
MULTAN,DISTRICT,65 - 69,DIVORCED,268,163,105,0,145,96,49,0,123,67,56,0
MULTAN,DISTRICT,65 - 69,MARRIED,59476,23313,36163,0,30978,12797,18181,0,28498,10516,17982,0
MULTAN,DISTRICT,65 - 69,NEVER MARRIED,777,344,429,4,289,119,169,1,488,225,260,3
MULTAN,DISTRICT,65 - 69,SEPERATION,176,90,86,0,104,58,46,0,72,32,40,0
MULTAN,DISTRICT,65 - 69,WIDOWED,20497,15290,5207,0,10432,7870,2562,0,10065,7420,2645,0
MULTAN,DISTRICT,70 - 74,DIVORCED,135,80,55,0,76,46,30,0,59,34,25,0
MULTAN,DISTRICT,70 - 74,MARRIED,34272,10699,23573,0,18995,6290,12705,0,15277,4409,10868,0
MULTAN,DISTRICT,70 - 74,NEVER MARRIED,397,152,244,1,158,61,97,0,239,91,147,1
MULTAN,DISTRICT,70 - 74,SEPERATION,105,46,59,0,63,28,35,0,42,18,24,0
MULTAN,DISTRICT,70 - 74,WIDOWED,17468,11984,5484,0,9562,6640,2922,0,7906,5344,2562,0
MULTAN,DISTRICT,75 & ABOVE,DIVORCED,92,45,47,0,56,25,31,0,36,20,16,0
MULTAN,DISTRICT,75 & ABOVE,MARRIED,25608,7233,18375,0,14812,4264,10548,0,10796,2969,7827,0
MULTAN,DISTRICT,75 & ABOVE,NEVER MARRIED,330,133,192,5,122,46,73,3,208,87,119,2
MULTAN,DISTRICT,75 & ABOVE,SEPERATION,82,30,52,0,49,16,33,0,33,14,19,0
MULTAN,DISTRICT,75 & ABOVE,WIDOWED,21543,13872,7671,0,12127,7852,4275,0,9416,6020,3396,0
MUZAFFARGARH,DISTRICT,15 &  ABOVE,DIVORCED,6853,4867,1986,0,5205,3705,1500,0,1648,1162,486,0
MUZAFFARGARH,DISTRICT,15 &  ABOVE,MARRIED,1920249,966098,954151,0,1556553,783782,772771,0,363696,182316,181380,0
MUZAFFARGARH,DISTRICT,15 &  ABOVE,NEVER MARRIED,718615,299750,418764,101,554286,228652,325575,59,164329,71098,93189,42
MUZAFFARGARH,DISTRICT,15 &  ABOVE,SEPERATION,4670,2638,2032,0,3768,2147,1621,0,902,491,411,0
MUZAFFARGARH,DISTRICT,15 &  ABOVE,WIDOWED,94336,71356,22980,0,73092,54967,18125,0,21244,16389,4855,0
MUZAFFARGARH,DISTRICT,15 - 19,DIVORCED,184,137,47,0,150,114,36,0,34,23,11,0
MUZAFFARGARH,DISTRICT,15 - 19,MARRIED,66967,47596,19371,0,58617,41389,17228,0,8350,6207,2143,0
MUZAFFARGARH,DISTRICT,15 - 19,NEVER MARRIED,436320,199791,236505,24,348367,158655,189695,17,87953,41136,46810,7
MUZAFFARGARH,DISTRICT,15 - 19,SEPERATION,178,110,68,0,156,97,59,0,22,13,9,0
MUZAFFARGARH,DISTRICT,15 - 19,WIDOWED,152,81,71,0,128,65,63,0,24,16,8,0
MUZAFFARGARH,DISTRICT,20 - 24,DIVORCED,654,480,174,0,523,374,149,0,131,106,25,0
MUZAFFARGARH,DISTRICT,20 - 24,MARRIED,218491,135715,82776,0,186156,114271,71885,0,32335,21444,10891,0
MUZAFFARGARH,DISTRICT,20 - 24,NEVER MARRIED,178237,61960,116262,15,133248,44068,89173,7,44989,17892,27089,8
MUZAFFARGARH,DISTRICT,20 - 24,SEPERATION,442,268,174,0,379,228,151,0,63,40,23,0
MUZAFFARGARH,DISTRICT,20 - 24,WIDOWED,631,375,256,0,537,312,225,0,94,63,31,0
MUZAFFARGARH,DISTRICT,25 - 29,DIVORCED,949,649,300,0,712,474,238,0,237,175,62,0
MUZAFFARGARH,DISTRICT,25 - 29,MARRIED,271165,145306,125859,0,221311,117039,104272,0,49854,28267,21587,0
MUZAFFARGARH,DISTRICT,25 - 29,NEVER MARRIED,64082,21834,42239,9,44890,14670,30215,5,19192,7164,12024,4
MUZAFFARGARH,DISTRICT,25 - 29,SEPERATION,623,359,264,0,519,297,222,0,104,62,42,0
MUZAFFARGARH,DISTRICT,25 - 29,WIDOWED,1303,810,493,0,1048,633,415,0,255,177,78,0
MUZAFFARGARH,DISTRICT,30 - 34,DIVORCED,1062,760,302,0,800,572,228,0,262,188,74,0
MUZAFFARGARH,DISTRICT,30 - 34,MARRIED,273513,139565,133948,0,218722,111205,107517,0,54791,28360,26431,0
MUZAFFARGARH,DISTRICT,30 - 34,NEVER MARRIED,21257,9580,11669,8,14753,6622,8125,6,6504,2958,3544,2
MUZAFFARGARH,DISTRICT,30 - 34,SEPERATION,587,322,265,0,470,261,209,0,117,61,56,0
MUZAFFARGARH,DISTRICT,30 - 34,WIDOWED,2118,1475,643,0,1682,1165,517,0,436,310,126,0
MUZAFFARGARH,DISTRICT,35 - 39,DIVORCED,1099,773,326,0,839,603,236,0,260,170,90,0
MUZAFFARGARH,DISTRICT,35 - 39,MARRIED,262984,128793,134191,0,210131,103022,107109,0,52853,25771,27082,0
MUZAFFARGARH,DISTRICT,35 - 39,NEVER MARRIED,8872,2889,5972,11,6120,2031,4082,7,2752,858,1890,4
MUZAFFARGARH,DISTRICT,35 - 39,SEPERATION,622,339,283,0,484,270,214,0,138,69,69,0
MUZAFFARGARH,DISTRICT,35 - 39,WIDOWED,3444,2592,852,0,2740,2037,703,0,704,555,149,0
MUZAFFARGARH,DISTRICT,40 - 44,DIVORCED,966,701,265,0,737,542,195,0,229,159,70,0
MUZAFFARGARH,DISTRICT,40 - 44,MARRIED,241136,116979,124157,0,193875,94436,99439,0,47261,22543,24718,0
MUZAFFARGARH,DISTRICT,40 - 44,NEVER MARRIED,4357,1521,2830,6,3104,1098,2003,3,1253,423,827,3
MUZAFFARGARH,DISTRICT,40 - 44,SEPERATION,574,342,232,0,458,275,183,0,116,67,49,0
MUZAFFARGARH,DISTRICT,40 - 44,WIDOWED,5866,4724,1142,0,4651,3724,927,0,1215,1000,215,0
MUZAFFARGARH,DISTRICT,45 - 49,DIVORCED,631,449,182,0,455,331,124,0,176,118,58,0
MUZAFFARGARH,DISTRICT,45 - 49,MARRIED,168438,77500,90938,0,133299,61563,71736,0,35139,15937,19202,0
MUZAFFARGARH,DISTRICT,45 - 49,NEVER MARRIED,2268,816,1446,6,1540,574,962,4,728,242,484,2
MUZAFFARGARH,DISTRICT,45 - 49,SEPERATION,431,247,184,0,340,201,139,0,91,46,45,0
MUZAFFARGARH,DISTRICT,45 - 49,WIDOWED,7260,5925,1335,0,5586,4550,1036,0,1674,1375,299,0
MUZAFFARGARH,DISTRICT,50 - 54,DIVORCED,518,380,138,0,383,283,100,0,135,97,38,0
MUZAFFARGARH,DISTRICT,50 - 54,MARRIED,133294,61063,72231,0,105523,48720,56803,0,27771,12343,15428,0
MUZAFFARGARH,DISTRICT,50 - 54,NEVER MARRIED,1241,510,724,7,869,368,500,1,372,142,224,6
MUZAFFARGARH,DISTRICT,50 - 54,SEPERATION,394,224,170,0,309,178,131,0,85,46,39,0
MUZAFFARGARH,DISTRICT,50 - 54,WIDOWED,9559,7885,1674,0,7345,6031,1314,0,2214,1854,360,0
MUZAFFARGARH,DISTRICT,55 - 59,DIVORCED,291,204,87,0,215,151,64,0,76,53,23,0
MUZAFFARGARH,DISTRICT,55 - 59,MARRIED,100345,42601,57744,0,79502,33994,45508,0,20843,8607,12236,0
MUZAFFARGARH,DISTRICT,55 - 59,NEVER MARRIED,745,330,408,7,515,219,292,4,230,111,116,3
MUZAFFARGARH,DISTRICT,55 - 59,SEPERATION,281,154,127,0,217,121,96,0,64,33,31,0
MUZAFFARGARH,DISTRICT,55 - 59,WIDOWED,10145,7984,2161,0,7660,5997,1663,0,2485,1987,498,0
MUZAFFARGARH,DISTRICT,60 - 64,DIVORCED,209,157,52,0,161,122,39,0,48,35,13,0
MUZAFFARGARH,DISTRICT,60 - 64,MARRIED,72346,29796,42550,0,57623,23983,33640,0,14723,5813,8910,0
MUZAFFARGARH,DISTRICT,60 - 64,NEVER MARRIED,522,232,287,3,347,146,200,1,175,86,87,2
MUZAFFARGARH,DISTRICT,60 - 64,SEPERATION,217,115,102,0,178,98,80,0,39,17,22,0
MUZAFFARGARH,DISTRICT,60 - 64,WIDOWED,11953,9308,2645,0,8976,6998,1978,0,2977,2310,667,0
MUZAFFARGARH,DISTRICT,65 - 69,DIVORCED,139,91,48,0,107,66,41,0,32,25,7,0
MUZAFFARGARH,DISTRICT,65 - 69,MARRIED,50216,21510,28706,0,40607,17638,22969,0,9609,3872,5737,0
MUZAFFARGARH,DISTRICT,65 - 69,NEVER MARRIED,311,129,180,2,226,88,137,1,85,41,43,1
MUZAFFARGARH,DISTRICT,65 - 69,SEPERATION,128,71,57,0,103,55,48,0,25,16,9,0
MUZAFFARGARH,DISTRICT,65 - 69,WIDOWED,12776,9998,2778,0,9695,7584,2111,0,3081,2414,667,0
MUZAFFARGARH,DISTRICT,70 - 74,DIVORCED,81,47,34,0,62,37,25,0,19,10,9,0
MUZAFFARGARH,DISTRICT,70 - 74,MARRIED,33225,11477,21748,0,27552,9597,17955,0,5673,1880,3793,0
MUZAFFARGARH,DISTRICT,70 - 74,NEVER MARRIED,203,85,116,2,155,60,93,2,48,25,23,0
MUZAFFARGARH,DISTRICT,70 - 74,SEPERATION,109,56,53,0,85,40,45,0,24,16,8,0
MUZAFFARGARH,DISTRICT,70 - 74,WIDOWED,12217,8933,3284,0,9514,6973,2541,0,2703,1960,743,0
MUZAFFARGARH,DISTRICT,75 & ABOVE,DIVORCED,70,39,31,0,61,36,25,0,9,3,6,0
MUZAFFARGARH,DISTRICT,75 & ABOVE,MARRIED,28129,8197,19932,0,23635,6925,16710,0,4494,1272,3222,0
MUZAFFARGARH,DISTRICT,75 & ABOVE,NEVER MARRIED,200,73,126,1,152,53,98,1,48,20,28,0
MUZAFFARGARH,DISTRICT,75 & ABOVE,SEPERATION,84,31,53,0,70,26,44,0,14,5,9,0
MUZAFFARGARH,DISTRICT,75 & ABOVE,WIDOWED,16912,11266,5646,0,13530,8898,4632,0,3382,2368,1014,0
NANKANA SAHIB,DISTRICT,15 &  ABOVE,DIVORCED,4885,3101,1784,0,3888,2473,1415,0,997,628,369,0
NANKANA SAHIB,DISTRICT,15 &  ABOVE,MARRIED,655150,330006,325144,0,524981,263736,261245,0,130169,66270,63899,0
NANKANA SAHIB,DISTRICT,15 &  ABOVE,NEVER MARRIED,308598,132248,176272,78,241645,102475,139139,31,66953,29773,37133,47
NANKANA SAHIB,DISTRICT,15 &  ABOVE,SEPERATION,1675,872,803,0,1395,727,668,0,280,145,135,0
NANKANA SAHIB,DISTRICT,15 &  ABOVE,WIDOWED,42540,28023,14517,0,33722,21933,11789,0,8818,6090,2728,0
NANKANA SAHIB,DISTRICT,15 - 19,DIVORCED,97,77,20,0,86,67,19,0,11,10,1,0
NANKANA SAHIB,DISTRICT,15 - 19,MARRIED,10270,7291,2979,0,8861,6278,2583,0,1409,1013,396,0
NANKANA SAHIB,DISTRICT,15 - 19,NEVER MARRIED,152543,73107,79432,4,120780,57643,63133,4,31763,15464,16299,0
NANKANA SAHIB,DISTRICT,15 - 19,SEPERATION,33,25,8,0,28,22,6,0,5,3,2,0
NANKANA SAHIB,DISTRICT,15 - 19,WIDOWED,32,17,15,0,22,11,11,0,10,6,4,0
NANKANA SAHIB,DISTRICT,20 - 24,DIVORCED,436,308,128,0,345,238,107,0,91,70,21,0
NANKANA SAHIB,DISTRICT,20 - 24,MARRIED,48502,32778,15724,0,40373,27071,13302,0,8129,5707,2422,0
NANKANA SAHIB,DISTRICT,20 - 24,NEVER MARRIED,90654,36657,53991,6,70573,27902,42670,1,20081,8755,11321,5
NANKANA SAHIB,DISTRICT,20 - 24,SEPERATION,124,75,49,0,106,63,43,0,18,12,6,0
NANKANA SAHIB,DISTRICT,20 - 24,WIDOWED,191,106,85,0,162,93,69,0,29,13,16,0
NANKANA SAHIB,DISTRICT,25 - 29,DIVORCED,650,437,213,0,512,336,176,0,138,101,37,0
NANKANA SAHIB,DISTRICT,25 - 29,MARRIED,86323,50517,35806,0,69886,40544,29342,0,16437,9973,6464,0
NANKANA SAHIB,DISTRICT,25 - 29,NEVER MARRIED,38936,13501,25429,6,29860,10013,19845,2,9076,3488,5584,4
NANKANA SAHIB,DISTRICT,25 - 29,SEPERATION,222,120,102,0,190,100,90,0,32,20,12,0
NANKANA SAHIB,DISTRICT,25 - 29,WIDOWED,422,241,181,0,349,192,157,0,73,49,24,0
NANKANA SAHIB,DISTRICT,30 - 34,DIVORCED,743,487,256,0,572,379,193,0,171,108,63,0
NANKANA SAHIB,DISTRICT,30 - 34,MARRIED,94201,50649,43552,0,74695,39913,34782,0,19506,10736,8770,0
NANKANA SAHIB,DISTRICT,30 - 34,NEVER MARRIED,12691,4618,8068,5,9605,3432,6171,2,3086,1186,1897,3
NANKANA SAHIB,DISTRICT,30 - 34,SEPERATION,205,103,102,0,164,76,88,0,41,27,14,0
NANKANA SAHIB,DISTRICT,30 - 34,WIDOWED,767,483,284,0,611,376,235,0,156,107,49,0
NANKANA SAHIB,DISTRICT,35 - 39,DIVORCED,752,454,298,0,584,355,229,0,168,99,69,0
NANKANA SAHIB,DISTRICT,35 - 39,MARRIED,92141,46070,46071,0,72948,36293,36655,0,19193,9777,9416,0
NANKANA SAHIB,DISTRICT,35 - 39,NEVER MARRIED,5503,1544,3941,18,4227,1180,3041,6,1276,364,900,12
NANKANA SAHIB,DISTRICT,35 - 39,SEPERATION,211,112,99,0,176,100,76,0,35,12,23,0
NANKANA SAHIB,DISTRICT,35 - 39,WIDOWED,1288,922,366,0,1038,741,297,0,250,181,69,0
NANKANA SAHIB,DISTRICT,40 - 44,DIVORCED,615,399,216,0,493,318,175,0,122,81,41,0
NANKANA SAHIB,DISTRICT,40 - 44,MARRIED,84412,40621,43791,0,66759,31862,34897,0,17653,8759,8894,0
NANKANA SAHIB,DISTRICT,40 - 44,NEVER MARRIED,2802,863,1928,11,2158,673,1479,6,644,190,449,5
NANKANA SAHIB,DISTRICT,40 - 44,SEPERATION,199,99,100,0,163,77,86,0,36,22,14,0
NANKANA SAHIB,DISTRICT,40 - 44,WIDOWED,2319,1783,536,0,1866,1404,462,0,453,379,74,0
NANKANA SAHIB,DISTRICT,45 - 49,DIVORCED,518,308,210,0,411,250,161,0,107,58,49,0
NANKANA SAHIB,DISTRICT,45 - 49,MARRIED,66760,30851,35909,0,52837,24397,28440,0,13923,6454,7469,0
NANKANA SAHIB,DISTRICT,45 - 49,NEVER MARRIED,1883,600,1273,10,1477,492,982,3,406,108,291,7
NANKANA SAHIB,DISTRICT,45 - 49,SEPERATION,209,110,99,0,163,91,72,0,46,19,27,0
NANKANA SAHIB,DISTRICT,45 - 49,WIDOWED,3027,2269,758,0,2340,1743,597,0,687,526,161,0
NANKANA SAHIB,DISTRICT,50 - 54,DIVORCED,385,251,134,0,312,208,104,0,73,43,30,0
NANKANA SAHIB,DISTRICT,50 - 54,MARRIED,52412,23644,28768,0,41290,18677,22613,0,11122,4967,6155,0
NANKANA SAHIB,DISTRICT,50 - 54,NEVER MARRIED,1168,457,704,7,942,375,565,2,226,82,139,5
NANKANA SAHIB,DISTRICT,50 - 54,SEPERATION,153,74,79,0,128,61,67,0,25,13,12,0
NANKANA SAHIB,DISTRICT,50 - 54,WIDOWED,4270,3185,1085,0,3303,2431,872,0,967,754,213,0
NANKANA SAHIB,DISTRICT,55 - 59,DIVORCED,262,151,111,0,216,128,88,0,46,23,23,0
NANKANA SAHIB,DISTRICT,55 - 59,MARRIED,41954,17822,24132,0,33221,14185,19036,0,8733,3637,5096,0
NANKANA SAHIB,DISTRICT,55 - 59,NEVER MARRIED,815,308,503,4,654,256,397,1,161,52,106,3
NANKANA SAHIB,DISTRICT,55 - 59,SEPERATION,115,62,53,0,95,52,43,0,20,10,10,0
NANKANA SAHIB,DISTRICT,55 - 59,WIDOWED,4899,3404,1495,0,3796,2583,1213,0,1103,821,282,0
NANKANA SAHIB,DISTRICT,60 - 64,DIVORCED,192,109,83,0,154,88,66,0,38,21,17,0
NANKANA SAHIB,DISTRICT,60 - 64,MARRIED,31988,13057,18931,0,25786,10594,15192,0,6202,2463,3739,0
NANKANA SAHIB,DISTRICT,60 - 64,NEVER MARRIED,664,272,389,3,558,226,330,2,106,46,59,1
NANKANA SAHIB,DISTRICT,60 - 64,SEPERATION,88,32,56,0,75,30,45,0,13,2,11,0
NANKANA SAHIB,DISTRICT,60 - 64,WIDOWED,5933,4031,1902,0,4664,3141,1523,0,1269,890,379,0
NANKANA SAHIB,DISTRICT,65 - 69,DIVORCED,123,64,59,0,108,56,52,0,15,8,7,0
NANKANA SAHIB,DISTRICT,65 - 69,MARRIED,20984,8278,12706,0,17073,6823,10250,0,3911,1455,2456,0
NANKANA SAHIB,DISTRICT,65 - 69,NEVER MARRIED,394,154,240,0,343,138,205,0,51,16,35,0
NANKANA SAHIB,DISTRICT,65 - 69,SEPERATION,49,28,21,0,45,25,20,0,4,3,1,0
NANKANA SAHIB,DISTRICT,65 - 69,WIDOWED,5631,3596,2035,0,4408,2815,1593,0,1223,781,442,0
NANKANA SAHIB,DISTRICT,70 - 74,DIVORCED,55,29,26,0,49,28,21,0,6,1,5,0
NANKANA SAHIB,DISTRICT,70 - 74,MARRIED,12313,4228,8085,0,10313,3562,6751,0,2000,666,1334,0
NANKANA SAHIB,DISTRICT,70 - 74,NEVER MARRIED,249,86,161,2,203,74,128,1,46,12,33,1
NANKANA SAHIB,DISTRICT,70 - 74,SEPERATION,34,19,15,0,30,18,12,0,4,1,3,0
NANKANA SAHIB,DISTRICT,70 - 74,WIDOWED,5099,3048,2051,0,4088,2405,1683,0,1011,643,368,0
NANKANA SAHIB,DISTRICT,75 & ABOVE,DIVORCED,57,27,30,0,46,22,24,0,11,5,6,0
NANKANA SAHIB,DISTRICT,75 & ABOVE,MARRIED,12890,4200,8690,0,10939,3537,7402,0,1951,663,1288,0
NANKANA SAHIB,DISTRICT,75 & ABOVE,NEVER MARRIED,296,81,213,2,265,71,193,1,31,10,20,1
NANKANA SAHIB,DISTRICT,75 & ABOVE,SEPERATION,33,13,20,0,32,12,20,0,1,1,0,0
NANKANA SAHIB,DISTRICT,75 & ABOVE,WIDOWED,8662,4938,3724,0,7075,3998,3077,0,1587,940,647,0
NAROWAL,DISTRICT,15 &  ABOVE,DIVORCED,4787,2940,1847,0,4029,2412,1617,0,758,528,230,0
NAROWAL,DISTRICT,15 &  ABOVE,MARRIED,774878,395471,379407,0,634039,323198,310841,0,140839,72273,68566,0
NAROWAL,DISTRICT,15 &  ABOVE,NEVER MARRIED,393023,167184,225756,83,317982,134355,183583,44,75041,32829,42173,39
NAROWAL,DISTRICT,15 &  ABOVE,SEPERATION,938,543,395,0,772,441,331,0,166,102,64,0
NAROWAL,DISTRICT,15 &  ABOVE,WIDOWED,50765,34746,16019,0,42861,29178,13683,0,7904,5568,2336,0
NAROWAL,DISTRICT,15 - 19,DIVORCED,40,33,7,0,35,29,6,0,5,4,1,0
NAROWAL,DISTRICT,15 - 19,MARRIED,6420,4679,1741,0,5411,3959,1452,0,1009,720,289,0
NAROWAL,DISTRICT,15 - 19,NEVER MARRIED,197049,94500,102539,10,161112,77437,83668,7,35937,17063,18871,3
NAROWAL,DISTRICT,15 - 19,SEPERATION,18,11,7,0,11,6,5,0,7,5,2,0
NAROWAL,DISTRICT,15 - 19,WIDOWED,33,18,15,0,31,18,13,0,2,0,2,0
NAROWAL,DISTRICT,20 - 24,DIVORCED,367,279,88,0,323,245,78,0,44,34,10,0
NAROWAL,DISTRICT,20 - 24,MARRIED,49668,35079,14589,0,42051,29645,12406,0,7617,5434,2183,0
NAROWAL,DISTRICT,20 - 24,NEVER MARRIED,128252,52908,75332,12,103648,41973,61668,7,24604,10935,13664,5
NAROWAL,DISTRICT,20 - 24,SEPERATION,71,48,23,0,64,42,22,0,7,6,1,0
NAROWAL,DISTRICT,20 - 24,WIDOWED,168,99,69,0,140,80,60,0,28,19,9,0
NAROWAL,DISTRICT,25 - 29,DIVORCED,689,464,225,0,580,380,200,0,109,84,25,0
NAROWAL,DISTRICT,25 - 29,MARRIED,103234,61744,41490,0,86228,51243,34985,0,17006,10501,6505,0
NAROWAL,DISTRICT,25 - 29,NEVER MARRIED,47170,14607,32556,7,37194,11063,26128,3,9976,3544,6428,4
NAROWAL,DISTRICT,25 - 29,SEPERATION,111,76,35,0,91,62,29,0,20,14,6,0
NAROWAL,DISTRICT,25 - 29,WIDOWED,402,228,174,0,336,190,146,0,66,38,28,0
NAROWAL,DISTRICT,30 - 34,DIVORCED,811,479,332,0,680,393,287,0,131,86,45,0
NAROWAL,DISTRICT,30 - 34,MARRIED,115028,61388,53640,0,94847,50147,44700,0,20181,11241,8940,0
NAROWAL,DISTRICT,30 - 34,NEVER MARRIED,11195,2586,8601,8,8659,1891,6765,3,2536,695,1836,5
NAROWAL,DISTRICT,30 - 34,SEPERATION,115,74,41,0,96,62,34,0,19,12,7,0
NAROWAL,DISTRICT,30 - 34,WIDOWED,755,502,253,0,616,410,206,0,139,92,47,0
NAROWAL,DISTRICT,35 - 39,DIVORCED,745,446,299,0,590,338,252,0,155,108,47,0
NAROWAL,DISTRICT,35 - 39,MARRIED,110641,55511,55130,0,89903,44768,45135,0,20738,10743,9995,0
NAROWAL,DISTRICT,35 - 39,NEVER MARRIED,3954,998,2948,8,3060,765,2290,5,894,233,658,3
NAROWAL,DISTRICT,35 - 39,SEPERATION,126,58,68,0,105,48,57,0,21,10,11,0
NAROWAL,DISTRICT,35 - 39,WIDOWED,1259,935,324,0,1027,746,281,0,232,189,43,0
NAROWAL,DISTRICT,40 - 44,DIVORCED,646,412,234,0,530,331,199,0,116,81,35,0
NAROWAL,DISTRICT,40 - 44,MARRIED,98305,48569,49736,0,79238,38994,40244,0,19067,9575,9492,0
NAROWAL,DISTRICT,40 - 44,NEVER MARRIED,1889,562,1312,15,1445,424,1013,8,444,138,299,7
NAROWAL,DISTRICT,40 - 44,SEPERATION,127,83,44,0,102,64,38,0,25,19,6,0
NAROWAL,DISTRICT,40 - 44,WIDOWED,2119,1630,489,0,1764,1341,423,0,355,289,66,0
NAROWAL,DISTRICT,45 - 49,DIVORCED,460,268,192,0,397,227,170,0,63,41,22,0
NAROWAL,DISTRICT,45 - 49,MARRIED,76557,36202,40355,0,60933,28849,32084,0,15624,7353,8271,0
NAROWAL,DISTRICT,45 - 49,NEVER MARRIED,1177,327,838,12,923,256,663,4,254,71,175,8
NAROWAL,DISTRICT,45 - 49,SEPERATION,101,49,52,0,84,38,46,0,17,11,6,0
NAROWAL,DISTRICT,45 - 49,WIDOWED,2868,2218,650,0,2328,1776,552,0,540,442,98,0
NAROWAL,DISTRICT,50 - 54,DIVORCED,370,211,159,0,316,171,145,0,54,40,14,0
NAROWAL,DISTRICT,50 - 54,MARRIED,63581,29569,34012,0,50791,23772,27019,0,12790,5797,6993,0
NAROWAL,DISTRICT,50 - 54,NEVER MARRIED,715,228,481,6,567,175,387,5,148,53,94,1
NAROWAL,DISTRICT,50 - 54,SEPERATION,72,39,33,0,55,31,24,0,17,8,9,0
NAROWAL,DISTRICT,50 - 54,WIDOWED,4235,3249,986,0,3529,2688,841,0,706,561,145,0
NAROWAL,DISTRICT,55 - 59,DIVORCED,259,153,106,0,227,134,93,0,32,19,13,0
NAROWAL,DISTRICT,55 - 59,MARRIED,51734,23033,28701,0,41632,18596,23036,0,10102,4437,5665,0
NAROWAL,DISTRICT,55 - 59,NEVER MARRIED,543,161,378,4,441,124,315,2,102,37,63,2
NAROWAL,DISTRICT,55 - 59,SEPERATION,73,38,35,0,58,30,28,0,15,8,7,0
NAROWAL,DISTRICT,55 - 59,WIDOWED,5092,3712,1380,0,4188,3017,1171,0,904,695,209,0
NAROWAL,DISTRICT,60 - 64,DIVORCED,188,92,96,0,158,76,82,0,30,16,14,0
NAROWAL,DISTRICT,60 - 64,MARRIED,39316,16500,22816,0,32086,13550,18536,0,7230,2950,4280,0
NAROWAL,DISTRICT,60 - 64,NEVER MARRIED,417,129,288,0,349,100,249,0,68,29,39,0
NAROWAL,DISTRICT,60 - 64,SEPERATION,49,28,21,0,42,24,18,0,7,4,3,0
NAROWAL,DISTRICT,60 - 64,WIDOWED,6587,4646,1941,0,5538,3889,1649,0,1049,757,292,0
NAROWAL,DISTRICT,65 - 69,DIVORCED,102,47,55,0,96,42,54,0,6,5,1,0
NAROWAL,DISTRICT,65 - 69,MARRIED,26085,11116,14969,0,21571,9296,12275,0,4514,1820,2694,0
NAROWAL,DISTRICT,65 - 69,NEVER MARRIED,257,78,178,1,223,64,159,0,34,14,19,1
NAROWAL,DISTRICT,65 - 69,SEPERATION,33,18,15,0,28,16,12,0,5,2,3,0
NAROWAL,DISTRICT,65 - 69,WIDOWED,6916,4804,2112,0,5781,4001,1780,0,1135,803,332,0
NAROWAL,DISTRICT,70 - 74,DIVORCED,57,32,25,0,49,24,25,0,8,8,0,0
NAROWAL,DISTRICT,70 - 74,MARRIED,16842,6193,10649,0,14344,5325,9019,0,2498,868,1630,0
NAROWAL,DISTRICT,70 - 74,NEVER MARRIED,179,40,139,0,161,33,128,0,18,7,11,0
NAROWAL,DISTRICT,70 - 74,SEPERATION,22,11,11,0,18,9,9,0,4,2,2,0
NAROWAL,DISTRICT,70 - 74,WIDOWED,6929,4503,2426,0,5958,3880,2078,0,971,623,348,0
NAROWAL,DISTRICT,75 & ABOVE,DIVORCED,53,24,29,0,48,22,26,0,5,2,3,0
NAROWAL,DISTRICT,75 & ABOVE,MARRIED,17467,5888,11579,0,15004,5054,9950,0,2463,834,1629,0
NAROWAL,DISTRICT,75 & ABOVE,NEVER MARRIED,226,60,166,0,200,50,150,0,26,10,16,0
NAROWAL,DISTRICT,75 & ABOVE,SEPERATION,20,10,10,0,18,9,9,0,2,1,1,0
NAROWAL,DISTRICT,75 & ABOVE,WIDOWED,13402,8202,5200,0,11625,7142,4483,0,1777,1060,717,0
OKARA,DISTRICT,15 &  ABOVE,DIVORCED,15067,9887,5180,0,10408,6826,3582,0,4659,3061,1598,0
OKARA,DISTRICT,15 &  ABOVE,MARRIED,1405894,700985,704909,0,930647,465073,465574,0,475247,235912,239335,0
OKARA,DISTRICT,15 &  ABOVE,NEVER MARRIED,614571,261706,352535,330,389362,163278,226006,78,225209,98428,126529,252
OKARA,DISTRICT,15 &  ABOVE,SEPERATION,6143,3322,2821,0,4405,2380,2025,0,1738,942,796,0
OKARA,DISTRICT,15 &  ABOVE,WIDOWED,94811,65032,29779,0,62560,42109,20451,0,32251,22923,9328,0
OKARA,DISTRICT,15 - 19,DIVORCED,371,291,80,0,285,224,61,0,86,67,19,0
OKARA,DISTRICT,15 - 19,MARRIED,28414,20569,7845,0,21553,15528,6025,0,6861,5041,1820,0
OKARA,DISTRICT,15 - 19,NEVER MARRIED,311345,146904,164414,27,202132,94516,107604,12,109213,52388,56810,15
OKARA,DISTRICT,15 - 19,SEPERATION,172,121,51,0,137,101,36,0,35,20,15,0
OKARA,DISTRICT,15 - 19,WIDOWED,106,75,31,0,76,52,24,0,30,23,7,0
OKARA,DISTRICT,20 - 24,DIVORCED,1360,943,417,0,990,669,321,0,370,274,96,0
OKARA,DISTRICT,20 - 24,MARRIED,116244,76678,39566,0,82379,53641,28738,0,33865,23037,10828,0
OKARA,DISTRICT,20 - 24,NEVER MARRIED,173182,67862,105274,46,106628,40032,66592,4,66554,27830,38682,42
OKARA,DISTRICT,20 - 24,SEPERATION,500,327,173,0,396,259,137,0,104,68,36,0
OKARA,DISTRICT,20 - 24,WIDOWED,527,280,247,0,395,203,192,0,132,77,55,0
OKARA,DISTRICT,25 - 29,DIVORCED,1975,1297,678,0,1320,854,466,0,655,443,212,0
OKARA,DISTRICT,25 - 29,MARRIED,186387,105734,80653,0,124055,69357,54698,0,62332,36377,25955,0
OKARA,DISTRICT,25 - 29,NEVER MARRIED,75750,26632,49060,58,45990,15685,30294,11,29760,10947,18766,47
OKARA,DISTRICT,25 - 29,SEPERATION,682,398,284,0,483,283,200,0,199,115,84,0
OKARA,DISTRICT,25 - 29,WIDOWED,1099,622,477,0,748,398,350,0,351,224,127,0
OKARA,DISTRICT,30 - 34,DIVORCED,2125,1392,733,0,1397,902,495,0,728,490,238,0
OKARA,DISTRICT,30 - 34,MARRIED,200749,104598,96151,0,128563,66785,61778,0,72186,37813,34373,0
OKARA,DISTRICT,30 - 34,NEVER MARRIED,25601,10603,14953,45,15870,6481,9380,9,9731,4122,5573,36
OKARA,DISTRICT,30 - 34,SEPERATION,815,456,359,0,559,319,240,0,256,137,119,0
OKARA,DISTRICT,30 - 34,WIDOWED,1829,1185,644,0,1189,723,466,0,640,462,178,0
OKARA,DISTRICT,35 - 39,DIVORCED,2175,1423,752,0,1420,929,491,0,755,494,261,0
OKARA,DISTRICT,35 - 39,MARRIED,195005,95944,99061,0,123481,61131,62350,0,71524,34813,36711,0
OKARA,DISTRICT,35 - 39,NEVER MARRIED,11463,3481,7936,46,7132,2156,4966,10,4331,1325,2970,36
OKARA,DISTRICT,35 - 39,SEPERATION,819,424,395,0,545,282,263,0,274,142,132,0
OKARA,DISTRICT,35 - 39,WIDOWED,2966,2040,926,0,1871,1258,613,0,1095,782,313,0
OKARA,DISTRICT,40 - 44,DIVORCED,1966,1342,624,0,1342,931,411,0,624,411,213,0
OKARA,DISTRICT,40 - 44,MARRIED,177138,84588,92550,0,114909,55068,59841,0,62229,29520,32709,0
OKARA,DISTRICT,40 - 44,NEVER MARRIED,6081,1996,4055,30,3915,1339,2565,11,2166,657,1490,19
OKARA,DISTRICT,40 - 44,SEPERATION,745,382,363,0,528,266,262,0,217,116,101,0
OKARA,DISTRICT,40 - 44,WIDOWED,4881,3669,1212,0,3153,2313,840,0,1728,1356,372,0
OKARA,DISTRICT,45 - 49,DIVORCED,1562,988,574,0,1099,707,392,0,463,281,182,0
OKARA,DISTRICT,45 - 49,MARRIED,138567,63482,75085,0,90024,41571,48453,0,48543,21911,26632,0
OKARA,DISTRICT,45 - 49,NEVER MARRIED,3891,1359,2505,27,2562,943,1613,6,1329,416,892,21
OKARA,DISTRICT,45 - 49,SEPERATION,666,329,337,0,476,236,240,0,190,93,97,0
OKARA,DISTRICT,45 - 49,WIDOWED,6653,4980,1673,0,4226,3072,1154,0,2427,1908,519,0
OKARA,DISTRICT,50 - 54,DIVORCED,1181,774,407,0,828,537,291,0,353,237,116,0
OKARA,DISTRICT,50 - 54,MARRIED,110731,49645,61086,0,73259,33229,40030,0,37472,16416,21056,0
OKARA,DISTRICT,50 - 54,NEVER MARRIED,2511,1009,1482,20,1703,734,964,5,808,275,518,15
OKARA,DISTRICT,50 - 54,SEPERATION,552,304,248,0,399,210,189,0,153,94,59,0
OKARA,DISTRICT,50 - 54,WIDOWED,9332,7089,2243,0,5894,4365,1529,0,3438,2724,714,0
OKARA,DISTRICT,55 - 59,DIVORCED,936,607,329,0,673,445,228,0,263,162,101,0
OKARA,DISTRICT,55 - 59,MARRIED,88375,37627,50748,0,58836,25186,33650,0,29539,12441,17098,0
OKARA,DISTRICT,55 - 59,NEVER MARRIED,1817,709,1092,16,1277,528,743,6,540,181,349,10
OKARA,DISTRICT,55 - 59,SEPERATION,412,203,209,0,301,150,151,0,111,53,58,0
OKARA,DISTRICT,55 - 59,WIDOWED,10903,8037,2866,0,6893,4969,1924,0,4010,3068,942,0
OKARA,DISTRICT,60 - 64,DIVORCED,639,408,231,0,482,311,171,0,157,97,60,0
OKARA,DISTRICT,60 - 64,MARRIED,66431,27072,39359,0,44594,18466,26128,0,21837,8606,13231,0
OKARA,DISTRICT,60 - 64,NEVER MARRIED,1258,520,733,5,926,391,534,1,332,129,199,4
OKARA,DISTRICT,60 - 64,SEPERATION,340,179,161,0,259,134,125,0,81,45,36,0
OKARA,DISTRICT,60 - 64,WIDOWED,13068,9265,3803,0,8428,5867,2561,0,4640,3398,1242,0
OKARA,DISTRICT,65 - 69,DIVORCED,374,215,159,0,283,168,115,0,91,47,44,0
OKARA,DISTRICT,65 - 69,MARRIED,43457,17648,25809,0,29770,12406,17364,0,13687,5242,8445,0
OKARA,DISTRICT,65 - 69,NEVER MARRIED,770,296,469,5,554,221,331,2,216,75,138,3
OKARA,DISTRICT,65 - 69,SEPERATION,219,114,105,0,157,78,79,0,62,36,26,0
OKARA,DISTRICT,65 - 69,WIDOWED,12799,8958,3841,0,8427,5907,2520,0,4372,3051,1321,0
OKARA,DISTRICT,70 - 74,DIVORCED,209,103,106,0,149,77,72,0,60,26,34,0
OKARA,DISTRICT,70 - 74,MARRIED,27644,9329,18315,0,19696,6826,12870,0,7948,2503,5445,0
OKARA,DISTRICT,70 - 74,NEVER MARRIED,439,154,283,2,326,112,214,0,113,42,69,2
OKARA,DISTRICT,70 - 74,SEPERATION,117,49,68,0,87,34,53,0,30,15,15,0
OKARA,DISTRICT,70 - 74,WIDOWED,11819,7576,4243,0,8032,5105,2927,0,3787,2471,1316,0
OKARA,DISTRICT,75 & ABOVE,DIVORCED,194,104,90,0,140,72,68,0,54,32,22,0
OKARA,DISTRICT,75 & ABOVE,MARRIED,26752,8071,18681,0,19528,5879,13649,0,7224,2192,5032,0
OKARA,DISTRICT,75 & ABOVE,NEVER MARRIED,463,181,279,3,347,140,206,1,116,41,73,2
OKARA,DISTRICT,75 & ABOVE,SEPERATION,104,36,68,0,78,28,50,0,26,8,18,0
OKARA,DISTRICT,75 & ABOVE,WIDOWED,18829,11256,7573,0,13228,7877,5351,0,5601,3379,2222,0
PAKPATTAN,DISTRICT,15 &  ABOVE,DIVORCED,10062,6829,3233,0,7685,5291,2394,0,2377,1538,839,0
PAKPATTAN,DISTRICT,15 &  ABOVE,MARRIED,834374,418007,416367,0,651981,326521,325460,0,182393,91486,90907,0
PAKPATTAN,DISTRICT,15 &  ABOVE,NEVER MARRIED,359705,152693,206854,158,270077,114143,155887,47,89628,38550,50967,111
PAKPATTAN,DISTRICT,15 &  ABOVE,SEPERATION,4831,2692,2139,0,3887,2188,1699,0,944,504,440,0
PAKPATTAN,DISTRICT,15 &  ABOVE,WIDOWED,61393,41732,19661,0,46629,31164,15465,0,14764,10568,4196,0
PAKPATTAN,DISTRICT,15 - 19,DIVORCED,205,155,50,0,167,124,43,0,38,31,7,0
PAKPATTAN,DISTRICT,15 - 19,MARRIED,17843,12931,4912,0,15047,10861,4186,0,2796,2070,726,0
PAKPATTAN,DISTRICT,15 - 19,NEVER MARRIED,184759,87002,97737,20,141602,66466,75131,5,43157,20536,22606,15
PAKPATTAN,DISTRICT,15 - 19,SEPERATION,109,77,32,0,96,66,30,0,13,11,2,0
PAKPATTAN,DISTRICT,15 - 19,WIDOWED,82,42,40,0,62,33,29,0,20,9,11,0
PAKPATTAN,DISTRICT,20 - 24,DIVORCED,882,647,235,0,680,498,182,0,202,149,53,0
PAKPATTAN,DISTRICT,20 - 24,MARRIED,69896,45339,24557,0,56537,36237,20300,0,13359,9102,4257,0
PAKPATTAN,DISTRICT,20 - 24,NEVER MARRIED,98314,38160,60133,21,72564,27502,45055,7,25750,10658,15078,14
PAKPATTAN,DISTRICT,20 - 24,SEPERATION,383,236,147,0,321,194,127,0,62,42,20,0
PAKPATTAN,DISTRICT,20 - 24,WIDOWED,317,172,145,0,250,133,117,0,67,39,28,0
PAKPATTAN,DISTRICT,25 - 29,DIVORCED,1301,849,452,0,983,642,341,0,318,207,111,0
PAKPATTAN,DISTRICT,25 - 29,MARRIED,110493,62364,48129,0,87065,48593,38472,0,23428,13771,9657,0
PAKPATTAN,DISTRICT,25 - 29,NEVER MARRIED,42886,15220,27651,15,31183,10880,20302,1,11703,4340,7349,14
PAKPATTAN,DISTRICT,25 - 29,SEPERATION,529,317,212,0,417,247,170,0,112,70,42,0
PAKPATTAN,DISTRICT,25 - 29,WIDOWED,676,359,317,0,524,275,249,0,152,84,68,0
PAKPATTAN,DISTRICT,30 - 34,DIVORCED,1402,989,413,0,1057,756,301,0,345,233,112,0
PAKPATTAN,DISTRICT,30 - 34,MARRIED,119305,62910,56395,0,91780,48252,43528,0,27525,14658,12867,0
PAKPATTAN,DISTRICT,30 - 34,NEVER MARRIED,15578,5851,9707,20,11181,4204,6973,4,4397,1647,2734,16
PAKPATTAN,DISTRICT,30 - 34,SEPERATION,543,336,207,0,444,277,167,0,99,59,40,0
PAKPATTAN,DISTRICT,30 - 34,WIDOWED,1251,785,466,0,945,585,360,0,306,200,106,0
PAKPATTAN,DISTRICT,35 - 39,DIVORCED,1353,904,449,0,982,670,312,0,371,234,137,0
PAKPATTAN,DISTRICT,35 - 39,MARRIED,112743,55359,57384,0,86255,42314,43941,0,26488,13045,13443,0
PAKPATTAN,DISTRICT,35 - 39,NEVER MARRIED,7186,2192,4970,24,5047,1633,3406,8,2139,559,1564,16
PAKPATTAN,DISTRICT,35 - 39,SEPERATION,630,367,263,0,498,304,194,0,132,63,69,0
PAKPATTAN,DISTRICT,35 - 39,WIDOWED,1924,1338,586,0,1446,990,456,0,478,348,130,0
PAKPATTAN,DISTRICT,40 - 44,DIVORCED,1303,881,422,0,967,665,302,0,336,216,120,0
PAKPATTAN,DISTRICT,40 - 44,MARRIED,108272,52081,56191,0,83564,40120,43444,0,24708,11961,12747,0
PAKPATTAN,DISTRICT,40 - 44,NEVER MARRIED,4066,1492,2552,22,3071,1188,1877,6,995,304,675,16
PAKPATTAN,DISTRICT,40 - 44,SEPERATION,625,352,273,0,493,283,210,0,132,69,63,0
PAKPATTAN,DISTRICT,40 - 44,WIDOWED,3193,2356,837,0,2385,1740,645,0,808,616,192,0
PAKPATTAN,DISTRICT,45 - 49,DIVORCED,1107,770,337,0,860,609,251,0,247,161,86,0
PAKPATTAN,DISTRICT,45 - 49,MARRIED,80726,37472,43254,0,62189,29000,33189,0,18537,8472,10065,0
PAKPATTAN,DISTRICT,45 - 49,NEVER MARRIED,2460,911,1533,16,1855,730,1118,7,605,181,415,9
PAKPATTAN,DISTRICT,45 - 49,SEPERATION,544,286,258,0,424,222,202,0,120,64,56,0
PAKPATTAN,DISTRICT,45 - 49,WIDOWED,4248,3208,1040,0,3126,2322,804,0,1122,886,236,0
PAKPATTAN,DISTRICT,50 - 54,DIVORCED,877,608,269,0,686,479,207,0,191,129,62,0
PAKPATTAN,DISTRICT,50 - 54,MARRIED,67333,30891,36442,0,52065,24085,27980,0,15268,6806,8462,0
PAKPATTAN,DISTRICT,50 - 54,NEVER MARRIED,1537,667,856,14,1191,537,650,4,346,130,206,10
PAKPATTAN,DISTRICT,50 - 54,SEPERATION,479,261,218,0,385,213,172,0,94,48,46,0
PAKPATTAN,DISTRICT,50 - 54,WIDOWED,6077,4621,1456,0,4427,3324,1103,0,1650,1297,353,0
PAKPATTAN,DISTRICT,55 - 59,DIVORCED,633,418,215,0,500,342,158,0,133,76,57,0
PAKPATTAN,DISTRICT,55 - 59,MARRIED,52793,22197,30596,0,40980,17351,23629,0,11813,4846,6967,0
PAKPATTAN,DISTRICT,55 - 59,NEVER MARRIED,1097,485,609,3,865,394,469,2,232,91,140,1
PAKPATTAN,DISTRICT,55 - 59,SEPERATION,367,174,193,0,285,140,145,0,82,34,48,0
PAKPATTAN,DISTRICT,55 - 59,WIDOWED,7021,4997,2024,0,5082,3532,1550,0,1939,1465,474,0
PAKPATTAN,DISTRICT,60 - 64,DIVORCED,462,305,157,0,360,250,110,0,102,55,47,0
PAKPATTAN,DISTRICT,60 - 64,MARRIED,39077,16087,22990,0,31048,12954,18094,0,8029,3133,4896,0
PAKPATTAN,DISTRICT,60 - 64,NEVER MARRIED,778,324,451,3,639,284,352,3,139,40,99,0
PAKPATTAN,DISTRICT,60 - 64,SEPERATION,262,133,129,0,218,115,103,0,44,18,26,0
PAKPATTAN,DISTRICT,60 - 64,WIDOWED,8459,5911,2548,0,6384,4427,1957,0,2075,1484,591,0
PAKPATTAN,DISTRICT,65 - 69,DIVORCED,263,161,102,0,218,136,82,0,45,25,20,0
PAKPATTAN,DISTRICT,65 - 69,MARRIED,24932,10078,14854,0,19868,8146,11722,0,5064,1932,3132,0
PAKPATTAN,DISTRICT,65 - 69,NEVER MARRIED,509,213,296,0,429,182,247,0,80,31,49,0
PAKPATTAN,DISTRICT,65 - 69,SEPERATION,155,74,81,0,127,60,67,0,28,14,14,0
PAKPATTAN,DISTRICT,65 - 69,WIDOWED,8286,5739,2547,0,6244,4283,1961,0,2042,1456,586,0
PAKPATTAN,DISTRICT,70 - 74,DIVORCED,142,75,67,0,115,64,51,0,27,11,16,0
PAKPATTAN,DISTRICT,70 - 74,MARRIED,16189,5736,10453,0,13211,4747,8464,0,2978,989,1989,0
PAKPATTAN,DISTRICT,70 - 74,NEVER MARRIED,273,93,180,0,228,75,153,0,45,18,27,0
PAKPATTAN,DISTRICT,70 - 74,SEPERATION,114,52,62,0,97,43,54,0,17,9,8,0
PAKPATTAN,DISTRICT,70 - 74,WIDOWED,8008,5222,2786,0,6266,4036,2230,0,1742,1186,556,0
PAKPATTAN,DISTRICT,75 & ABOVE,DIVORCED,132,67,65,0,110,56,54,0,22,11,11,0
PAKPATTAN,DISTRICT,75 & ABOVE,MARRIED,14772,4562,10210,0,12372,3861,8511,0,2400,701,1699,0
PAKPATTAN,DISTRICT,75 & ABOVE,NEVER MARRIED,262,83,179,0,222,68,154,0,40,15,25,0
PAKPATTAN,DISTRICT,75 & ABOVE,SEPERATION,91,27,64,0,82,24,58,0,9,3,6,0
PAKPATTAN,DISTRICT,75 & ABOVE,WIDOWED,11851,6982,4869,0,9488,5484,4004,0,2363,1498,865,0
RAHIM YAR KHAN,DISTRICT,15 &  ABOVE,DIVORCED,9315,6048,3267,0,5880,3738,2142,0,3435,2310,1125,0
RAHIM YAR KHAN,DISTRICT,15 &  ABOVE,MARRIED,2181134,1101332,1079802,0,1651338,834199,817139,0,529796,267133,262663,0
RAHIM YAR KHAN,DISTRICT,15 &  ABOVE,NEVER MARRIED,880360,345058,534760,542,626881,240674,386014,193,253479,104384,148746,349
RAHIM YAR KHAN,DISTRICT,15 &  ABOVE,SEPERATION,4530,2547,1983,0,3380,1906,1474,0,1150,641,509,0
RAHIM YAR KHAN,DISTRICT,15 &  ABOVE,WIDOWED,126414,93389,33025,0,91630,67114,24516,0,34784,26275,8509,0
RAHIM YAR KHAN,DISTRICT,15 - 19,DIVORCED,222,175,47,0,172,138,34,0,50,37,13,0
RAHIM YAR KHAN,DISTRICT,15 - 19,MARRIED,57855,40844,17011,0,49212,34485,14727,0,8643,6359,2284,0
RAHIM YAR KHAN,DISTRICT,15 - 19,NEVER MARRIED,485428,214788,270589,51,358524,157072,201417,35,126904,57716,69172,16
RAHIM YAR KHAN,DISTRICT,15 - 19,SEPERATION,139,89,50,0,116,72,44,0,23,17,6,0
RAHIM YAR KHAN,DISTRICT,15 - 19,WIDOWED,164,91,73,0,140,77,63,0,24,14,10,0
RAHIM YAR KHAN,DISTRICT,20 - 24,DIVORCED,903,631,272,0,611,415,196,0,292,216,76,0
RAHIM YAR KHAN,DISTRICT,20 - 24,MARRIED,223673,141696,81977,0,181630,113595,68035,0,42043,28101,13942,0
RAHIM YAR KHAN,DISTRICT,20 - 24,NEVER MARRIED,240375,85102,155181,92,163433,54255,109150,28,76942,30847,46031,64
RAHIM YAR KHAN,DISTRICT,20 - 24,SEPERATION,409,255,154,0,323,198,125,0,86,57,29,0
RAHIM YAR KHAN,DISTRICT,20 - 24,WIDOWED,799,438,361,0,661,359,302,0,138,79,59,0
RAHIM YAR KHAN,DISTRICT,25 - 29,DIVORCED,1446,926,520,0,928,567,361,0,518,359,159,0
RAHIM YAR KHAN,DISTRICT,25 - 29,MARRIED,316094,173403,142691,0,243615,131460,112155,0,72479,41943,30536,0
RAHIM YAR KHAN,DISTRICT,25 - 29,NEVER MARRIED,93632,27217,66314,101,62353,17038,45276,39,31279,10179,21038,62
RAHIM YAR KHAN,DISTRICT,25 - 29,SEPERATION,539,288,251,0,437,240,197,0,102,48,54,0
RAHIM YAR KHAN,DISTRICT,25 - 29,WIDOWED,1687,915,772,0,1317,703,614,0,370,212,158,0
RAHIM YAR KHAN,DISTRICT,30 - 34,DIVORCED,1493,954,539,0,915,558,357,0,578,396,182,0
RAHIM YAR KHAN,DISTRICT,30 - 34,MARRIED,308629,162331,146298,0,229452,120120,109332,0,79177,42211,36966,0
RAHIM YAR KHAN,DISTRICT,30 - 34,NEVER MARRIED,29853,8263,21498,92,20383,5417,14940,26,9470,2846,6558,66
RAHIM YAR KHAN,DISTRICT,30 - 34,SEPERATION,638,359,279,0,456,259,197,0,182,100,82,0
RAHIM YAR KHAN,DISTRICT,30 - 34,WIDOWED,2607,1694,913,0,1943,1238,705,0,664,456,208,0
RAHIM YAR KHAN,DISTRICT,35 - 39,DIVORCED,1486,962,524,0,886,561,325,0,600,401,199,0
RAHIM YAR KHAN,DISTRICT,35 - 39,MARRIED,296429,146552,149877,0,218264,107733,110531,0,78165,38819,39346,0
RAHIM YAR KHAN,DISTRICT,35 - 39,NEVER MARRIED,13981,3940,9959,82,9803,2727,7055,21,4178,1213,2904,61
RAHIM YAR KHAN,DISTRICT,35 - 39,SEPERATION,636,342,294,0,449,245,204,0,187,97,90,0
RAHIM YAR KHAN,DISTRICT,35 - 39,WIDOWED,4285,3057,1228,0,3111,2151,960,0,1174,906,268,0
RAHIM YAR KHAN,DISTRICT,40 - 44,DIVORCED,1238,804,434,0,736,461,275,0,502,343,159,0
RAHIM YAR KHAN,DISTRICT,40 - 44,MARRIED,263446,127119,136327,0,196640,94809,101831,0,66806,32310,34496,0
RAHIM YAR KHAN,DISTRICT,40 - 44,NEVER MARRIED,7069,2245,4780,44,5070,1605,3450,15,1999,640,1330,29
RAHIM YAR KHAN,DISTRICT,40 - 44,SEPERATION,574,328,246,0,419,238,181,0,155,90,65,0
RAHIM YAR KHAN,DISTRICT,40 - 44,WIDOWED,7107,5484,1623,0,5214,3942,1272,0,1893,1542,351,0
RAHIM YAR KHAN,DISTRICT,45 - 49,DIVORCED,811,520,291,0,507,316,191,0,304,204,100,0
RAHIM YAR KHAN,DISTRICT,45 - 49,MARRIED,201151,94272,106879,0,148119,69776,78343,0,53032,24496,28536,0
RAHIM YAR KHAN,DISTRICT,45 - 49,NEVER MARRIED,3990,1254,2708,28,2877,919,1948,10,1113,335,760,18
RAHIM YAR KHAN,DISTRICT,45 - 49,SEPERATION,450,267,183,0,327,192,135,0,123,75,48,0
RAHIM YAR KHAN,DISTRICT,45 - 49,WIDOWED,9292,7450,1842,0,6637,5232,1405,0,2655,2218,437,0
RAHIM YAR KHAN,DISTRICT,50 - 54,DIVORCED,663,411,252,0,427,261,166,0,236,150,86,0
RAHIM YAR KHAN,DISTRICT,50 - 54,MARRIED,165132,74982,90150,0,121881,55624,66257,0,43251,19358,23893,0
RAHIM YAR KHAN,DISTRICT,50 - 54,NEVER MARRIED,2361,841,1505,15,1704,606,1093,5,657,235,412,10
RAHIM YAR KHAN,DISTRICT,50 - 54,SEPERATION,412,231,181,0,311,165,146,0,101,66,35,0
RAHIM YAR KHAN,DISTRICT,50 - 54,WIDOWED,13420,10848,2572,0,9556,7640,1916,0,3864,3208,656,0
RAHIM YAR KHAN,DISTRICT,55 - 59,DIVORCED,400,266,134,0,261,181,80,0,139,85,54,0
RAHIM YAR KHAN,DISTRICT,55 - 59,MARRIED,122526,51910,70616,0,90218,38410,51808,0,32308,13500,18808,0
RAHIM YAR KHAN,DISTRICT,55 - 59,NEVER MARRIED,1434,525,900,9,1024,384,636,4,410,141,264,5
RAHIM YAR KHAN,DISTRICT,55 - 59,SEPERATION,288,161,127,0,205,120,85,0,83,41,42,0
RAHIM YAR KHAN,DISTRICT,55 - 59,WIDOWED,14440,11249,3191,0,10153,7799,2354,0,4287,3450,837,0
RAHIM YAR KHAN,DISTRICT,60 - 64,DIVORCED,302,184,118,0,202,126,76,0,100,58,42,0
RAHIM YAR KHAN,DISTRICT,60 - 64,MARRIED,90954,38280,52674,0,67505,28946,38559,0,23449,9334,14115,0
RAHIM YAR KHAN,DISTRICT,60 - 64,NEVER MARRIED,1021,406,602,13,772,297,471,4,249,109,131,9
RAHIM YAR KHAN,DISTRICT,60 - 64,SEPERATION,203,106,97,0,152,80,72,0,51,26,25,0
RAHIM YAR KHAN,DISTRICT,60 - 64,WIDOWED,17415,13398,4017,0,12374,9471,2903,0,5041,3927,1114,0
RAHIM YAR KHAN,DISTRICT,65 - 69,DIVORCED,187,119,68,0,124,87,37,0,63,32,31,0
RAHIM YAR KHAN,DISTRICT,65 - 69,MARRIED,63129,26510,36619,0,47562,20333,27229,0,15567,6177,9390,0
RAHIM YAR KHAN,DISTRICT,65 - 69,NEVER MARRIED,598,243,348,7,443,173,266,4,155,70,82,3
RAHIM YAR KHAN,DISTRICT,65 - 69,SEPERATION,119,61,58,0,91,49,42,0,28,12,16,0
RAHIM YAR KHAN,DISTRICT,65 - 69,WIDOWED,17621,13385,4236,0,12460,9472,2988,0,5161,3913,1248,0
RAHIM YAR KHAN,DISTRICT,70 - 74,DIVORCED,86,48,38,0,61,35,26,0,25,13,12,0
RAHIM YAR KHAN,DISTRICT,70 - 74,MARRIED,39474,13228,26246,0,30955,10558,20397,0,8519,2670,5849,0
RAHIM YAR KHAN,DISTRICT,70 - 74,NEVER MARRIED,327,116,205,6,251,88,163,0,76,28,42,6
RAHIM YAR KHAN,DISTRICT,70 - 74,SEPERATION,65,28,37,0,47,21,26,0,18,7,11,0
RAHIM YAR KHAN,DISTRICT,70 - 74,WIDOWED,15976,11243,4733,0,11843,8395,3448,0,4133,2848,1285,0
RAHIM YAR KHAN,DISTRICT,75 & ABOVE,DIVORCED,78,48,30,0,50,32,18,0,28,16,12,0
RAHIM YAR KHAN,DISTRICT,75 & ABOVE,MARRIED,32642,10205,22437,0,26285,8350,17935,0,6357,1855,4502,0
RAHIM YAR KHAN,DISTRICT,75 & ABOVE,NEVER MARRIED,291,118,171,2,244,93,149,2,47,25,22,0
RAHIM YAR KHAN,DISTRICT,75 & ABOVE,SEPERATION,58,32,26,0,47,27,20,0,11,5,6,0
RAHIM YAR KHAN,DISTRICT,75 & ABOVE,WIDOWED,21601,14137,7464,0,16221,10635,5586,0,5380,3502,1878,0
RAJANPUR,DISTRICT,15 &  ABOVE,DIVORCED,1630,1141,489,0,841,585,256,0,789,556,233,0
RAJANPUR,DISTRICT,15 &  ABOVE,MARRIED,853788,432921,420867,0,617970,313874,304096,0,235818,119047,116771,0
RAJANPUR,DISTRICT,15 &  ABOVE,NEVER MARRIED,310825,127399,183314,112,203108,80172,122920,16,107717,47227,60394,96
RAJANPUR,DISTRICT,15 &  ABOVE,SEPERATION,1611,905,706,0,1102,592,510,0,509,313,196,0
RAJANPUR,DISTRICT,15 &  ABOVE,WIDOWED,35961,27050,8911,0,23541,17346,6195,0,12420,9704,2716,0
RAJANPUR,DISTRICT,15 - 19,DIVORCED,52,36,16,0,30,20,10,0,22,16,6,0
RAJANPUR,DISTRICT,15 - 19,MARRIED,33590,22990,10600,0,26802,18143,8659,0,6788,4847,1941,0
RAJANPUR,DISTRICT,15 - 19,NEVER MARRIED,190364,86610,103743,11,132055,58658,73390,7,58309,27952,30353,4
RAJANPUR,DISTRICT,15 - 19,SEPERATION,79,32,47,0,64,24,40,0,15,8,7,0
RAJANPUR,DISTRICT,15 - 19,WIDOWED,70,42,28,0,61,37,24,0,9,5,4,0
RAJANPUR,DISTRICT,20 - 24,DIVORCED,189,140,49,0,112,77,35,0,77,63,14,0
RAJANPUR,DISTRICT,20 - 24,MARRIED,104363,63908,40455,0,80580,48612,31968,0,23783,15296,8487,0
RAJANPUR,DISTRICT,20 - 24,NEVER MARRIED,73787,24987,48781,19,45112,13534,31577,1,28675,11453,17204,18
RAJANPUR,DISTRICT,20 - 24,SEPERATION,118,69,49,0,71,36,35,0,47,33,14,0
RAJANPUR,DISTRICT,20 - 24,WIDOWED,314,161,153,0,248,113,135,0,66,48,18,0
RAJANPUR,DISTRICT,25 - 29,DIVORCED,198,139,59,0,108,71,37,0,90,68,22,0
RAJANPUR,DISTRICT,25 - 29,MARRIED,118707,63708,54999,0,86383,45529,40854,0,32324,18179,14145,0
RAJANPUR,DISTRICT,25 - 29,NEVER MARRIED,28172,9757,18394,21,15875,4928,10945,2,12297,4829,7449,19
RAJANPUR,DISTRICT,25 - 29,SEPERATION,174,101,73,0,112,58,54,0,62,43,19,0
RAJANPUR,DISTRICT,25 - 29,WIDOWED,525,282,243,0,366,179,187,0,159,103,56,0
RAJANPUR,DISTRICT,30 - 34,DIVORCED,239,162,77,0,118,82,36,0,121,80,41,0
RAJANPUR,DISTRICT,30 - 34,MARRIED,115370,60768,54602,0,81633,43136,38497,0,33737,17632,16105,0
RAJANPUR,DISTRICT,30 - 34,NEVER MARRIED,9340,3305,6022,13,5094,1664,3429,1,4246,1641,2593,12
RAJANPUR,DISTRICT,30 - 34,SEPERATION,207,121,86,0,134,74,60,0,73,47,26,0
RAJANPUR,DISTRICT,30 - 34,WIDOWED,844,542,302,0,570,339,231,0,274,203,71,0
RAJANPUR,DISTRICT,35 - 39,DIVORCED,261,187,74,0,118,88,30,0,143,99,44,0
RAJANPUR,DISTRICT,35 - 39,MARRIED,112879,55958,56921,0,79708,39638,40070,0,33171,16320,16851,0
RAJANPUR,DISTRICT,35 - 39,NEVER MARRIED,4367,1247,3102,18,2352,621,1729,2,2015,626,1373,16
RAJANPUR,DISTRICT,35 - 39,SEPERATION,185,105,80,0,127,63,64,0,58,42,16,0
RAJANPUR,DISTRICT,35 - 39,WIDOWED,1331,923,408,0,867,585,282,0,464,338,126,0
RAJANPUR,DISTRICT,40 - 44,DIVORCED,228,159,69,0,123,84,39,0,105,75,30,0
RAJANPUR,DISTRICT,40 - 44,MARRIED,103790,50374,53416,0,73715,36047,37668,0,30075,14327,15748,0
RAJANPUR,DISTRICT,40 - 44,NEVER MARRIED,2163,623,1529,11,1185,316,869,0,978,307,660,11
RAJANPUR,DISTRICT,40 - 44,SEPERATION,212,109,103,0,132,67,65,0,80,42,38,0
RAJANPUR,DISTRICT,40 - 44,WIDOWED,2126,1627,499,0,1425,1076,349,0,701,551,150,0
RAJANPUR,DISTRICT,45 - 49,DIVORCED,153,114,39,0,77,56,21,0,76,58,18,0
RAJANPUR,DISTRICT,45 - 49,MARRIED,75389,34734,40655,0,53416,24893,28523,0,21973,9841,12132,0
RAJANPUR,DISTRICT,45 - 49,NEVER MARRIED,1109,344,754,11,624,182,441,1,485,162,313,10
RAJANPUR,DISTRICT,45 - 49,SEPERATION,195,99,96,0,140,74,66,0,55,25,30,0
RAJANPUR,DISTRICT,45 - 49,WIDOWED,2599,2042,557,0,1653,1258,395,0,946,784,162,0
RAJANPUR,DISTRICT,50 - 54,DIVORCED,132,87,45,0,60,40,20,0,72,47,25,0
RAJANPUR,DISTRICT,50 - 54,MARRIED,59933,27655,32278,0,42611,19707,22904,0,17322,7948,9374,0
RAJANPUR,DISTRICT,50 - 54,NEVER MARRIED,623,212,407,4,328,114,213,1,295,98,194,3
RAJANPUR,DISTRICT,50 - 54,SEPERATION,148,87,61,0,97,57,40,0,51,30,21,0
RAJANPUR,DISTRICT,50 - 54,WIDOWED,3547,2828,719,0,2245,1762,483,0,1302,1066,236,0
RAJANPUR,DISTRICT,55 - 59,DIVORCED,77,52,25,0,44,33,11,0,33,19,14,0
RAJANPUR,DISTRICT,55 - 59,MARRIED,43429,18554,24875,0,30292,13054,17238,0,13137,5500,7637,0
RAJANPUR,DISTRICT,55 - 59,NEVER MARRIED,364,128,235,1,185,65,120,0,179,63,115,1
RAJANPUR,DISTRICT,55 - 59,SEPERATION,90,62,28,0,66,45,21,0,24,17,7,0
RAJANPUR,DISTRICT,55 - 59,WIDOWED,3730,2897,833,0,2299,1729,570,0,1431,1168,263,0
RAJANPUR,DISTRICT,60 - 64,DIVORCED,46,35,11,0,23,19,4,0,23,16,7,0
RAJANPUR,DISTRICT,60 - 64,MARRIED,33076,13911,19165,0,23491,10001,13490,0,9585,3910,5675,0
RAJANPUR,DISTRICT,60 - 64,NEVER MARRIED,249,89,158,2,138,44,93,1,111,45,65,1
RAJANPUR,DISTRICT,60 - 64,SEPERATION,89,57,32,0,66,42,24,0,23,15,8,0
RAJANPUR,DISTRICT,60 - 64,WIDOWED,4599,3640,959,0,2931,2280,651,0,1668,1360,308,0
RAJANPUR,DISTRICT,65 - 69,DIVORCED,25,14,11,0,9,4,5,0,16,10,6,0
RAJANPUR,DISTRICT,65 - 69,MARRIED,22142,9697,12445,0,15805,7020,8785,0,6337,2677,3660,0
RAJANPUR,DISTRICT,65 - 69,NEVER MARRIED,142,56,85,1,70,25,45,0,72,31,40,1
RAJANPUR,DISTRICT,65 - 69,SEPERATION,41,24,17,0,31,20,11,0,10,4,6,0
RAJANPUR,DISTRICT,65 - 69,WIDOWED,4492,3521,971,0,2807,2160,647,0,1685,1361,324,0
RAJANPUR,DISTRICT,70 - 74,DIVORCED,16,7,9,0,8,4,4,0,8,3,5,0
RAJANPUR,DISTRICT,70 - 74,MARRIED,16346,6068,10278,0,12146,4547,7599,0,4200,1521,2679,0
RAJANPUR,DISTRICT,70 - 74,NEVER MARRIED,68,19,49,0,43,10,33,0,25,9,16,0
RAJANPUR,DISTRICT,70 - 74,SEPERATION,32,19,13,0,28,17,11,0,4,2,2,0
RAJANPUR,DISTRICT,70 - 74,WIDOWED,4776,3607,1169,0,3154,2385,769,0,1622,1222,400,0
RAJANPUR,DISTRICT,75 & ABOVE,DIVORCED,14,9,5,0,11,7,4,0,3,2,1,0
RAJANPUR,DISTRICT,75 & ABOVE,MARRIED,14774,4596,10178,0,11388,3547,7841,0,3386,1049,2337,0
RAJANPUR,DISTRICT,75 & ABOVE,NEVER MARRIED,77,22,55,0,47,11,36,0,30,11,19,0
RAJANPUR,DISTRICT,75 & ABOVE,SEPERATION,41,20,21,0,34,15,19,0,7,5,2,0
RAJANPUR,DISTRICT,75 & ABOVE,WIDOWED,7008,4938,2070,0,4915,3443,1472,0,2093,1495,598,0
RAWALPINDI,DISTRICT,15 &  ABOVE,DIVORCED,17404,12054,5350,0,7481,5177,2304,0,9923,6877,3046,0
RAWALPINDI,DISTRICT,15 &  ABOVE,MARRIED,2553432,1265984,1287448,0,819635,419509,400126,0,1733797,846475,887322,0
RAWALPINDI,DISTRICT,15 &  ABOVE,NEVER MARRIED,1289310,553450,734529,1331,380088,167809,212240,39,909222,385641,522289,1292
RAWALPINDI,DISTRICT,15 &  ABOVE,SEPERATION,5621,2853,2768,0,2092,1032,1060,0,3529,1821,1708,0
RAWALPINDI,DISTRICT,15 &  ABOVE,WIDOWED,174094,134527,39567,0,74582,58499,16083,0,99512,76028,23484,0
RAWALPINDI,DISTRICT,15 - 19,DIVORCED,77,64,13,0,33,30,3,0,44,34,10,0
RAWALPINDI,DISTRICT,15 - 19,MARRIED,24240,18411,5829,0,7754,6094,1660,0,16486,12317,4169,0
RAWALPINDI,DISTRICT,15 - 19,NEVER MARRIED,549025,266266,282691,68,166743,83075,83664,4,382282,183191,199027,64
RAWALPINDI,DISTRICT,15 - 19,SEPERATION,61,33,28,0,16,13,3,0,45,20,25,0
RAWALPINDI,DISTRICT,15 - 19,WIDOWED,69,49,20,0,26,20,6,0,43,29,14,0
RAWALPINDI,DISTRICT,20 - 24,DIVORCED,786,662,124,0,348,290,58,0,438,372,66,0
RAWALPINDI,DISTRICT,20 - 24,MARRIED,137956,98875,39081,0,45248,33650,11598,0,92708,65225,27483,0
RAWALPINDI,DISTRICT,20 - 24,NEVER MARRIED,391773,163912,227662,199,112941,48058,64878,5,278832,115854,162784,194
RAWALPINDI,DISTRICT,20 - 24,SEPERATION,221,144,77,0,75,54,21,0,146,90,56,0
RAWALPINDI,DISTRICT,20 - 24,WIDOWED,353,255,98,0,125,95,30,0,228,160,68,0
RAWALPINDI,DISTRICT,25 - 29,DIVORCED,1993,1470,523,0,876,643,233,0,1117,827,290,0
RAWALPINDI,DISTRICT,25 - 29,MARRIED,294502,178523,115979,0,93273,59189,34084,0,201229,119334,81895,0
RAWALPINDI,DISTRICT,25 - 29,NEVER MARRIED,196567,65962,130329,276,54435,18035,36397,3,142132,47927,93932,273
RAWALPINDI,DISTRICT,25 - 29,SEPERATION,519,288,231,0,183,101,82,0,336,187,149,0
RAWALPINDI,DISTRICT,25 - 29,WIDOWED,1115,752,363,0,403,265,138,0,712,487,225,0
RAWALPINDI,DISTRICT,30 - 34,DIVORCED,2841,1998,843,0,1118,770,348,0,1723,1228,495,0
RAWALPINDI,DISTRICT,30 - 34,MARRIED,374174,201004,173170,0,117988,66055,51933,0,256186,134949,121237,0
RAWALPINDI,DISTRICT,30 - 34,NEVER MARRIED,71847,26616,44994,237,20644,7563,13074,7,51203,19053,31920,230
RAWALPINDI,DISTRICT,30 - 34,SEPERATION,772,386,386,0,274,127,147,0,498,259,239,0
RAWALPINDI,DISTRICT,30 - 34,WIDOWED,2248,1610,638,0,851,607,244,0,1397,1003,394,0
RAWALPINDI,DISTRICT,35 - 39,DIVORCED,3126,2117,1009,0,1227,818,409,0,1899,1299,600,0
RAWALPINDI,DISTRICT,35 - 39,MARRIED,393137,196365,196772,0,121459,62721,58738,0,271678,133644,138034,0
RAWALPINDI,DISTRICT,35 - 39,NEVER MARRIED,34589,11240,23083,266,9490,3330,6155,5,25099,7910,16928,261
RAWALPINDI,DISTRICT,35 - 39,SEPERATION,852,387,465,0,294,139,155,0,558,248,310,0
RAWALPINDI,DISTRICT,35 - 39,WIDOWED,4243,3305,938,0,1572,1247,325,0,2671,2058,613,0
RAWALPINDI,DISTRICT,40 - 44,DIVORCED,2551,1744,807,0,1025,694,331,0,1526,1050,476,0
RAWALPINDI,DISTRICT,40 - 44,MARRIED,338892,163189,175703,0,104211,51792,52419,0,234681,111397,123284,0
RAWALPINDI,DISTRICT,40 - 44,NEVER MARRIED,16904,6380,10397,127,5104,2121,2979,4,11800,4259,7418,123
RAWALPINDI,DISTRICT,40 - 44,SEPERATION,811,402,409,0,281,142,139,0,530,260,270,0
RAWALPINDI,DISTRICT,40 - 44,WIDOWED,7242,5915,1327,0,2673,2214,459,0,4569,3701,868,0
RAWALPINDI,DISTRICT,45 - 49,DIVORCED,1919,1250,669,0,754,514,240,0,1165,736,429,0
RAWALPINDI,DISTRICT,45 - 49,MARRIED,278631,126813,151818,0,85371,40423,44948,0,193260,86390,106870,0
RAWALPINDI,DISTRICT,45 - 49,NEVER MARRIED,10197,3954,6178,65,3239,1448,1789,2,6958,2506,4389,63
RAWALPINDI,DISTRICT,45 - 49,SEPERATION,686,361,325,0,230,117,113,0,456,244,212,0
RAWALPINDI,DISTRICT,45 - 49,WIDOWED,10654,8977,1677,0,3790,3236,554,0,6864,5741,1123,0
RAWALPINDI,DISTRICT,50 - 54,DIVORCED,1403,930,473,0,629,423,206,0,774,507,267,0
RAWALPINDI,DISTRICT,50 - 54,MARRIED,217857,96173,121684,0,69426,32218,37208,0,148431,63955,84476,0
RAWALPINDI,DISTRICT,50 - 54,NEVER MARRIED,6375,2819,3505,51,2258,1174,1081,3,4117,1645,2424,48
RAWALPINDI,DISTRICT,50 - 54,SEPERATION,528,271,257,0,209,89,120,0,319,182,137,0
RAWALPINDI,DISTRICT,50 - 54,WIDOWED,16184,13689,2495,0,6159,5311,848,0,10025,8378,1647,0
RAWALPINDI,DISTRICT,55 - 59,DIVORCED,1001,666,335,0,489,327,162,0,512,339,173,0
RAWALPINDI,DISTRICT,55 - 59,MARRIED,171515,73421,98094,0,57594,25731,31863,0,113921,47690,66231,0
RAWALPINDI,DISTRICT,55 - 59,NEVER MARRIED,4357,2132,2213,12,1691,957,732,2,2666,1175,1481,10
RAWALPINDI,DISTRICT,55 - 59,SEPERATION,411,214,197,0,160,69,91,0,251,145,106,0
RAWALPINDI,DISTRICT,55 - 59,WIDOWED,19871,16504,3367,0,7967,6767,1200,0,11904,9737,2167,0
RAWALPINDI,DISTRICT,60 - 64,DIVORCED,738,499,239,0,403,279,124,0,335,220,115,0
RAWALPINDI,DISTRICT,60 - 64,MARRIED,133922,52053,81869,0,46295,18477,27818,0,87627,33576,54051,0
RAWALPINDI,DISTRICT,60 - 64,NEVER MARRIED,3096,1641,1444,11,1287,745,542,0,1809,896,902,11
RAWALPINDI,DISTRICT,60 - 64,SEPERATION,319,156,163,0,143,74,69,0,176,82,94,0
RAWALPINDI,DISTRICT,60 - 64,WIDOWED,24928,19981,4947,0,9810,8065,1745,0,15118,11916,3202,0
RAWALPINDI,DISTRICT,65 - 69,DIVORCED,487,351,136,0,280,205,75,0,207,146,61,0
RAWALPINDI,DISTRICT,65 - 69,MARRIED,90538,34738,55800,0,32639,12757,19882,0,57899,21981,35918,0
RAWALPINDI,DISTRICT,65 - 69,NEVER MARRIED,2166,1217,938,11,984,596,387,1,1182,621,551,10
RAWALPINDI,DISTRICT,65 - 69,SEPERATION,226,114,112,0,110,52,58,0,116,62,54,0
RAWALPINDI,DISTRICT,65 - 69,WIDOWED,26353,20752,5601,0,11238,9007,2231,0,15115,11745,3370,0
RAWALPINDI,DISTRICT,70 - 74,DIVORCED,273,178,95,0,167,104,63,0,106,74,32,0
RAWALPINDI,DISTRICT,70 - 74,MARRIED,54159,15321,38838,0,20652,6019,14633,0,33507,9302,24205,0
RAWALPINDI,DISTRICT,70 - 74,NEVER MARRIED,1214,651,561,2,629,338,291,0,585,313,270,2
RAWALPINDI,DISTRICT,70 - 74,SEPERATION,115,51,64,0,66,31,35,0,49,20,29,0
RAWALPINDI,DISTRICT,70 - 74,WIDOWED,24053,17450,6603,0,11181,8385,2796,0,12872,9065,3807,0
RAWALPINDI,DISTRICT,75 & ABOVE,DIVORCED,209,125,84,0,132,80,52,0,77,45,32,0
RAWALPINDI,DISTRICT,75 & ABOVE,MARRIED,43909,11098,32811,0,17725,4383,13342,0,26184,6715,19469,0
RAWALPINDI,DISTRICT,75 & ABOVE,NEVER MARRIED,1200,660,534,6,643,369,271,3,557,291,263,3
RAWALPINDI,DISTRICT,75 & ABOVE,SEPERATION,100,46,54,0,51,24,27,0,49,22,27,0
RAWALPINDI,DISTRICT,75 & ABOVE,WIDOWED,36781,25288,11493,0,18787,13280,5507,0,17994,12008,5986,0
SAHIWAL,DISTRICT,15 &  ABOVE,DIVORCED,10911,7265,3646,0,8172,5436,2736,0,2739,1829,910,0
SAHIWAL,DISTRICT,15 &  ABOVE,MARRIED,1153871,581591,572280,0,851742,430087,421655,0,302129,151504,150625,0
SAHIWAL,DISTRICT,15 &  ABOVE,NEVER MARRIED,527636,225325,302167,144,375926,159720,216125,81,151710,65605,86042,63
SAHIWAL,DISTRICT,15 &  ABOVE,SEPERATION,4301,2325,1976,0,3490,1835,1655,0,811,490,321,0
SAHIWAL,DISTRICT,15 &  ABOVE,WIDOWED,86359,59673,26686,0,63106,42969,20137,0,23253,16704,6549,0
SAHIWAL,DISTRICT,15 - 19,DIVORCED,188,155,33,0,156,131,25,0,32,24,8,0
SAHIWAL,DISTRICT,15 - 19,MARRIED,19040,13901,5139,0,15791,11513,4278,0,3249,2388,861,0
SAHIWAL,DISTRICT,15 - 19,NEVER MARRIED,249912,118846,131048,18,181315,86156,95146,13,68597,32690,35902,5
SAHIWAL,DISTRICT,15 - 19,SEPERATION,93,71,22,0,83,63,20,0,10,8,2,0
SAHIWAL,DISTRICT,15 - 19,WIDOWED,61,36,25,0,51,29,22,0,10,7,3,0
SAHIWAL,DISTRICT,20 - 24,DIVORCED,829,590,239,0,661,471,190,0,168,119,49,0
SAHIWAL,DISTRICT,20 - 24,MARRIED,83654,55927,27727,0,65737,43478,22259,0,17917,12449,5468,0
SAHIWAL,DISTRICT,20 - 24,NEVER MARRIED,151248,61266,89967,15,105199,41619,63572,8,46049,19647,26395,7
SAHIWAL,DISTRICT,20 - 24,SEPERATION,331,212,119,0,271,169,102,0,60,43,17,0
SAHIWAL,DISTRICT,20 - 24,WIDOWED,366,199,167,0,297,152,145,0,69,47,22,0
SAHIWAL,DISTRICT,25 - 29,DIVORCED,1381,915,466,0,1008,641,367,0,373,274,99,0
SAHIWAL,DISTRICT,25 - 29,MARRIED,141909,82869,59040,0,106251,61186,45065,0,35658,21683,13975,0
SAHIWAL,DISTRICT,25 - 29,NEVER MARRIED,69629,24623,44975,31,48455,16856,31584,15,21174,7767,13391,16
SAHIWAL,DISTRICT,25 - 29,SEPERATION,466,266,200,0,381,217,164,0,85,49,36,0
SAHIWAL,DISTRICT,25 - 29,WIDOWED,752,444,308,0,561,321,240,0,191,123,68,0
SAHIWAL,DISTRICT,30 - 34,DIVORCED,1563,1043,520,0,1128,742,386,0,435,301,134,0
SAHIWAL,DISTRICT,30 - 34,MARRIED,166715,89448,77267,0,120980,64629,56351,0,45735,24819,20916,0
SAHIWAL,DISTRICT,30 - 34,NEVER MARRIED,25569,8973,16581,15,17680,6204,11469,7,7889,2769,5112,8
SAHIWAL,DISTRICT,30 - 34,SEPERATION,540,292,248,0,417,219,198,0,123,73,50,0
SAHIWAL,DISTRICT,30 - 34,WIDOWED,1490,983,507,0,1126,731,395,0,364,252,112,0
SAHIWAL,DISTRICT,35 - 39,DIVORCED,1560,1063,497,0,1094,735,359,0,466,328,138,0
SAHIWAL,DISTRICT,35 - 39,MARRIED,163370,81969,81401,0,117470,59072,58398,0,45900,22897,23003,0
SAHIWAL,DISTRICT,35 - 39,NEVER MARRIED,11889,3879,7999,11,8431,2781,5643,7,3458,1098,2356,4
SAHIWAL,DISTRICT,35 - 39,SEPERATION,561,305,256,0,438,230,208,0,123,75,48,0
SAHIWAL,DISTRICT,35 - 39,WIDOWED,2517,1816,701,0,1842,1298,544,0,675,518,157,0
SAHIWAL,DISTRICT,40 - 44,DIVORCED,1501,987,514,0,1061,710,351,0,440,277,163,0
SAHIWAL,DISTRICT,40 - 44,MARRIED,150677,73663,77014,0,109652,53759,55893,0,41025,19904,21121,0
SAHIWAL,DISTRICT,40 - 44,NEVER MARRIED,6566,2364,4187,15,4790,1775,3007,8,1776,589,1180,7
SAHIWAL,DISTRICT,40 - 44,SEPERATION,569,300,269,0,456,227,229,0,113,73,40,0
SAHIWAL,DISTRICT,40 - 44,WIDOWED,4620,3585,1035,0,3392,2615,777,0,1228,970,258,0
SAHIWAL,DISTRICT,45 - 49,DIVORCED,1189,796,393,0,877,588,289,0,312,208,104,0
SAHIWAL,DISTRICT,45 - 49,MARRIED,116425,54146,62279,0,83712,39104,44608,0,32713,15042,17671,0
SAHIWAL,DISTRICT,45 - 49,NEVER MARRIED,4227,1632,2583,12,3167,1254,1908,5,1060,378,675,7
SAHIWAL,DISTRICT,45 - 49,SEPERATION,469,237,232,0,378,189,189,0,91,48,43,0
SAHIWAL,DISTRICT,45 - 49,WIDOWED,6183,4772,1411,0,4462,3389,1073,0,1721,1383,338,0
SAHIWAL,DISTRICT,50 - 54,DIVORCED,971,632,339,0,773,518,255,0,198,114,84,0
SAHIWAL,DISTRICT,50 - 54,MARRIED,95604,43725,51879,0,69308,32014,37294,0,26296,11711,14585,0
SAHIWAL,DISTRICT,50 - 54,NEVER MARRIED,2937,1220,1709,8,2293,996,1291,6,644,224,418,2
SAHIWAL,DISTRICT,50 - 54,SEPERATION,380,213,167,0,311,162,149,0,69,51,18,0
SAHIWAL,DISTRICT,50 - 54,WIDOWED,8800,6726,2074,0,6207,4670,1537,0,2593,2056,537,0
SAHIWAL,DISTRICT,55 - 59,DIVORCED,689,447,242,0,559,366,193,0,130,81,49,0
SAHIWAL,DISTRICT,55 - 59,MARRIED,76880,32548,44332,0,56373,23981,32392,0,20507,8567,11940,0
SAHIWAL,DISTRICT,55 - 59,NEVER MARRIED,2119,931,1180,8,1689,768,918,3,430,163,262,5
SAHIWAL,DISTRICT,55 - 59,SEPERATION,335,166,169,0,274,134,140,0,61,32,29,0
SAHIWAL,DISTRICT,55 - 59,WIDOWED,10398,7649,2749,0,7347,5262,2085,0,3051,2387,664,0
SAHIWAL,DISTRICT,60 - 64,DIVORCED,491,312,179,0,396,256,140,0,95,56,39,0
SAHIWAL,DISTRICT,60 - 64,MARRIED,58689,23965,34724,0,43824,18198,25626,0,14865,5767,9098,0
SAHIWAL,DISTRICT,60 - 64,NEVER MARRIED,1499,676,819,4,1204,556,645,3,295,120,174,1
SAHIWAL,DISTRICT,60 - 64,SEPERATION,231,113,118,0,200,96,104,0,31,17,14,0
SAHIWAL,DISTRICT,60 - 64,WIDOWED,12484,8757,3727,0,8884,6132,2752,0,3600,2625,975,0
SAHIWAL,DISTRICT,65 - 69,DIVORCED,287,186,101,0,227,152,75,0,60,34,26,0
SAHIWAL,DISTRICT,65 - 69,MARRIED,37493,14954,22539,0,28317,11456,16861,0,9176,3498,5678,0
SAHIWAL,DISTRICT,65 - 69,NEVER MARRIED,919,422,495,2,752,346,404,2,167,76,91,0
SAHIWAL,DISTRICT,65 - 69,SEPERATION,143,71,72,0,123,61,62,0,20,10,10,0
SAHIWAL,DISTRICT,65 - 69,WIDOWED,12007,8270,3737,0,8737,5932,2805,0,3270,2338,932,0
SAHIWAL,DISTRICT,70 - 74,DIVORCED,143,64,79,0,125,57,68,0,18,7,11,0
SAHIWAL,DISTRICT,70 - 74,MARRIED,22830,7809,15021,0,17807,6271,11536,0,5023,1538,3485,0
SAHIWAL,DISTRICT,70 - 74,NEVER MARRIED,590,274,314,2,488,228,258,2,102,46,56,0
SAHIWAL,DISTRICT,70 - 74,SEPERATION,97,46,51,0,86,42,44,0,11,4,7,0
SAHIWAL,DISTRICT,70 - 74,WIDOWED,10650,6850,3800,0,7976,5131,2845,0,2674,1719,955,0
SAHIWAL,DISTRICT,75 & ABOVE,DIVORCED,119,75,44,0,107,69,38,0,12,6,6,0
SAHIWAL,DISTRICT,75 & ABOVE,MARRIED,20585,6667,13918,0,16520,5426,11094,0,4065,1241,2824,0
SAHIWAL,DISTRICT,75 & ABOVE,NEVER MARRIED,532,219,310,3,463,181,280,2,69,38,30,1
SAHIWAL,DISTRICT,75 & ABOVE,SEPERATION,86,33,53,0,72,26,46,0,14,7,7,0
SAHIWAL,DISTRICT,75 & ABOVE,WIDOWED,16031,9586,6445,0,12224,7307,4917,0,3807,2279,1528,0
SARGODHA,DISTRICT,15 &  ABOVE,DIVORCED,16579,10735,5844,0,11200,7199,4001,0,5379,3536,1843,0
SARGODHA,DISTRICT,15 &  ABOVE,MARRIED,1739755,876700,863055,0,1099791,555039,544752,0,639964,321661,318303,0
SARGODHA,DISTRICT,15 &  ABOVE,NEVER MARRIED,846778,363208,483195,375,503366,214106,289141,119,343412,149102,194054,256
SARGODHA,DISTRICT,15 &  ABOVE,SEPERATION,6120,3338,2782,0,4322,2337,1985,0,1798,1001,797,0
SARGODHA,DISTRICT,15 &  ABOVE,WIDOWED,140644,97754,42890,0,91751,62302,29449,0,48893,35452,13441,0
SARGODHA,DISTRICT,15 - 19,DIVORCED,287,221,66,0,237,179,58,0,50,42,8,0
SARGODHA,DISTRICT,15 - 19,MARRIED,28119,20479,7640,0,20587,14899,5688,0,7532,5580,1952,0
SARGODHA,DISTRICT,15 - 19,NEVER MARRIED,398581,190714,207828,39,245435,117258,128162,15,153146,73456,79666,24
SARGODHA,DISTRICT,15 - 19,SEPERATION,149,97,52,0,116,76,40,0,33,21,12,0
SARGODHA,DISTRICT,15 - 19,WIDOWED,144,84,60,0,109,68,41,0,35,16,19,0
SARGODHA,DISTRICT,20 - 24,DIVORCED,1147,843,304,0,816,595,221,0,331,248,83,0
SARGODHA,DISTRICT,20 - 24,MARRIED,120831,82047,38784,0,82752,55333,27419,0,38079,26714,11365,0
SARGODHA,DISTRICT,20 - 24,NEVER MARRIED,252735,104878,147778,79,143690,57740,85924,26,109045,47138,61854,53
SARGODHA,DISTRICT,20 - 24,SEPERATION,381,246,135,0,281,175,106,0,100,71,29,0
SARGODHA,DISTRICT,20 - 24,WIDOWED,545,315,230,0,398,233,165,0,147,82,65,0
SARGODHA,DISTRICT,25 - 29,DIVORCED,2029,1377,652,0,1346,887,459,0,683,490,193,0
SARGODHA,DISTRICT,25 - 29,MARRIED,217614,129446,88168,0,139475,81820,57655,0,78139,47626,30513,0
SARGODHA,DISTRICT,25 - 29,NEVER MARRIED,113268,38984,74209,75,64538,21596,42920,22,48730,17388,31289,53
SARGODHA,DISTRICT,25 - 29,SEPERATION,669,394,275,0,478,276,202,0,191,118,73,0
SARGODHA,DISTRICT,25 - 29,WIDOWED,1315,784,531,0,893,507,386,0,422,277,145,0
SARGODHA,DISTRICT,30 - 34,DIVORCED,2582,1637,945,0,1632,1002,630,0,950,635,315,0
SARGODHA,DISTRICT,30 - 34,MARRIED,257665,139191,118474,0,160738,86419,74319,0,96927,52772,44155,0
SARGODHA,DISTRICT,30 - 34,NEVER MARRIED,39940,14522,25358,60,23562,8552,14985,25,16378,5970,10373,35
SARGODHA,DISTRICT,30 - 34,SEPERATION,740,390,350,0,510,262,248,0,230,128,102,0
SARGODHA,DISTRICT,30 - 34,WIDOWED,2477,1689,788,0,1652,1091,561,0,825,598,227,0
SARGODHA,DISTRICT,35 - 39,DIVORCED,2525,1621,904,0,1637,1036,601,0,888,585,303,0
SARGODHA,DISTRICT,35 - 39,MARRIED,248883,125811,123072,0,152094,76904,75190,0,96789,48907,47882,0
SARGODHA,DISTRICT,35 - 39,NEVER MARRIED,17509,5273,12197,39,10410,3124,7273,13,7099,2149,4924,26
SARGODHA,DISTRICT,35 - 39,SEPERATION,837,443,394,0,547,285,262,0,290,158,132,0
SARGODHA,DISTRICT,35 - 39,WIDOWED,4293,3144,1149,0,2785,1991,794,0,1508,1153,355,0
SARGODHA,DISTRICT,40 - 44,DIVORCED,2185,1434,751,0,1444,938,506,0,741,496,245,0
SARGODHA,DISTRICT,40 - 44,MARRIED,216226,104968,111258,0,133510,64930,68580,0,82716,40038,42678,0
SARGODHA,DISTRICT,40 - 44,NEVER MARRIED,8710,2836,5842,32,5290,1778,3507,5,3420,1058,2335,27
SARGODHA,DISTRICT,40 - 44,SEPERATION,708,386,322,0,500,273,227,0,208,113,95,0
SARGODHA,DISTRICT,40 - 44,WIDOWED,6941,5442,1499,0,4419,3385,1034,0,2522,2057,465,0
SARGODHA,DISTRICT,45 - 49,DIVORCED,1713,1094,619,0,1207,781,426,0,506,313,193,0
SARGODHA,DISTRICT,45 - 49,MARRIED,169836,80083,89753,0,103774,49518,54256,0,66062,30565,35497,0
SARGODHA,DISTRICT,45 - 49,NEVER MARRIED,5310,1803,3494,13,3269,1178,2087,4,2041,625,1407,9
SARGODHA,DISTRICT,45 - 49,SEPERATION,638,331,307,0,445,233,212,0,193,98,95,0
SARGODHA,DISTRICT,45 - 49,WIDOWED,9056,7244,1812,0,5700,4466,1234,0,3356,2778,578,0
SARGODHA,DISTRICT,50 - 54,DIVORCED,1385,883,502,0,958,608,350,0,427,275,152,0
SARGODHA,DISTRICT,50 - 54,MARRIED,145090,65802,79288,0,90596,41416,49180,0,54494,24386,30108,0
SARGODHA,DISTRICT,50 - 54,NEVER MARRIED,3495,1357,2124,14,2240,886,1352,2,1255,471,772,12
SARGODHA,DISTRICT,50 - 54,SEPERATION,557,323,234,0,395,223,172,0,162,100,62,0
SARGODHA,DISTRICT,50 - 54,WIDOWED,13796,10774,3022,0,8636,6637,1999,0,5160,4137,1023,0
SARGODHA,DISTRICT,55 - 59,DIVORCED,1078,668,410,0,749,474,275,0,329,194,135,0
SARGODHA,DISTRICT,55 - 59,MARRIED,118136,49694,68442,0,74664,31514,43150,0,43472,18180,25292,0
SARGODHA,DISTRICT,55 - 59,NEVER MARRIED,2533,1017,1510,6,1662,704,957,1,871,313,553,5
SARGODHA,DISTRICT,55 - 59,SEPERATION,483,240,243,0,350,175,175,0,133,65,68,0
SARGODHA,DISTRICT,55 - 59,WIDOWED,16190,12042,4148,0,10033,7266,2767,0,6157,4776,1381,0
SARGODHA,DISTRICT,60 - 64,DIVORCED,716,452,264,0,510,323,187,0,206,129,77,0
SARGODHA,DISTRICT,60 - 64,MARRIED,88642,34773,53869,0,55718,22181,33537,0,32924,12592,20332,0
SARGODHA,DISTRICT,60 - 64,NEVER MARRIED,1910,770,1130,10,1297,558,734,5,613,212,396,5
SARGODHA,DISTRICT,60 - 64,SEPERATION,411,220,191,0,300,162,138,0,111,58,53,0
SARGODHA,DISTRICT,60 - 64,WIDOWED,19012,13696,5316,0,11984,8435,3549,0,7028,5261,1767,0
SARGODHA,DISTRICT,65 - 69,DIVORCED,476,281,195,0,331,206,125,0,145,75,70,0
SARGODHA,DISTRICT,65 - 69,MARRIED,59551,23502,36049,0,38181,15364,22817,0,21370,8138,13232,0
SARGODHA,DISTRICT,65 - 69,NEVER MARRIED,1240,492,740,8,851,341,509,1,389,151,231,7
SARGODHA,DISTRICT,65 - 69,SEPERATION,246,126,120,0,181,90,91,0,65,36,29,0
SARGODHA,DISTRICT,65 - 69,WIDOWED,19512,13530,5982,0,12418,8442,3976,0,7094,5088,2006,0
SARGODHA,DISTRICT,70 - 74,DIVORCED,261,120,141,0,185,87,98,0,76,33,43,0
SARGODHA,DISTRICT,70 - 74,MARRIED,36521,11507,25014,0,24678,8045,16633,0,11843,3462,8381,0
SARGODHA,DISTRICT,70 - 74,NEVER MARRIED,759,271,488,0,554,184,370,0,205,87,118,0
SARGODHA,DISTRICT,70 - 74,SEPERATION,162,81,81,0,118,60,58,0,44,21,23,0
SARGODHA,DISTRICT,70 - 74,WIDOWED,18030,11540,6490,0,12125,7652,4473,0,5905,3888,2017,0
SARGODHA,DISTRICT,75 & ABOVE,DIVORCED,195,104,91,0,148,83,65,0,47,21,26,0
SARGODHA,DISTRICT,75 & ABOVE,MARRIED,32641,9397,23244,0,23024,6696,16328,0,9617,2701,6916,0
SARGODHA,DISTRICT,75 & ABOVE,NEVER MARRIED,788,291,497,0,568,207,361,0,220,84,136,0
SARGODHA,DISTRICT,75 & ABOVE,SEPERATION,139,61,78,0,101,47,54,0,38,14,24,0
SARGODHA,DISTRICT,75 & ABOVE,WIDOWED,29333,17470,11863,0,20599,12129,8470,0,8734,5341,3393,0
SHEIKHUPURA,DISTRICT,15 &  ABOVE,DIVORCED,8226,4871,3355,0,4856,2850,2006,0,3370,2021,1349,0
SHEIKHUPURA,DISTRICT,15 &  ABOVE,MARRIED,1606381,795143,811238,0,986935,486831,500104,0,619446,308312,311134,0
SHEIKHUPURA,DISTRICT,15 &  ABOVE,NEVER MARRIED,785326,338150,446606,570,477288,203478,273478,332,308038,134672,173128,238
SHEIKHUPURA,DISTRICT,15 &  ABOVE,SEPERATION,3134,1477,1657,0,1966,901,1065,0,1168,576,592,0
SHEIKHUPURA,DISTRICT,15 &  ABOVE,WIDOWED,87956,57563,30393,0,52543,33552,18991,0,35413,24011,11402,0
SHEIKHUPURA,DISTRICT,15 - 19,DIVORCED,129,107,22,0,89,73,16,0,40,34,6,0
SHEIKHUPURA,DISTRICT,15 - 19,MARRIED,20670,14792,5878,0,14080,10045,4035,0,6590,4747,1843,0
SHEIKHUPURA,DISTRICT,15 - 19,NEVER MARRIED,393125,188958,204025,142,243086,116757,126228,101,150039,72201,77797,41
SHEIKHUPURA,DISTRICT,15 - 19,SEPERATION,101,54,47,0,46,34,12,0,55,20,35,0
SHEIKHUPURA,DISTRICT,15 - 19,WIDOWED,79,39,40,0,49,26,23,0,30,13,17,0
SHEIKHUPURA,DISTRICT,20 - 24,DIVORCED,788,547,241,0,512,355,157,0,276,192,84,0
SHEIKHUPURA,DISTRICT,20 - 24,MARRIED,122735,82561,40174,0,78856,52647,26209,0,43879,29914,13965,0
SHEIKHUPURA,DISTRICT,20 - 24,NEVER MARRIED,239753,96801,142853,99,144284,56630,87582,72,95469,40171,55271,27
SHEIKHUPURA,DISTRICT,20 - 24,SEPERATION,227,134,93,0,141,90,51,0,86,44,42,0
SHEIKHUPURA,DISTRICT,20 - 24,WIDOWED,387,223,164,0,255,142,113,0,132,81,51,0
SHEIKHUPURA,DISTRICT,25 - 29,DIVORCED,1346,888,458,0,778,488,290,0,568,400,168,0
SHEIKHUPURA,DISTRICT,25 - 29,MARRIED,224305,128065,96240,0,138506,78267,60239,0,85799,49798,36001,0
SHEIKHUPURA,DISTRICT,25 - 29,NEVER MARRIED,98738,33803,64835,100,58571,19273,39243,55,40167,14530,25592,45
SHEIKHUPURA,DISTRICT,25 - 29,SEPERATION,406,203,203,0,262,125,137,0,144,78,66,0
SHEIKHUPURA,DISTRICT,25 - 29,WIDOWED,1020,597,423,0,644,369,275,0,376,228,148,0
SHEIKHUPURA,DISTRICT,30 - 34,DIVORCED,1426,839,587,0,784,448,336,0,642,391,251,0
SHEIKHUPURA,DISTRICT,30 - 34,MARRIED,241947,126290,115657,0,147680,76268,71412,0,94267,50022,44245,0
SHEIKHUPURA,DISTRICT,30 - 34,NEVER MARRIED,28789,12265,16465,59,17090,7123,9941,26,11699,5142,6524,33
SHEIKHUPURA,DISTRICT,30 - 34,SEPERATION,445,203,242,0,263,109,154,0,182,94,88,0
SHEIKHUPURA,DISTRICT,30 - 34,WIDOWED,1746,1143,603,0,1075,683,392,0,671,460,211,0
SHEIKHUPURA,DISTRICT,35 - 39,DIVORCED,1343,755,588,0,751,421,330,0,592,334,258,0
SHEIKHUPURA,DISTRICT,35 - 39,MARRIED,233529,113644,119885,0,140716,67611,73105,0,92813,46033,46780,0
SHEIKHUPURA,DISTRICT,35 - 39,NEVER MARRIED,11735,2948,8726,61,6540,1602,4905,33,5195,1346,3821,28
SHEIKHUPURA,DISTRICT,35 - 39,SEPERATION,481,214,267,0,299,129,170,0,182,85,97,0
SHEIKHUPURA,DISTRICT,35 - 39,WIDOWED,3008,2075,933,0,1813,1201,612,0,1195,874,321,0
SHEIKHUPURA,DISTRICT,40 - 44,DIVORCED,1039,568,471,0,610,334,276,0,429,234,195,0
SHEIKHUPURA,DISTRICT,40 - 44,MARRIED,204332,96236,108096,0,124800,58552,66248,0,79532,37684,41848,0
SHEIKHUPURA,DISTRICT,40 - 44,NEVER MARRIED,5496,1294,4157,45,3093,791,2284,18,2403,503,1873,27
SHEIKHUPURA,DISTRICT,40 - 44,SEPERATION,403,195,208,0,252,120,132,0,151,75,76,0
SHEIKHUPURA,DISTRICT,40 - 44,WIDOWED,4918,3649,1269,0,2981,2151,830,0,1937,1498,439,0
SHEIKHUPURA,DISTRICT,45 - 49,DIVORCED,783,456,327,0,458,268,190,0,325,188,137,0
SHEIKHUPURA,DISTRICT,45 - 49,MARRIED,163206,73509,89697,0,98286,44342,53944,0,64920,29167,35753,0
SHEIKHUPURA,DISTRICT,45 - 49,NEVER MARRIED,3215,777,2409,29,1815,473,1332,10,1400,304,1077,19
SHEIKHUPURA,DISTRICT,45 - 49,SEPERATION,321,154,167,0,205,98,107,0,116,56,60,0
SHEIKHUPURA,DISTRICT,45 - 49,WIDOWED,6796,5127,1669,0,3973,2961,1012,0,2823,2166,657,0
SHEIKHUPURA,DISTRICT,50 - 54,DIVORCED,520,287,233,0,328,182,146,0,192,105,87,0
SHEIKHUPURA,DISTRICT,50 - 54,MARRIED,126212,55309,70903,0,76532,33605,42927,0,49680,21704,27976,0
SHEIKHUPURA,DISTRICT,50 - 54,NEVER MARRIED,1724,464,1246,14,1012,293,711,8,712,171,535,6
SHEIKHUPURA,DISTRICT,50 - 54,SEPERATION,242,115,127,0,159,70,89,0,83,45,38,0
SHEIKHUPURA,DISTRICT,50 - 54,WIDOWED,9318,6895,2423,0,5412,3938,1474,0,3906,2957,949,0
SHEIKHUPURA,DISTRICT,55 - 59,DIVORCED,358,183,175,0,228,120,108,0,130,63,67,0
SHEIKHUPURA,DISTRICT,55 - 59,MARRIED,98542,41623,56919,0,60391,25495,34896,0,38151,16128,22023,0
SHEIKHUPURA,DISTRICT,55 - 59,NEVER MARRIED,1115,329,779,7,708,209,495,4,407,120,284,3
SHEIKHUPURA,DISTRICT,55 - 59,SEPERATION,210,89,121,0,125,50,75,0,85,39,46,0
SHEIKHUPURA,DISTRICT,55 - 59,WIDOWED,10628,7454,3174,0,6113,4156,1957,0,4515,3298,1217,0
SHEIKHUPURA,DISTRICT,60 - 64,DIVORCED,250,121,129,0,151,81,70,0,99,40,59,0
SHEIKHUPURA,DISTRICT,60 - 64,MARRIED,73876,29381,44495,0,45288,18162,27126,0,28588,11219,17369,0
SHEIKHUPURA,DISTRICT,60 - 64,NEVER MARRIED,707,229,471,7,449,143,304,2,258,86,167,5
SHEIKHUPURA,DISTRICT,60 - 64,SEPERATION,127,50,77,0,84,29,55,0,43,21,22,0
SHEIKHUPURA,DISTRICT,60 - 64,WIDOWED,12737,8619,4118,0,7356,4808,2548,0,5381,3811,1570,0
SHEIKHUPURA,DISTRICT,65 - 69,DIVORCED,128,58,70,0,79,34,45,0,49,24,25,0
SHEIKHUPURA,DISTRICT,65 - 69,MARRIED,46543,18037,28506,0,28745,11311,17434,0,17798,6726,11072,0
SHEIKHUPURA,DISTRICT,65 - 69,NEVER MARRIED,412,150,256,6,271,99,169,3,141,51,87,3
SHEIKHUPURA,DISTRICT,65 - 69,SEPERATION,73,34,39,0,54,24,30,0,19,10,9,0
SHEIKHUPURA,DISTRICT,65 - 69,WIDOWED,11659,7582,4077,0,6769,4301,2468,0,4890,3281,1609,0
SHEIKHUPURA,DISTRICT,70 - 74,DIVORCED,57,27,30,0,46,22,24,0,11,5,6,0
SHEIKHUPURA,DISTRICT,70 - 74,MARRIED,25955,8142,17813,0,16501,5337,11164,0,9454,2805,6649,0
SHEIKHUPURA,DISTRICT,70 - 74,NEVER MARRIED,248,68,180,0,162,38,124,0,86,30,56,0
SHEIKHUPURA,DISTRICT,70 - 74,SEPERATION,43,13,30,0,32,9,23,0,11,4,7,0
SHEIKHUPURA,DISTRICT,70 - 74,WIDOWED,9719,5654,4065,0,5926,3448,2478,0,3793,2206,1587,0
SHEIKHUPURA,DISTRICT,75 & ABOVE,DIVORCED,59,35,24,0,42,24,18,0,17,11,6,0
SHEIKHUPURA,DISTRICT,75 & ABOVE,MARRIED,24529,7554,16975,0,16554,5189,11365,0,7975,2365,5610,0
SHEIKHUPURA,DISTRICT,75 & ABOVE,NEVER MARRIED,269,64,204,1,207,47,160,0,62,17,44,1
SHEIKHUPURA,DISTRICT,75 & ABOVE,SEPERATION,55,19,36,0,44,14,30,0,11,5,6,0
SHEIKHUPURA,DISTRICT,75 & ABOVE,WIDOWED,15941,8506,7435,0,10177,5368,4809,0,5764,3138,2626,0
SIALKOT,DISTRICT,15 &  ABOVE,DIVORCED,12099,7715,4384,0,7951,4985,2966,0,4148,2730,1418,0
SIALKOT,DISTRICT,15 &  ABOVE,MARRIED,1780354,925376,854978,0,1193907,626569,567338,0,586447,298807,287640,0
SIALKOT,DISTRICT,15 &  ABOVE,NEVER MARRIED,915242,394946,519834,462,607639,264791,342652,196,307603,130155,177182,266
SIALKOT,DISTRICT,15 &  ABOVE,SEPERATION,2987,1634,1353,0,1849,1013,836,0,1138,621,517,0
SIALKOT,DISTRICT,15 &  ABOVE,WIDOWED,129682,89122,40560,0,86354,58263,28091,0,43328,30859,12469,0
SIALKOT,DISTRICT,15 - 19,DIVORCED,80,67,13,0,59,51,8,0,21,16,5,0
SIALKOT,DISTRICT,15 - 19,MARRIED,14878,10821,4057,0,10545,7696,2849,0,4333,3125,1208,0
SIALKOT,DISTRICT,15 - 19,NEVER MARRIED,445429,211290,234097,42,304864,145619,159221,24,140565,65671,74876,18
SIALKOT,DISTRICT,15 - 19,SEPERATION,45,30,15,0,26,18,8,0,19,12,7,0
SIALKOT,DISTRICT,15 - 19,WIDOWED,67,37,30,0,45,24,21,0,22,13,9,0
SIALKOT,DISTRICT,20 - 24,DIVORCED,879,687,192,0,632,484,148,0,247,203,44,0
SIALKOT,DISTRICT,20 - 24,MARRIED,113993,81399,32594,0,80146,57372,22774,0,33847,24027,9820,0
SIALKOT,DISTRICT,20 - 24,NEVER MARRIED,294898,126753,168067,78,195972,84574,111369,29,98926,42179,56698,49
SIALKOT,DISTRICT,20 - 24,SEPERATION,150,101,49,0,109,79,30,0,41,22,19,0
SIALKOT,DISTRICT,20 - 24,WIDOWED,355,236,119,0,230,153,77,0,125,83,42,0
SIALKOT,DISTRICT,25 - 29,DIVORCED,1811,1236,575,0,1257,847,410,0,554,389,165,0
SIALKOT,DISTRICT,25 - 29,MARRIED,230907,144537,86370,0,157827,99578,58249,0,73080,44959,28121,0
SIALKOT,DISTRICT,25 - 29,NEVER MARRIED,112671,38871,73726,74,70720,24556,46128,36,41951,14315,27598,38
SIALKOT,DISTRICT,25 - 29,SEPERATION,273,170,103,0,172,103,69,0,101,67,34,0
SIALKOT,DISTRICT,25 - 29,WIDOWED,989,627,362,0,691,441,250,0,298,186,112,0
SIALKOT,DISTRICT,30 - 34,DIVORCED,2108,1350,758,0,1359,852,507,0,749,498,251,0
SIALKOT,DISTRICT,30 - 34,MARRIED,267892,148690,119202,0,178054,99492,78562,0,89838,49198,40640,0
SIALKOT,DISTRICT,30 - 34,NEVER MARRIED,32025,8701,23250,74,18857,4927,13896,34,13168,3774,9354,40
SIALKOT,DISTRICT,30 - 34,SEPERATION,370,194,176,0,224,116,108,0,146,78,68,0
SIALKOT,DISTRICT,30 - 34,WIDOWED,1865,1276,589,0,1271,867,404,0,594,409,185,0
SIALKOT,DISTRICT,35 - 39,DIVORCED,2015,1269,746,0,1272,784,488,0,743,485,258,0
SIALKOT,DISTRICT,35 - 39,MARRIED,254687,132826,121861,0,168157,88427,79730,0,86530,44399,42131,0
SIALKOT,DISTRICT,35 - 39,NEVER MARRIED,12633,3578,8995,60,7199,1940,5238,21,5434,1638,3757,39
SIALKOT,DISTRICT,35 - 39,SEPERATION,421,237,184,0,262,146,116,0,159,91,68,0
SIALKOT,DISTRICT,35 - 39,WIDOWED,3265,2386,879,0,2138,1530,608,0,1127,856,271,0
SIALKOT,DISTRICT,40 - 44,DIVORCED,1671,1060,611,0,1066,658,408,0,605,402,203,0
SIALKOT,DISTRICT,40 - 44,MARRIED,228482,116463,112019,0,151814,77859,73955,0,76668,38604,38064,0
SIALKOT,DISTRICT,40 - 44,NEVER MARRIED,6313,1948,4319,46,3508,1046,2445,17,2805,902,1874,29
SIALKOT,DISTRICT,40 - 44,SEPERATION,430,253,177,0,268,160,108,0,162,93,69,0
SIALKOT,DISTRICT,40 - 44,WIDOWED,5849,4555,1294,0,3897,2996,901,0,1952,1559,393,0
SIALKOT,DISTRICT,45 - 49,DIVORCED,1191,715,476,0,745,444,301,0,446,271,175,0
SIALKOT,DISTRICT,45 - 49,MARRIED,185354,89297,96057,0,121942,59037,62905,0,63412,30260,33152,0
SIALKOT,DISTRICT,45 - 49,NEVER MARRIED,3912,1213,2667,32,2217,676,1530,11,1695,537,1137,21
SIALKOT,DISTRICT,45 - 49,SEPERATION,354,195,159,0,207,113,94,0,147,82,65,0
SIALKOT,DISTRICT,45 - 49,WIDOWED,8207,6475,1732,0,5273,4067,1206,0,2934,2408,526,0
SIALKOT,DISTRICT,50 - 54,DIVORCED,872,519,353,0,569,347,222,0,303,172,131,0
SIALKOT,DISTRICT,50 - 54,MARRIED,150790,69100,81690,0,99691,46145,53546,0,51099,22955,28144,0
SIALKOT,DISTRICT,50 - 54,NEVER MARRIED,2551,870,1651,30,1406,490,904,12,1145,380,747,18
SIALKOT,DISTRICT,50 - 54,SEPERATION,288,158,130,0,175,97,78,0,113,61,52,0
SIALKOT,DISTRICT,50 - 54,WIDOWED,12347,9560,2787,0,7866,5949,1917,0,4481,3611,870,0
SIALKOT,DISTRICT,55 - 59,DIVORCED,553,323,230,0,358,196,162,0,195,127,68,0
SIALKOT,DISTRICT,55 - 59,MARRIED,118229,52459,65770,0,79290,35298,43992,0,38939,17161,21778,0
SIALKOT,DISTRICT,55 - 59,NEVER MARRIED,1694,554,1129,11,986,321,660,5,708,233,469,6
SIALKOT,DISTRICT,55 - 59,SEPERATION,234,107,127,0,132,59,73,0,102,48,54,0
SIALKOT,DISTRICT,55 - 59,WIDOWED,14851,11087,3764,0,9616,7000,2616,0,5235,4087,1148,0
SIALKOT,DISTRICT,60 - 64,DIVORCED,421,228,193,0,267,137,130,0,154,91,63,0
SIALKOT,DISTRICT,60 - 64,MARRIED,90356,36294,54062,0,60260,24657,35603,0,30096,11637,18459,0
SIALKOT,DISTRICT,60 - 64,NEVER MARRIED,1263,464,793,6,721,247,473,1,542,217,320,5
SIALKOT,DISTRICT,60 - 64,SEPERATION,173,89,84,0,116,59,57,0,57,30,27,0
SIALKOT,DISTRICT,60 - 64,WIDOWED,18761,13289,5472,0,12094,8394,3700,0,6667,4895,1772,0
SIALKOT,DISTRICT,65 - 69,DIVORCED,242,136,106,0,165,85,80,0,77,51,26,0
SIALKOT,DISTRICT,65 - 69,MARRIED,59294,23138,36156,0,39885,15934,23951,0,19409,7204,12205,0
SIALKOT,DISTRICT,65 - 69,NEVER MARRIED,796,324,469,3,480,174,303,3,316,150,166,0
SIALKOT,DISTRICT,65 - 69,SEPERATION,129,45,84,0,77,25,52,0,52,20,32,0
SIALKOT,DISTRICT,65 - 69,WIDOWED,18249,12475,5774,0,11983,8048,3935,0,6266,4427,1839,0
SIALKOT,DISTRICT,70 - 74,DIVORCED,125,65,60,0,98,53,45,0,27,12,15,0
SIALKOT,DISTRICT,70 - 74,MARRIED,33272,10426,22846,0,22902,7523,15379,0,10370,2903,7467,0
SIALKOT,DISTRICT,70 - 74,NEVER MARRIED,476,168,305,3,307,89,216,2,169,79,89,1
SIALKOT,DISTRICT,70 - 74,SEPERATION,65,32,33,0,41,20,21,0,24,12,12,0
SIALKOT,DISTRICT,70 - 74,WIDOWED,16281,10220,6061,0,10993,6851,4142,0,5288,3369,1919,0
SIALKOT,DISTRICT,75 & ABOVE,DIVORCED,131,60,71,0,104,47,57,0,27,13,14,
SIALKOT,DISTRICT,75 & ABOVE,MARRIED,32220,9926,22294,0,23394,7551,15843,0,8826,2375,6451,
SIALKOT,DISTRICT,75 & ABOVE,NEVER MARRIED,581,212,366,3,402,132,269,1,179,80,97,2
SIALKOT,DISTRICT,75 & ABOVE,SEPERATION,55,23,32,0,40,18,22,0,15,5,10,
SIALKOT,DISTRICT,75 & ABOVE,WIDOWED,28596,16899,11697,0,20257,11943,8314,0,8339,4956,3383,
TOBA TEK SINGH,DISTRICT,15 &  ABOVE,DIVORCED,8575,5457,3118,,6591,4195,2396,,1984,1262,722,
TOBA TEK SINGH,DISTRICT,15 &  ABOVE,MARRIED,1044941,531334,513607,,813985,414231,399754,,230956,117103,113853,
TOBA TEK SINGH,DISTRICT,15 &  ABOVE,NEVER MARRIED,484848,199799,284815,234,366583,149772,216722,89,118265,50027,68093,145
TOBA TEK SINGH,DISTRICT,15 &  ABOVE,SEPERATION,2403,1210,1193,,1863,936,927,,540,274,266,
TOBA TEK SINGH,DISTRICT,15 &  ABOVE,WIDOWED,76386,52389,23997,,58186,39320,18866,,18200,13069,5131,
TOBA TEK SINGH,DISTRICT,15 - 19,DIVORCED,130,107,23,,107,92,15,,23,15,8,
TOBA TEK SINGH,DISTRICT,15 - 19,MARRIED,15199,11019,4180,,13045,9421,3624,,2154,1598,556,
TOBA TEK SINGH,DISTRICT,15 - 19,NEVER MARRIED,230398,106477,123906,15,177082,81568,95506,8,53316,24909,28400,7
TOBA TEK SINGH,DISTRICT,15 - 19,SEPERATION,57,37,20,,51,34,17,,6,3,3,
TOBA TEK SINGH,DISTRICT,15 - 19,WIDOWED,46,26,20,,40,22,18,,6,4,2,
TOBA TEK SINGH,DISTRICT,20 - 24,DIVORCED,666,487,179,,530,384,146,,136,103,33,
TOBA TEK SINGH,DISTRICT,20 - 24,MARRIED,72363,49481,22882,,59030,40037,18993,,13333,9444,3889,
TOBA TEK SINGH,DISTRICT,20 - 24,NEVER MARRIED,147006,59317,87662,27,110211,43495,66708,8,36795,15822,20954,19
TOBA TEK SINGH,DISTRICT,20 - 24,SEPERATION,176,113,63,,141,94,47,,35,19,16,
TOBA TEK SINGH,DISTRICT,20 - 24,WIDOWED,266,143,123,,212,103,109,,54,40,14,
TOBA TEK SINGH,DISTRICT,25 - 29,DIVORCED,1088,719,369,,803,526,277,,285,193,92,
TOBA TEK SINGH,DISTRICT,25 - 29,MARRIED,131109,78561,52548,,102906,61159,41747,,28203,17402,10801,
TOBA TEK SINGH,DISTRICT,25 - 29,NEVER MARRIED,63430,20577,42824,29,46610,14658,31945,7,16820,5919,10879,22
TOBA TEK SINGH,DISTRICT,25 - 29,SEPERATION,256,132,124,,192,95,97,,64,37,27,
TOBA TEK SINGH,DISTRICT,25 - 29,WIDOWED,670,409,261,,533,320,213,,137,89,48,
TOBA TEK SINGH,DISTRICT,30 - 34,DIVORCED,1298,859,439,,987,654,333,,311,205,106,
TOBA TEK SINGH,DISTRICT,30 - 34,MARRIED,151369,81695,69674,,115929,62508,53421,,35440,19187,16253,
TOBA TEK SINGH,DISTRICT,30 - 34,NEVER MARRIED,20681,5566,15079,36,15091,4003,11075,13,5590,1563,4004,23
TOBA TEK SINGH,DISTRICT,30 - 34,SEPERATION,284,145,139,,222,113,109,,62,32,30,
TOBA TEK SINGH,DISTRICT,30 - 34,WIDOWED,1286,883,403,,962,646,316,,324,237,87,
TOBA TEK SINGH,DISTRICT,35 - 39,DIVORCED,1268,791,477,,920,570,350,,348,221,127,
TOBA TEK SINGH,DISTRICT,35 - 39,MARRIED,145677,74050,71627,,111221,56511,54710,,34456,17539,16917,
TOBA TEK SINGH,DISTRICT,35 - 39,NEVER MARRIED,8800,2471,6291,38,6471,1819,4639,13,2329,652,1652,25
TOBA TEK SINGH,DISTRICT,35 - 39,SEPERATION,294,137,157,,221,101,120,,73,36,37,
TOBA TEK SINGH,DISTRICT,35 - 39,WIDOWED,2204,1641,563,,1632,1179,453,,572,462,110,
TOBA TEK SINGH,DISTRICT,40 - 44,DIVORCED,1188,720,468,,906,541,365,,282,179,103,
TOBA TEK SINGH,DISTRICT,40 - 44,MARRIED,135130,66174,68956,,104062,51049,53013,,31068,15125,15943,
TOBA TEK SINGH,DISTRICT,40 - 44,NEVER MARRIED,4992,1630,3332,30,3717,1233,2472,12,1275,397,860,18
TOBA TEK SINGH,DISTRICT,40 - 44,SEPERATION,327,157,170,,247,119,128,,80,38,42,
TOBA TEK SINGH,DISTRICT,40 - 44,WIDOWED,3774,2978,796,,2836,2197,639,,938,781,157,
TOBA TEK SINGH,DISTRICT,45 - 49,DIVORCED,894,539,355,,688,421,267,,206,118,88,
TOBA TEK SINGH,DISTRICT,45 - 49,MARRIED,104313,49406,54907,,80142,38048,42094,,24171,11358,12813,
TOBA TEK SINGH,DISTRICT,45 - 49,NEVER MARRIED,3192,1161,2009,22,2403,893,1496,14,789,268,513,8
TOBA TEK SINGH,DISTRICT,45 - 49,SEPERATION,293,155,138,,215,112,103,,78,43,35,
TOBA TEK SINGH,DISTRICT,45 - 49,WIDOWED,5189,4131,1058,,3871,3032,839,,1318,1099,219,
TOBA TEK SINGH,DISTRICT,50 - 54,DIVORCED,686,428,258,,535,336,199,,151,92,59,
TOBA TEK SINGH,DISTRICT,50 - 54,MARRIED,86961,39880,47081,,67028,30906,36122,,19933,8974,10959,
TOBA TEK SINGH,DISTRICT,50 - 54,NEVER MARRIED,1999,842,1141,16,1514,673,836,5,485,169,305,11
TOBA TEK SINGH,DISTRICT,50 - 54,SEPERATION,226,113,113,,174,89,85,,52,24,28,
TOBA TEK SINGH,DISTRICT,50 - 54,WIDOWED,7448,5831,1617,,5447,4237,1210,,2001,1594,407,
TOBA TEK SINGH,DISTRICT,55 - 59,DIVORCED,486,299,187,,395,246,149,,91,53,38,
TOBA TEK SINGH,DISTRICT,55 - 59,MARRIED,70605,30345,40260,,54899,23590,31309,,15706,6755,8951,
TOBA TEK SINGH,DISTRICT,55 - 59,NEVER MARRIED,1527,592,924,11,1190,483,702,5,337,109,222,6
TOBA TEK SINGH,DISTRICT,55 - 59,SEPERATION,183,92,91,,148,72,76,,35,20,15,
TOBA TEK SINGH,DISTRICT,55 - 59,WIDOWED,8807,6486,2321,,6496,4731,1765,,2311,1755,556,
TOBA TEK SINGH,DISTRICT,60 - 64,DIVORCED,384,236,148,,313,197,116,,71,39,32,
TOBA TEK SINGH,DISTRICT,60 - 64,MARRIED,53309,22002,31307,,41730,17416,24314,,11579,4586,6993,
TOBA TEK SINGH,DISTRICT,60 - 64,NEVER MARRIED,1179,473,701,5,949,382,564,3,230,91,137,2
TOBA TEK SINGH,DISTRICT,60 - 64,SEPERATION,111,56,55,,87,43,44,,24,13,11,
TOBA TEK SINGH,DISTRICT,60 - 64,WIDOWED,10646,7648,2998,,7947,5637,2310,,2699,2011,688,
TOBA TEK SINGH,DISTRICT,65 - 69,DIVORCED,274,157,117,,220,123,97,,54,34,20,
TOBA TEK SINGH,DISTRICT,65 - 69,MARRIED,36742,14890,21852,,29179,11996,17183,,7563,2894,4669,
TOBA TEK SINGH,DISTRICT,65 - 69,NEVER MARRIED,772,336,433,3,623,266,356,1,149,70,77,2
TOBA TEK SINGH,DISTRICT,65 - 69,SEPERATION,97,42,55,,80,38,42,,17,4,13,
TOBA TEK SINGH,DISTRICT,65 - 69,WIDOWED,10475,7117,3358,,7819,5313,2506,,2656,1804,852,
TOBA TEK SINGH,DISTRICT,70 - 74,DIVORCED,117,55,62,,100,49,51,,17,6,11,
TOBA TEK SINGH,DISTRICT,70 - 74,MARRIED,21597,7254,14343,,17527,6017,11510,,4070,1237,2833,
TOBA TEK SINGH,DISTRICT,70 - 74,NEVER MARRIED,437,189,247,1,356,165,191,,81,24,56,1
TOBA TEK SINGH,DISTRICT,70 - 74,SEPERATION,53,17,36,,44,14,30,,9,3,6,
TOBA TEK SINGH,DISTRICT,70 - 74,WIDOWED,9353,5817,3536,,7297,4501,2796,,2056,1316,740,
TOBA TEK SINGH,DISTRICT,75 & ABOVE,DIVORCED,96,60,36,,87,56,31,,9,4,5,
TOBA TEK SINGH,DISTRICT,75 & ABOVE,MARRIED,20567,6577,13990,,17287,5573,11714,,3280,1004,2276,
TOBA TEK SINGH,DISTRICT,75 & ABOVE,NEVER MARRIED,435,168,266,1,366,134,232,,69,34,34,1
TOBA TEK SINGH,DISTRICT,75 & ABOVE,SEPERATION,46,14,32,,41,12,29,,5,2,3,
TOBA TEK SINGH,DISTRICT,75 & ABOVE,WIDOWED,16222,9279,6943,,13094,7402,5692,,3128,1877,1251,
VEHARI,DISTRICT,15 &  ABOVE,DIVORCED,11297,7321,3976,,8816,5756,3060,,2481,1565,916,
VEHARI,DISTRICT,15 &  ABOVE,MARRIED,1384160,700450,683710,,1076078,544325,531753,,308082,156125,151957,
VEHARI,DISTRICT,15 &  ABOVE,NEVER MARRIED,597104,253544,343148,412,446157,187855,258084,218,150947,65689,85064,194
VEHARI,DISTRICT,15 &  ABOVE,SEPERATION,4878,2656,2222,,3864,2118,1746,,1014,538,476,
VEHARI,DISTRICT,15 &  ABOVE,WIDOWED,92793,64858,27935,,70626,49026,21600,,22167,15832,6335,
VEHARI,DISTRICT,15 - 19,DIVORCED,183,152,31,,152,127,25,,31,25,6,
VEHARI,DISTRICT,15 - 19,MARRIED,24973,18099,6874,,21082,15217,5865,,3891,2882,1009,
VEHARI,DISTRICT,15 - 19,NEVER MARRIED,301624,143408,158144,72,229102,108542,120506,54,72522,34866,37638,18
VEHARI,DISTRICT,15 - 19,SEPERATION,133,86,47,,110,70,40,,23,16,7,
VEHARI,DISTRICT,15 - 19,WIDOWED,92,51,41,,77,42,35,,15,9,6,
VEHARI,DISTRICT,20 - 24,DIVORCED,959,690,269,,787,557,230,,172,133,39,
VEHARI,DISTRICT,20 - 24,MARRIED,112876,75072,37804,,91750,60377,31373,,21126,14695,6431,
VEHARI,DISTRICT,20 - 24,NEVER MARRIED,171605,67287,104253,65,126221,48202,77976,43,45384,19085,26277,22
VEHARI,DISTRICT,20 - 24,SEPERATION,370,232,138,,294,187,107,,76,45,31,
VEHARI,DISTRICT,20 - 24,WIDOWED,445,236,209,,368,181,187,,77,55,22,
VEHARI,DISTRICT,25 - 29,DIVORCED,1567,1013,554,,1206,764,442,,361,249,112,
VEHARI,DISTRICT,25 - 29,MARRIED,182230,105182,77048,,142599,81459,61140,,39631,23723,15908,
VEHARI,DISTRICT,25 - 29,NEVER MARRIED,73022,25155,47802,65,52953,17779,35146,28,20069,7376,12656,37
VEHARI,DISTRICT,25 - 29,SEPERATION,578,336,242,,457,257,200,,121,79,42,
VEHARI,DISTRICT,25 - 29,WIDOWED,1003,567,436,,787,424,363,,216,143,73,
VEHARI,DISTRICT,30 - 34,DIVORCED,1692,1087,605,,1250,808,442,,442,279,163,
VEHARI,DISTRICT,30 - 34,MARRIED,199594,106831,92763,,153005,81542,71463,,46589,25289,21300,
VEHARI,DISTRICT,30 - 34,NEVER MARRIED,24905,9122,15738,45,18165,6619,11530,16,6740,2503,4208,29
VEHARI,DISTRICT,30 - 34,SEPERATION,621,337,284,,506,284,222,,115,53,62,
VEHARI,DISTRICT,30 - 34,WIDOWED,1817,1170,647,,1379,885,494,,438,285,153,
VEHARI,DISTRICT,35 - 39,DIVORCED,1671,1085,586,,1255,818,437,,416,267,149,
VEHARI,DISTRICT,35 - 39,MARRIED,194416,96647,97769,,148378,73605,74773,,46038,23042,22996,
VEHARI,DISTRICT,35 - 39,NEVER MARRIED,10882,3273,7555,54,8095,2463,5610,22,2787,810,1945,32
VEHARI,DISTRICT,35 - 39,SEPERATION,656,345,311,,513,279,234,,143,66,77,
VEHARI,DISTRICT,35 - 39,WIDOWED,2957,2095,862,,2256,1582,674,,701,513,188,
VEHARI,DISTRICT,40 - 44,DIVORCED,1510,969,541,,1165,760,405,,345,209,136,
VEHARI,DISTRICT,40 - 44,MARRIED,175242,85009,90233,,134872,65455,69417,,40370,19554,20816,
VEHARI,DISTRICT,40 - 44,NEVER MARRIED,5664,1790,3832,42,4258,1376,2860,22,1406,414,972,20
VEHARI,DISTRICT,40 - 44,SEPERATION,650,352,298,,513,280,233,,137,72,65,
VEHARI,DISTRICT,40 - 44,WIDOWED,4876,3727,1149,,3625,2737,888,,1251,990,261,
VEHARI,DISTRICT,45 - 49,DIVORCED,1204,769,435,,967,626,341,,237,143,94,
VEHARI,DISTRICT,45 - 49,MARRIED,138811,64829,73982,,106405,49920,56485,,32406,14909,17497,
VEHARI,DISTRICT,45 - 49,NEVER MARRIED,3498,1149,2327,22,2695,938,1742,15,803,211,585,7
VEHARI,DISTRICT,45 - 49,SEPERATION,549,301,248,,429,231,198,,120,70,50,
VEHARI,DISTRICT,45 - 49,WIDOWED,6832,5310,1522,,5131,3929,1202,,1701,1381,320,
VEHARI,DISTRICT,50 - 54,DIVORCED,920,584,336,,730,485,245,,190,99,91,
VEHARI,DISTRICT,50 - 54,MARRIED,113312,51432,61880,,87603,39986,47617,,25709,11446,14263,
VEHARI,DISTRICT,50 - 54,NEVER MARRIED,2094,829,1242,23,1654,684,962,8,440,145,280,15
VEHARI,DISTRICT,50 - 54,SEPERATION,439,218,221,,336,169,167,,103,49,54,
VEHARI,DISTRICT,50 - 54,WIDOWED,9861,7515,2346,,7400,5596,1804,,2461,1919,542,
VEHARI,DISTRICT,55 - 59,DIVORCED,644,416,228,,525,340,185,,119,76,43,
VEHARI,DISTRICT,55 - 59,MARRIED,87542,37311,50231,,67644,28815,38829,,19898,8496,11402,
VEHARI,DISTRICT,55 - 59,NEVER MARRIED,1465,605,848,12,1132,486,642,4,333,119,206,8
VEHARI,DISTRICT,55 - 59,SEPERATION,335,177,158,,270,142,128,,65,35,30,
VEHARI,DISTRICT,55 - 59,WIDOWED,11047,8152,2895,,8168,5976,2192,,2879,2176,703,
VEHARI,DISTRICT,60 - 64,DIVORCED,476,296,180,,390,253,137,,86,43,43,
VEHARI,DISTRICT,60 - 64,MARRIED,64987,26987,38000,,50364,21195,29169,,14623,5792,8831,
VEHARI,DISTRICT,60 - 64,NEVER MARRIED,1064,443,615,6,836,363,470,3,228,80,145,3
VEHARI,DISTRICT,60 - 64,SEPERATION,252,130,122,,195,100,95,,57,30,27,
VEHARI,DISTRICT,60 - 64,WIDOWED,13139,9491,3648,,9772,7040,2732,,3367,2451,916,
VEHARI,DISTRICT,65 - 69,DIVORCED,269,163,106,,223,137,86,,46,26,20,
VEHARI,DISTRICT,65 - 69,MARRIED,42841,17532,25309,,33731,13952,19779,,9110,3580,5530,
VEHARI,DISTRICT,65 - 69,NEVER MARRIED,600,238,357,5,471,190,278,3,129,48,79,2
VEHARI,DISTRICT,65 - 69,SEPERATION,123,69,54,,102,59,43,,21,10,11,
VEHARI,DISTRICT,65 - 69,WIDOWED,12824,9041,3783,,9691,6846,2845,,3133,2195,938,
VEHARI,DISTRICT,70 - 74,DIVORCED,123,60,63,,105,51,54,,18,9,9,
VEHARI,DISTRICT,70 - 74,MARRIED,25062,8433,16629,,20218,6913,13305,,4844,1520,3324,
VEHARI,DISTRICT,70 - 74,NEVER MARRIED,342,127,215,,288,110,178,,54,17,37,
VEHARI,DISTRICT,70 - 74,SEPERATION,84,40,44,,71,31,40,,13,9,4,
VEHARI,DISTRICT,70 - 74,WIDOWED,11216,7348,3868,,8733,5704,3029,,2483,1644,839,
VEHARI,DISTRICT,75 & ABOVE,DIVORCED,79,37,42,,61,30,31,,18,7,11,
VEHARI,DISTRICT,75 & ABOVE,MARRIED,22274,7086,15188,,18427,5889,12538,,3847,1197,2650,
VEHARI,DISTRICT,75 & ABOVE,NEVER MARRIED,339,118,220,1,287,103,184,,52,15,36,1
VEHARI,DISTRICT,75 & ABOVE,SEPERATION,88,33,55,,68,29,39,,20,4,16,
VEHARI,DISTRICT,75 & ABOVE,WIDOWED,16684,10155,6529,,13239,8084,5155,,3445,2071,1374,
