name_admin_unit,part_of_district,admin_unit,religion,all_sexes_overall,female_overall,male_overall,tgend_overall,all_sexes_rural,female_rural,male_rural,tgend_rural,all_sexes_urban,female_urban,male_urban,tgend_urban
ABBOTTABAD,ABBOTTABAD,DISTRICT,QADIANI/AHMADI,21,11,10,0,15,8,7,0,6,3,3,0
ABBOTTABAD,ABBOTTABAD,DISTRICT,CHRISTIAN,5818,3197,2620,1,3174,1809,1365,0,2644,1388,1255,1
ABBOTTABAD,ABBOTTABAD,DISTRICT,HINDU JATI,97,49,48,0,48,16,32,0,49,33,16,0
ABBOTTABAD,ABBOTTABAD,DISTRICT,MUSLIM,1391394,692187,699104,103,1083261,540293,542945,23,308133,151894,156159,80
ABBOTTABAD,ABBOTTABAD,DISTRICT,OTHERS,191,104,87,0,150,87,63,0,41,17,24,0
ABBOTTABAD,ABBOTTABAD,DISTRICT,PARSI,6,3,3,0,4,2,2,0,2,1,1,0
ABBOTTABAD,ABBOTTABAD,DISTRICT,SCHEDULED CASTE,17,7,10,0,16,7,9,0,1,0,1,0
ABBOTTABAD,ABBOTTABAD,DISTRICT,SIKH,43,19,24,0,20,9,11,0,23,10,13,0
BAJAUR,BAJAUR,DISTRICT,QADIANI/AHMADI,21,10,11,0,21,10,11,0,0,0,0,0
BAJAUR,BAJAUR,DISTRICT,CHRISTIAN,3068,1651,1417,0,3068,1651,1417,0,0,0,0,0
BAJAUR,BAJAUR,DISTRICT,HINDU JATI,34,19,15,0,34,19,15,0,0,0,0,0
BAJAUR,BAJAUR,DISTRICT,MUSLIM,1279889,632888,646986,15,1279889,632888,646986,15,0,0,0,0
BAJAUR,BAJAUR,DISTRICT,OTHERS,63,37,26,0,63,37,26,0,0,0,0,0
BAJAUR,BAJAUR,DISTRICT,PARSI,0,0,0,0,0,0,0,0,0,0,0,0
BAJAUR,BAJAUR,DISTRICT,SCHEDULED CASTE,16,8,8,0,16,8,8,0,0,0,0,0
BAJAUR,BAJAUR,DISTRICT,SIKH,22,12,10,0,22,12,10,0,0,0,0,0
BANNU,BANNU,DISTRICT,QADIANI/AHMADI,68,35,33,0,68,35,33,0,0,0,0,0
BANNU,BANNU,DISTRICT,CHRISTIAN,4844,2527,2317,0,3572,1890,1682,0,1272,637,635,0
BANNU,BANNU,DISTRICT,HINDU JATI,236,120,116,0,121,70,51,0,115,50,65,0
BANNU,BANNU,DISTRICT,MUSLIM,1349359,647333,702008,18,1302684,625863,676810,11,46675,21470,25198,7
BANNU,BANNU,DISTRICT,OTHERS,101,47,53,1,68,34,33,1,33,13,20,0
BANNU,BANNU,DISTRICT,PARSI,1,0,1,0,1,0,1,0,0,0,0,0
BANNU,BANNU,DISTRICT,SCHEDULED CASTE,43,28,15,0,42,27,15,0,1,1,0,0
BANNU,BANNU,DISTRICT,SIKH,22,9,13,0,22,9,13,0,0,0,0,0
BATAGRAM,BATAGRAM,DISTRICT,QADIANI/AHMADI,4,2,2,0,4,2,2,0,0,0,0,0
BATAGRAM,BATAGRAM,DISTRICT,CHRISTIAN,986,527,459,0,986,527,459,0,0,0,0,0
BATAGRAM,BATAGRAM,DISTRICT,HINDU JATI,61,26,35,0,61,26,35,0,0,0,0,0
BATAGRAM,BATAGRAM,DISTRICT,MUSLIM,552050,271715,280325,10,552050,271715,280325,10,0,0,0,0
BATAGRAM,BATAGRAM,DISTRICT,OTHERS,153,96,57,0,153,96,57,0,0,0,0,0
BATAGRAM,BATAGRAM,DISTRICT,PARSI,1,1,0,0,1,1,0,0,0,0,0,0
BATAGRAM,BATAGRAM,DISTRICT,SCHEDULED CASTE,8,6,2,0,8,6,2,0,0,0,0,0
BATAGRAM,BATAGRAM,DISTRICT,SIKH,22,9,13,0,22,9,13,0,0,0,0,0
BUNER,BUNER,DISTRICT,QADIANI/AHMADI,17,9,8,0,17,9,8,0,0,0,0,0
BUNER,BUNER,DISTRICT,CHRISTIAN,1872,1018,854,0,1872,1018,854,0,0,0,0,0
BUNER,BUNER,DISTRICT,HINDU JATI,131,68,63,0,131,68,63,0,0,0,0,0
BUNER,BUNER,DISTRICT,MUSLIM,1013575,506931,506616,28,1013575,506931,506616,28,0,0,0,0
BUNER,BUNER,DISTRICT,OTHERS,46,29,17,0,46,29,17,0,0,0,0,0
BUNER,BUNER,DISTRICT,PARSI,0,0,0,0,0,0,0,0,0,0,0,0
BUNER,BUNER,DISTRICT,SCHEDULED CASTE,10,2,8,0,10,2,8,0,0,0,0,0
BUNER,BUNER,DISTRICT,SIKH,1023,510,513,0,1023,510,513,0,0,0,0,0
CHARSADDA,CHARSADDA,DISTRICT,QADIANI/AHMADI,22,10,12,0,20,10,10,0,2,0,2,0
CHARSADDA,CHARSADDA,DISTRICT,CHRISTIAN,4392,2353,2039,0,3286,1779,1507,0,1106,574,532,0
CHARSADDA,CHARSADDA,DISTRICT,HINDU JATI,18,10,8,0,11,7,4,0,7,3,4,0
CHARSADDA,CHARSADDA,DISTRICT,MUSLIM,1830646,882027,948600,19,1539359,741963,797380,16,291287,140064,151220,3
CHARSADDA,CHARSADDA,DISTRICT,OTHERS,21,10,11,0,18,9,9,0,3,1,2,0
CHARSADDA,CHARSADDA,DISTRICT,PARSI,0,0,0,0,0,0,0,0,0,0,0,0
CHARSADDA,CHARSADDA,DISTRICT,SCHEDULED CASTE,23,7,16,0,17,6,11,0,6,1,5,0
CHARSADDA,CHARSADDA,DISTRICT,SIKH,14,2,12,0,10,2,8,0,4,0,4,0
DERA ISMAIL KHAN,DERA ISMAIL KHAN,DISTRICT,QADIANI/AHMADI,13,5,8,0,6,2,4,0,7,3,4,0
DERA ISMAIL KHAN,DERA ISMAIL KHAN,DISTRICT,CHRISTIAN,5645,2849,2795,1,2935,1524,1411,0,2710,1325,1384,1
DERA ISMAIL KHAN,DERA ISMAIL KHAN,DISTRICT,HINDU JATI,668,338,330,0,93,49,44,0,575,289,286,0
DERA ISMAIL KHAN,DERA ISMAIL KHAN,DISTRICT,MUSLIM,1816418,863400,952868,150,1448333,689216,759104,13,368085,174184,193764,137
DERA ISMAIL KHAN,DERA ISMAIL KHAN,DISTRICT,OTHERS,85,43,42,0,60,30,30,0,25,13,12,0
DERA ISMAIL KHAN,DERA ISMAIL KHAN,DISTRICT,PARSI,0,0,0,0,0,0,0,0,0,0,0,0
DERA ISMAIL KHAN,DERA ISMAIL KHAN,DISTRICT,SCHEDULED CASTE,29,8,21,0,18,5,13,0,11,3,8,0
DERA ISMAIL KHAN,DERA ISMAIL KHAN,DISTRICT,SIKH,58,24,34,0,9,2,7,0,49,22,27,0
HANGU,HANGU,DISTRICT,QADIANI/AHMADI,16,6,10,0,16,6,10,0,0,0,0,0
HANGU,HANGU,DISTRICT,CHRISTIAN,2256,1226,1030,0,1751,968,783,0,505,258,247,0
HANGU,HANGU,DISTRICT,HINDU JATI,145,79,66,0,52,32,20,0,93,47,46,0
HANGU,HANGU,DISTRICT,MUSLIM,522967,265472,257487,8,440199,224665,215530,4,82768,40807,41957,4
HANGU,HANGU,DISTRICT,OTHERS,65,27,38,0,10,6,4,0,55,21,34,0
HANGU,HANGU,DISTRICT,PARSI,0,0,0,0,0,0,0,0,0,0,0,0
HANGU,HANGU,DISTRICT,SCHEDULED CASTE,14,8,6,0,14,8,6,0,0,0,0,0
HANGU,HANGU,DISTRICT,SIKH,160,76,84,0,12,7,5,0,148,69,79,0
HARIPUR,HARIPUR,DISTRICT,QADIANI/AHMADI,124,61,63,0,94,47,47,0,30,14,16,0
HARIPUR,HARIPUR,DISTRICT,CHRISTIAN,3570,1939,1628,3,3125,1708,1417,0,445,231,211,3
HARIPUR,HARIPUR,DISTRICT,HINDU JATI,41,18,23,0,40,17,23,0,1,1,0,0
HARIPUR,HARIPUR,DISTRICT,MUSLIM,1169155,580191,588922,42,1022285,507095,515175,15,146870,73096,73747,27
HARIPUR,HARIPUR,DISTRICT,OTHERS,135,77,58,0,125,72,53,0,10,5,5,0
HARIPUR,HARIPUR,DISTRICT,PARSI,0,0,0,0,0,0,0,0,0,0,0,0
HARIPUR,HARIPUR,DISTRICT,SCHEDULED CASTE,9,2,7,0,8,1,7,0,1,1,0,0
HARIPUR,HARIPUR,DISTRICT,SIKH,22,11,11,0,19,9,10,0,3,2,1,0
KARAK,KARAK,DISTRICT,QADIANI/AHMADI,10,7,3,0,8,5,3,0,2,2,0,0
KARAK,KARAK,DISTRICT,CHRISTIAN,2335,1246,1089,0,1968,1051,917,0,367,195,172,0
KARAK,KARAK,DISTRICT,HINDU JATI,10,7,3,0,10,7,3,0,0,0,0,0
KARAK,KARAK,DISTRICT,MUSLIM,812726,392894,419821,11,755070,365135,389924,11,57656,27759,29897,0
KARAK,KARAK,DISTRICT,OTHERS,48,28,20,0,38,24,14,0,10,4,6,0
KARAK,KARAK,DISTRICT,PARSI,1,0,1,0,1,0,1,0,0,0,0,0
KARAK,KARAK,DISTRICT,SCHEDULED CASTE,13,5,8,0,11,5,6,0,2,0,2,0
KARAK,KARAK,DISTRICT,SIKH,7,3,4,0,7,3,4,0,0,0,0,0
KHYBER,KHYBER,DISTRICT,QADIANI/AHMADI,8,1,7,0,6,1,5,0,2,0,2,0
KHYBER,KHYBER,DISTRICT,CHRISTIAN,3482,1809,1673,0,2463,1284,1179,0,1019,525,494,0
KHYBER,KHYBER,DISTRICT,HINDU JATI,18,10,8,0,17,9,8,0,1,1,0,0
KHYBER,KHYBER,DISTRICT,MUSLIM,1142377,545973,596395,9,1048827,501578,547240,9,93550,44395,49155,0
KHYBER,KHYBER,DISTRICT,OTHERS,54,30,23,1,51,29,21,1,3,1,2,0
KHYBER,KHYBER,DISTRICT,PARSI,0,0,0,0,0,0,0,0,0,0,0,0
KHYBER,KHYBER,DISTRICT,SCHEDULED CASTE,26,12,14,0,24,12,12,0,2,0,2,0
KHYBER,KHYBER,DISTRICT,SIKH,17,6,11,0,16,5,11,0,1,1,0,0
KOHAT,KOHAT,DISTRICT,QADIANI/AHMADI,14,6,8,0,10,3,7,0,4,3,1,0
KOHAT,KOHAT,DISTRICT,CHRISTIAN,5464,2827,2637,0,1870,1015,855,0,3594,1812,1782,0
KOHAT,KOHAT,DISTRICT,HINDU JATI,599,304,295,0,18,9,9,0,581,295,286,0
KOHAT,KOHAT,DISTRICT,MUSLIM,1228271,601760,626483,28,953908,469956,483943,9,274363,131804,142540,19
KOHAT,KOHAT,DISTRICT,OTHERS,114,58,55,1,50,25,25,0,64,33,30,1
KOHAT,KOHAT,DISTRICT,PARSI,1,0,1,0,0,0,0,0,1,0,1,0
KOHAT,KOHAT,DISTRICT,SCHEDULED CASTE,10,4,6,0,7,3,4,0,3,1,2,0
KOHAT,KOHAT,DISTRICT,SIKH,106,62,44,0,17,9,8,0,89,53,36,0
KOLAI PALAS KOHISTAN,KOLAI PALAS KOHISTAN,DISTRICT,QADIANI/AHMADI,2,2,0,0,2,2,0,0,0,0,0,0
KOLAI PALAS KOHISTAN,KOLAI PALAS KOHISTAN,DISTRICT,CHRISTIAN,611,323,288,0,611,323,288,0,0,0,0,0
KOLAI PALAS KOHISTAN,KOLAI PALAS KOHISTAN,DISTRICT,HINDU JATI,24,15,9,0,24,15,9,0,0,0,0,0
KOLAI PALAS KOHISTAN,KOLAI PALAS KOHISTAN,DISTRICT,MUSLIM,235939,114573,121364,2,235939,114573,121364,2,0,0,0,0
KOLAI PALAS KOHISTAN,KOLAI PALAS KOHISTAN,DISTRICT,OTHERS,132,62,70,0,132,62,70,0,0,0,0,0
KOLAI PALAS KOHISTAN,KOLAI PALAS KOHISTAN,DISTRICT,PARSI,2,1,1,0,2,1,1,0,0,0,0,0
KOLAI PALAS KOHISTAN,KOLAI PALAS KOHISTAN,DISTRICT,SCHEDULED CASTE,6,3,3,0,6,3,3,0,0,0,0,0
KOLAI PALAS KOHISTAN,KOLAI PALAS KOHISTAN,DISTRICT,SIKH,10,3,7,0,10,3,7,0,0,0,0,0
KURRAM,KURRAM,DISTRICT,QADIANI/AHMADI,7,1,6,0,7,1,6,0,0,0,0,0
KURRAM,KURRAM,DISTRICT,CHRISTIAN,2517,1285,1232,0,2174,1108,1066,0,343,177,166,0
KURRAM,KURRAM,DISTRICT,HINDU JATI,39,20,19,0,30,13,17,0,9,7,2,0
KURRAM,KURRAM,DISTRICT,MUSLIM,782792,377158,405620,14,737682,356044,381625,13,45110,21114,23995,1
KURRAM,KURRAM,DISTRICT,OTHERS,44,25,19,0,35,20,15,0,9,5,4,0
KURRAM,KURRAM,DISTRICT,PARSI,0,0,0,0,0,0,0,0,0,0,0,0
KURRAM,KURRAM,DISTRICT,SCHEDULED CASTE,17,7,10,0,17,7,10,0,0,0,0,0
KURRAM,KURRAM,DISTRICT,SIKH,18,9,8,1,18,9,8,1,0,0,0,0
LAKKI MARWAT,LAKKI MARWAT,DISTRICT,QADIANI/AHMADI,9,7,2,0,9,7,2,0,0,0,0,0
LAKKI MARWAT,LAKKI MARWAT,DISTRICT,CHRISTIAN,2040,1124,916,0,1869,1034,835,0,171,90,81,0
LAKKI MARWAT,LAKKI MARWAT,DISTRICT,HINDU JATI,1,0,1,0,1,0,1,0,0,0,0,0
LAKKI MARWAT,LAKKI MARWAT,DISTRICT,MUSLIM,1034204,510205,523986,13,932441,460020,472409,12,101763,50185,51577,1
LAKKI MARWAT,LAKKI MARWAT,DISTRICT,OTHERS,11,7,4,0,9,5,4,0,2,2,0,0
LAKKI MARWAT,LAKKI MARWAT,DISTRICT,PARSI,0,0,0,0,0,0,0,0,0,0,0,0
LAKKI MARWAT,LAKKI MARWAT,DISTRICT,SCHEDULED CASTE,23,6,17,0,21,6,15,0,2,0,2,0
LAKKI MARWAT,LAKKI MARWAT,DISTRICT,SIKH,12,5,7,0,12,5,7,0,0,0,0,0
LOWER CHITRAL,LOWER CHITRAL,DISTRICT,QADIANI/AHMADI,2,1,1,0,1,1,0,0,1,0,1,0
LOWER CHITRAL,LOWER CHITRAL,DISTRICT,CHRISTIAN,509,281,228,0,363,214,149,0,146,67,79,0
LOWER CHITRAL,LOWER CHITRAL,DISTRICT,HINDU JATI,1,0,1,0,1,0,1,0,0,0,0,0
LOWER CHITRAL,LOWER CHITRAL,DISTRICT,MUSLIM,313101,153140,159961,0,257895,126279,131616,0,55206,26861,28345,0
LOWER CHITRAL,LOWER CHITRAL,DISTRICT,OTHERS,4617,2269,2348,0,4449,2173,2276,0,168,96,72,0
LOWER CHITRAL,LOWER CHITRAL,DISTRICT,PARSI,0,0,0,0,0,0,0,0,0,0,0,0
LOWER CHITRAL,LOWER CHITRAL,DISTRICT,SCHEDULED CASTE,3,1,2,0,1,0,1,0,2,1,1,0
LOWER CHITRAL,LOWER CHITRAL,DISTRICT,SIKH,1,1,0,0,0,0,0,0,1,1,0,0
LOWER DIR,LOWER DIR,DISTRICT,QADIANI/AHMADI,22,8,14,0,22,8,14,0,0,0,0,0
LOWER DIR,LOWER DIR,DISTRICT,CHRISTIAN,4268,2320,1948,0,3904,2148,1756,0,364,172,192,0
LOWER DIR,LOWER DIR,DISTRICT,HINDU JATI,51,24,27,0,17,10,7,0,34,14,20,0
LOWER DIR,LOWER DIR,DISTRICT,MUSLIM,1644181,833392,810762,27,1596721,810138,786557,26,47460,23254,24205,1
LOWER DIR,LOWER DIR,DISTRICT,OTHERS,59,30,29,0,57,30,27,0,2,0,2,0
LOWER DIR,LOWER DIR,DISTRICT,PARSI,1,1,0,0,1,1,0,0,0,0,0,0
LOWER DIR,LOWER DIR,DISTRICT,SCHEDULED CASTE,22,10,12,0,22,10,12,0,0,0,0,0
LOWER DIR,LOWER DIR,DISTRICT,SIKH,16,6,10,0,16,6,10,0,0,0,0,0
LOWER KOHISTAN,LOWER KOHISTAN,DISTRICT,QADIANI/AHMADI,2,1,1,0,2,1,1,0,0,0,0,0
LOWER KOHISTAN,LOWER KOHISTAN,DISTRICT,CHRISTIAN,834,425,409,0,834,425,409,0,0,0,0,0
LOWER KOHISTAN,LOWER KOHISTAN,DISTRICT,HINDU JATI,2,1,1,0,2,1,1,0,0,0,0,0
LOWER KOHISTAN,LOWER KOHISTAN,DISTRICT,MUSLIM,302360,146777,155572,11,302360,146777,155572,11,0,0,0,0
LOWER KOHISTAN,LOWER KOHISTAN,DISTRICT,OTHERS,94,53,41,0,94,53,41,0,0,0,0,0
LOWER KOHISTAN,LOWER KOHISTAN,DISTRICT,PARSI,2,2,0,0,2,2,0,0,0,0,0,0
LOWER KOHISTAN,LOWER KOHISTAN,DISTRICT,SCHEDULED CASTE,7,1,6,0,7,1,6,0,0,0,0,0
LOWER KOHISTAN,LOWER KOHISTAN,DISTRICT,SIKH,4,2,2,0,4,2,2,0,0,0,0,0
MALAKAND,MALAKAND,DISTRICT,QADIANI/AHMADI,15,10,5,0,10,9,1,0,5,1,4,0
MALAKAND,MALAKAND,DISTRICT,CHRISTIAN,2092,1103,989,0,1615,868,747,0,477,235,242,0
MALAKAND,MALAKAND,DISTRICT,HINDU JATI,75,42,33,0,73,40,33,0,2,2,0,0
MALAKAND,MALAKAND,DISTRICT,MUSLIM,823056,401765,421279,12,750018,366834,383178,6,73038,34931,38101,6
MALAKAND,MALAKAND,DISTRICT,OTHERS,98,50,48,0,98,50,48,0,0,0,0,0
MALAKAND,MALAKAND,DISTRICT,PARSI,0,0,0,0,0,0,0,0,0,0,0,0
MALAKAND,MALAKAND,DISTRICT,SCHEDULED CASTE,11,6,5,0,8,5,3,0,3,1,2,0
MALAKAND,MALAKAND,DISTRICT,SIKH,30,15,15,0,30,15,15,0,0,0,0,0
MANSEHRA,MANSEHRA,DISTRICT,QADIANI/AHMADI,26,13,13,0,25,13,12,0,1,0,1,0
MANSEHRA,MANSEHRA,DISTRICT,CHRISTIAN,3986,2191,1794,1,3492,1936,1556,0,494,255,238,1
MANSEHRA,MANSEHRA,DISTRICT,HINDU JATI,32,17,15,0,30,16,14,0,2,1,1,0
MANSEHRA,MANSEHRA,DISTRICT,MUSLIM,1785071,878466,906499,106,1631253,803784,827426,43,153818,74682,79073,63
MANSEHRA,MANSEHRA,DISTRICT,OTHERS,467,268,199,0,452,258,194,0,15,10,5,0
MANSEHRA,MANSEHRA,DISTRICT,PARSI,4,2,2,0,3,2,1,0,1,0,1,0
MANSEHRA,MANSEHRA,DISTRICT,SCHEDULED CASTE,7,2,5,0,7,2,5,0,0,0,0,0
MANSEHRA,MANSEHRA,DISTRICT,SIKH,31,18,13,0,29,17,12,0,2,1,1,0
MARDAN,MARDAN,DISTRICT,QADIANI/AHMADI,78,36,42,0,31,16,15,0,47,20,27,0
MARDAN,MARDAN,DISTRICT,CHRISTIAN,7567,4018,3549,0,4856,2641,2215,0,2711,1377,1334,0
MARDAN,MARDAN,DISTRICT,HINDU JATI,340,171,169,0,58,27,31,0,282,144,138,0
MARDAN,MARDAN,DISTRICT,MUSLIM,2732331,1329474,1402805,52,2282415,1112308,1170089,18,449916,217166,232716,34
MARDAN,MARDAN,DISTRICT,OTHERS,167,81,86,0,143,67,76,0,24,14,10,0
MARDAN,MARDAN,DISTRICT,PARSI,3,0,3,0,1,0,1,0,2,0,2,0
MARDAN,MARDAN,DISTRICT,SCHEDULED CASTE,39,20,18,1,34,16,17,1,5,4,1,0
MARDAN,MARDAN,DISTRICT,SIKH,167,76,91,0,39,11,28,0,128,65,63,0
MOHMAND,MOHMAND,DISTRICT,QADIANI/AHMADI,5,3,2,0,5,3,2,0,0,0,0,0
MOHMAND,MOHMAND,DISTRICT,CHRISTIAN,1554,823,731,0,1554,823,731,0,0,0,0,0
MOHMAND,MOHMAND,DISTRICT,HINDU JATI,0,0,0,0,0,0,0,0,0,0,0,0
MOHMAND,MOHMAND,DISTRICT,MUSLIM,552341,271701,280634,6,552341,271701,280634,6,0,0,0,0
MOHMAND,MOHMAND,DISTRICT,OTHERS,18,13,5,0,18,13,5,0,0,0,0,0
MOHMAND,MOHMAND,DISTRICT,PARSI,0,0,0,0,0,0,0,0,0,0,0,0
MOHMAND,MOHMAND,DISTRICT,SCHEDULED CASTE,1,1,0,0,1,1,0,0,0,0,0,0
MOHMAND,MOHMAND,DISTRICT,SIKH,14,2,12,0,14,2,12,0,0,0,0,0
NORTH WAZIRISTAN,NORTH WAZIRISTAN,DISTRICT,QADIANI/AHMADI,21,8,13,0,20,8,12,0,1,0,1,0
NORTH WAZIRISTAN,NORTH WAZIRISTAN,DISTRICT,CHRISTIAN,2009,988,1020,1,1564,782,782,0,445,206,238,1
NORTH WAZIRISTAN,NORTH WAZIRISTAN,DISTRICT,HINDU JATI,87,39,48,0,29,13,16,0,58,26,32,0
NORTH WAZIRISTAN,NORTH WAZIRISTAN,DISTRICT,MUSLIM,690967,337515,353439,13,687535,335983,351539,13,3432,1532,1900,0
NORTH WAZIRISTAN,NORTH WAZIRISTAN,DISTRICT,OTHERS,29,15,14,0,29,15,14,0,0,0,0,0
NORTH WAZIRISTAN,NORTH WAZIRISTAN,DISTRICT,PARSI,1,1,0,0,1,1,0,0,0,0,0,0
NORTH WAZIRISTAN,NORTH WAZIRISTAN,DISTRICT,SCHEDULED CASTE,9,4,5,0,9,4,5,0,0,0,0,0
NORTH WAZIRISTAN,NORTH WAZIRISTAN,DISTRICT,SIKH,14,10,3,1,14,10,3,1,0,0,0,0
NOWSHERA,NOWSHERA,DISTRICT,QADIANI/AHMADI,54,31,23,0,40,26,14,0,14,5,9,0
NOWSHERA,NOWSHERA,DISTRICT,CHRISTIAN,8886,4609,4276,1,4916,2622,2294,0,3970,1987,1982,1
NOWSHERA,NOWSHERA,DISTRICT,HINDU JATI,815,406,409,0,324,166,158,0,491,240,251,0
NOWSHERA,NOWSHERA,DISTRICT,MUSLIM,1725710,846421,879240,49,1392706,687332,705356,18,333004,159089,173884,31
NOWSHERA,NOWSHERA,DISTRICT,OTHERS,145,70,75,0,87,49,38,0,58,21,37,0
NOWSHERA,NOWSHERA,DISTRICT,PARSI,1,1,0,0,0,0,0,0,1,1,0,0
NOWSHERA,NOWSHERA,DISTRICT,SCHEDULED CASTE,47,21,26,0,27,13,14,0,20,8,12,0
NOWSHERA,NOWSHERA,DISTRICT,SIKH,31,14,17,0,17,7,10,0,14,7,7,0
ORAKZAI,ORAKZAI,DISTRICT,QADIANI/AHMADI,33,13,20,0,33,13,20,0,0,0,0,0
ORAKZAI,ORAKZAI,DISTRICT,CHRISTIAN,719,366,353,0,719,366,353,0,0,0,0,0
ORAKZAI,ORAKZAI,DISTRICT,HINDU JATI,27,14,13,0,27,14,13,0,0,0,0,0
ORAKZAI,ORAKZAI,DISTRICT,MUSLIM,386749,182273,204469,7,386749,182273,204469,7,0,0,0,0
ORAKZAI,ORAKZAI,DISTRICT,OTHERS,16,8,8,0,16,8,8,0,0,0,0,0
ORAKZAI,ORAKZAI,DISTRICT,PARSI,0,0,0,0,0,0,0,0,0,0,0,0
ORAKZAI,ORAKZAI,DISTRICT,SCHEDULED CASTE,7,4,3,0,7,4,3,0,0,0,0,0
ORAKZAI,ORAKZAI,DISTRICT,SIKH,10,6,4,0,10,6,4,0,0,0,0,0
PESHAWAR,PESHAWAR,DISTRICT,QADIANI/AHMADI,213,118,95,0,47,27,20,0,166,91,75,0
PESHAWAR,PESHAWAR,DISTRICT,CHRISTIAN,33249,17266,15983,0,9611,5114,4497,0,23638,12152,11486,0
PESHAWAR,PESHAWAR,DISTRICT,HINDU JATI,1708,844,864,0,68,33,35,0,1640,811,829,0
PESHAWAR,PESHAWAR,DISTRICT,MUSLIM,4713004,2309053,2403768,183,2840891,1400623,1440239,29,1872113,908430,963529,154
PESHAWAR,PESHAWAR,DISTRICT,OTHERS,614,316,294,4,138,84,53,1,476,232,241,3
PESHAWAR,PESHAWAR,DISTRICT,PARSI,5,1,4,0,5,1,4,0,0,0,0,0
PESHAWAR,PESHAWAR,DISTRICT,SCHEDULED CASTE,114,73,41,0,28,9,19,0,86,64,22,0
PESHAWAR,PESHAWAR,DISTRICT,SIKH,1481,727,754,0,40,13,27,0,1441,714,727,0
SHANGLA,SHANGLA,DISTRICT,QADIANI/AHMADI,9,5,4,0,9,5,4,0,0,0,0,0
SHANGLA,SHANGLA,DISTRICT,CHRISTIAN,2140,1124,1015,1,2140,1124,1015,1,0,0,0,0
SHANGLA,SHANGLA,DISTRICT,HINDU JATI,19,14,5,0,19,14,5,0,0,0,0,0
SHANGLA,SHANGLA,DISTRICT,MUSLIM,888436,429803,458628,5,888436,429803,458628,5,0,0,0,0
SHANGLA,SHANGLA,DISTRICT,OTHERS,181,97,84,0,181,97,84,0,0,0,0,0
SHANGLA,SHANGLA,DISTRICT,PARSI,0,0,0,0,0,0,0,0,0,0,0,0
SHANGLA,SHANGLA,DISTRICT,SCHEDULED CASTE,11,4,7,0,11,4,7,0,0,0,0,0
SHANGLA,SHANGLA,DISTRICT,SIKH,50,23,27,0,50,23,27,0,0,0,0,0
SOUTH WAZIRISTAN,SOUTH WAZIRISTAN,DISTRICT,QADIANI/AHMADI,23,9,14,0,23,9,14,0,0,0,0,0
SOUTH WAZIRISTAN,SOUTH WAZIRISTAN,DISTRICT,CHRISTIAN,1556,785,771,0,1556,785,771,0,0,0,0,0
SOUTH WAZIRISTAN,SOUTH WAZIRISTAN,DISTRICT,HINDU JATI,4,2,2,0,4,2,2,0,0,0,0,0
SOUTH WAZIRISTAN,SOUTH WAZIRISTAN,DISTRICT,MUSLIM,886981,428283,458684,14,886981,428283,458684,14,0,0,0,0
SOUTH WAZIRISTAN,SOUTH WAZIRISTAN,DISTRICT,OTHERS,70,35,35,0,70,35,35,0,0,0,0,0
SOUTH WAZIRISTAN,SOUTH WAZIRISTAN,DISTRICT,PARSI,0,0,0,0,0,0,0,0,0,0,0,0
SOUTH WAZIRISTAN,SOUTH WAZIRISTAN,DISTRICT,SCHEDULED CASTE,13,4,9,0,13,4,9,0,0,0,0,0
SOUTH WAZIRISTAN,SOUTH WAZIRISTAN,DISTRICT,SIKH,28,12,16,0,28,12,16,0,0,0,0,0
SWABI,SWABI,DISTRICT,QADIANI/AHMADI,28,18,10,0,17,13,4,0,11,5,6,0
SWABI,SWABI,DISTRICT,CHRISTIAN,4608,2490,2118,0,3629,1966,1663,0,979,524,455,0
SWABI,SWABI,DISTRICT,HINDU JATI,64,35,29,0,42,23,19,0,22,12,10,0
SWABI,SWABI,DISTRICT,MUSLIM,1885379,930621,954723,35,1547111,763229,783863,19,338268,167392,170860,16
SWABI,SWABI,DISTRICT,OTHERS,77,43,34,0,57,31,26,0,20,12,8,0
SWABI,SWABI,DISTRICT,PARSI,1,0,1,0,1,0,1,0,0,0,0,0
SWABI,SWABI,DISTRICT,SCHEDULED CASTE,16,9,7,0,15,8,7,0,1,1,0,0
SWABI,SWABI,DISTRICT,SIKH,57,27,30,0,18,9,9,0,39,18,21,0
SWAT,SWAT,DISTRICT,QADIANI/AHMADI,27,14,13,0,19,10,9,0,8,4,4,0
SWAT,SWAT,DISTRICT,CHRISTIAN,7219,3957,3262,0,5121,2817,2304,0,2098,1140,958,0
SWAT,SWAT,DISTRICT,HINDU JATI,89,38,51,0,56,20,36,0,33,18,15,0
SWAT,SWAT,DISTRICT,MUSLIM,2677745,1306745,1370913,87,1887006,924898,962080,28,790739,381847,408833,59
SWAT,SWAT,DISTRICT,OTHERS,425,231,194,0,390,208,182,0,35,23,12,0
SWAT,SWAT,DISTRICT,PARSI,3,2,1,0,3,2,1,0,0,0,0,0
SWAT,SWAT,DISTRICT,SCHEDULED CASTE,28,10,18,0,23,7,16,0,5,3,2,0
SWAT,SWAT,DISTRICT,SIKH,540,260,280,0,52,23,29,0,488,237,251,0
TANK,TANK,DISTRICT,QADIANI/AHMADI,3,0,3,0,3,0,3,0,0,0,0,0
TANK,TANK,DISTRICT,CHRISTIAN,1164,598,566,0,841,439,402,0,323,159,164,0
TANK,TANK,DISTRICT,HINDU JATI,1,1,0,0,1,1,0,0,0,0,0,0
TANK,TANK,DISTRICT,MUSLIM,469033,228063,240969,1,420235,205121,215113,1,48798,22942,25856,0
TANK,TANK,DISTRICT,OTHERS,85,38,47,0,34,15,19,0,51,23,28,0
TANK,TANK,DISTRICT,PARSI,0,0,0,0,0,0,0,0,0,0,0,0
TANK,TANK,DISTRICT,SCHEDULED CASTE,1,0,1,0,1,0,1,0,0,0,0,0
TANK,TANK,DISTRICT,SIKH,6,3,3,0,6,3,3,0,0,0,0,0
TORGHAR,TORGHAR,DISTRICT,QADIANI/AHMADI,1,1,0,0,1,1,0,0,0,0,0,0
TORGHAR,TORGHAR,DISTRICT,CHRISTIAN,280,154,126,0,280,154,126,0,0,0,0,0
TORGHAR,TORGHAR,DISTRICT,HINDU JATI,1,1,0,0,1,1,0,0,0,0,0,0
TORGHAR,TORGHAR,DISTRICT,MUSLIM,200158,98123,102031,4,200158,98123,102031,4,0,0,0,0
TORGHAR,TORGHAR,DISTRICT,OTHERS,2,1,1,0,2,1,1,0,0,0,0,0
TORGHAR,TORGHAR,DISTRICT,PARSI,0,0,0,0,0,0,0,0,0,0,0,0
TORGHAR,TORGHAR,DISTRICT,SCHEDULED CASTE,1,1,0,0,1,1,0,0,0,0,0,0
TORGHAR,TORGHAR,DISTRICT,SIKH,2,0,2,0,2,0,2,0,0,0,0,0
UPPER CHITRAL,UPPER CHITRAL,DISTRICT,QADIANI/AHMADI,2,1,1,0,2,1,1,0,0,0,0,0
UPPER CHITRAL,UPPER CHITRAL,DISTRICT,CHRISTIAN,425,232,193,0,425,232,193,0,0,0,0,0
UPPER CHITRAL,UPPER CHITRAL,DISTRICT,HINDU JATI,1,1,0,0,1,1,0,0,0,0,0,0
UPPER CHITRAL,UPPER CHITRAL,DISTRICT,MUSLIM,194379,94409,99970,0,194379,94409,99970,0,0,0,0,0
UPPER CHITRAL,UPPER CHITRAL,DISTRICT,OTHERS,353,198,155,0,353,198,155,0,0,0,0,0
UPPER CHITRAL,UPPER CHITRAL,DISTRICT,PARSI,1,1,0,0,1,1,0,0,0,0,0,0
UPPER CHITRAL,UPPER CHITRAL,DISTRICT,SCHEDULED CASTE,0,0,0,0,0,0,0,0,0,0,0,0
UPPER CHITRAL,UPPER CHITRAL,DISTRICT,SIKH,0,0,0,0,0,0,0,0,0,0,0,0
UPPER DIR,UPPER DIR,DISTRICT,QADIANI/AHMADI,29,13,16,0,29,13,16,0,0,0,0,0
UPPER DIR,UPPER DIR,DISTRICT,CHRISTIAN,2258,1226,1032,0,2200,1195,1005,0,58,31,27,0
UPPER DIR,UPPER DIR,DISTRICT,HINDU JATI,18,11,7,0,16,10,6,0,2,1,1,0
UPPER DIR,UPPER DIR,DISTRICT,MUSLIM,1080001,544364,535625,12,1033226,521385,511830,11,46775,22979,23795,1
UPPER DIR,UPPER DIR,DISTRICT,OTHERS,78,37,41,0,75,37,38,0,3,0,3,0
UPPER DIR,UPPER DIR,DISTRICT,PARSI,0,0,0,0,0,0,0,0,0,0,0,0
UPPER DIR,UPPER DIR,DISTRICT,SCHEDULED CASTE,24,13,11,0,24,13,11,0,0,0,0,0
UPPER DIR,UPPER DIR,DISTRICT,SIKH,8,1,7,0,8,1,7,0,0,0,0,0
UPPER KOHISTAN,UPPER KOHISTAN,DISTRICT,QADIANI/AHMADI,2,0,2,0,2,0,2,0,0,0,0,0
UPPER KOHISTAN,UPPER KOHISTAN,DISTRICT,CHRISTIAN,661,333,328,0,661,333,328,0,0,0,0,0
UPPER KOHISTAN,UPPER KOHISTAN,DISTRICT,HINDU JATI,16,8,8,0,16,8,8,0,0,0,0,0
UPPER KOHISTAN,UPPER KOHISTAN,DISTRICT,MUSLIM,373408,181027,192377,4,373408,181027,192377,4,0,0,0,0
UPPER KOHISTAN,UPPER KOHISTAN,DISTRICT,OTHERS,86,33,53,0,86,33,53,0,0,0,0,0
UPPER KOHISTAN,UPPER KOHISTAN,DISTRICT,PARSI,2,0,2,0,2,0,2,0,0,0,0,0
UPPER KOHISTAN,UPPER KOHISTAN,DISTRICT,SCHEDULED CASTE,4,1,3,0,4,1,3,0,0,0,0,0
UPPER KOHISTAN,UPPER KOHISTAN,DISTRICT,SIKH,4,1,3,0,4,1,3,0,0,0,0,0
