name_admin_unit,part_of_district,admin_unit,sex___age_group__in_years_,all_sexes_overall,male_overall,female_overall,transgender_overall,all_sexes_rural,male_rural,female_rural,transgender_rural,all_sexes_urban,male_urban,female_urban,transgender_urban
AWARAN,AWARAN,DISTRICT,ALL AGES,178958,91623,87318,17,132122,67516,64594,12,46836,24107,22724,5
AWARAN,AWARAN,DISTRICT,UNDER 1,3399,1810,1589,,2362,1251,1111,,1037,559,478,
AWARAN,AWARAN,DISTRICT,UNDER 5,31481,16018,15463,,23171,11726,11445,,8310,4292,4018,
AWARAN,AWARAN,DISTRICT,UNDER 10,62549,31824,30725,,46573,23579,22994,,15976,8245,7731,
AWARAN,AWARAN,DISTRICT,UNDER 15,88319,45046,43271,2,65875,33535,32340,,22444,11511,10931,2
AWARAN,AWARAN,DISTRICT,05 - 24,88200,45129,43064,7,65353,33293,32058,2,22847,11836,11006,5
AWARAN,AWARAN,DISTRICT,15 - 49,75924,38493,37416,15,55324,27948,27364,12,20600,10545,10052,3
AWARAN,AWARAN,DISTRICT,15 - 64,86319,44161,42143,15,63145,32235,30898,12,23174,11926,11245,3
AWARAN,AWARAN,DISTRICT,18 - 60,72942,37171,35760,11,53399,27110,26279,10,19543,10061,9481,1
AWARAN,AWARAN,DISTRICT,18 &  ABOVE,78995,40620,38364,11,57791,29629,28152,10,21204,10991,10212,1
AWARAN,AWARAN,DISTRICT,60 &  ABOVE,6820,3891,2929,,4993,2867,2126,,1827,1024,803,
AWARAN,AWARAN,DISTRICT,65 &  ABOVE,4320,2416,1904,,3102,1746,1356,,1218,670,548,
BARKHAN,BARKHAN,DISTRICT,ALL AGES,210249,109624,100617,8,195824,102226,93591,7,14425,7398,7026,1
BARKHAN,BARKHAN,DISTRICT,UNDER 1,6341,3210,3131,,6017,3053,2964,,324,157,167,
BARKHAN,BARKHAN,DISTRICT,UNDER 5,43726,22653,21073,,41243,21391,19852,,2483,1262,1221,
BARKHAN,BARKHAN,DISTRICT,UNDER 10,84790,44269,40521,,79872,41744,38128,,4918,2525,2393,
BARKHAN,BARKHAN,DISTRICT,UNDER 15,114903,60522,54379,2,108135,56993,51140,2,6768,3529,3239,
BARKHAN,BARKHAN,DISTRICT,05 - 24,104439,55553,48880,6,97460,51895,45559,6,6979,3658,3321,
BARKHAN,BARKHAN,DISTRICT,15 - 49,77703,40167,37531,5,71426,36986,34436,4,6277,3181,3095,1
BARKHAN,BARKHAN,DISTRICT,15 - 64,89503,46156,43341,6,82232,42470,39757,5,7271,3686,3584,1
BARKHAN,BARKHAN,DISTRICT,18 - 60,75515,38504,37008,3,69440,35482,33956,2,6075,3022,3052,1
BARKHAN,BARKHAN,DISTRICT,18 &  ABOVE,83683,42688,40992,3,77038,39382,37654,2,6645,3306,3338,1
BARKHAN,BARKHAN,DISTRICT,60 &  ABOVE,8864,4549,4315,,8240,4238,4002,,624,311,313,
BARKHAN,BARKHAN,DISTRICT,65 &  ABOVE,5843,2946,2897,,5457,2763,2694,,386,183,203,
CHAGAI,CHAGAI,DISTRICT,ALL AGES,268611,139642,128964,5,248652,129430,119217,5,19959,10212,9747,
CHAGAI,CHAGAI,DISTRICT,UNDER 1,6843,3475,3368,,6452,3278,3174,,391,197,194,
CHAGAI,CHAGAI,DISTRICT,UNDER 5,52155,26833,25322,,49066,25242,23824,,3089,1591,1498,
CHAGAI,CHAGAI,DISTRICT,UNDER 10,101423,52316,49107,,95010,49030,45980,,6413,3286,3127,
CHAGAI,CHAGAI,DISTRICT,UNDER 15,140142,72426,67715,1,130932,67699,63232,1,9210,4727,4483,
CHAGAI,CHAGAI,DISTRICT,05 - 24,138936,71976,66956,4,128723,66802,61917,4,10213,5174,5039,
CHAGAI,CHAGAI,DISTRICT,15 - 49,110294,56843,53447,4,101099,52202,48893,4,9195,4641,4554,
CHAGAI,CHAGAI,DISTRICT,15 - 64,123152,64159,58989,4,112848,58909,53935,4,10304,5250,5054,
CHAGAI,CHAGAI,DISTRICT,18 - 60,102368,52986,49381,1,93835,48643,45191,1,8533,4343,4190,
CHAGAI,CHAGAI,DISTRICT,18 &  ABOVE,109954,57404,52549,1,100780,52711,48068,1,9174,4693,4481,
CHAGAI,CHAGAI,DISTRICT,60 &  ABOVE,8218,4780,3438,,7522,4398,3124,,696,382,314,
CHAGAI,CHAGAI,DISTRICT,65 &  ABOVE,5317,3057,2260,,4872,2822,2050,,445,235,210,
CHAMAN,CHAMAN,DISTRICT,ALL AGES,466218,261194,205011,13,336079,189666,146401,12,130139,71528,58610,1
CHAMAN,CHAMAN,DISTRICT,UNDER 1,10705,6280,4425,,7983,4646,3337,,2722,1634,1088,
CHAMAN,CHAMAN,DISTRICT,UNDER 5,95923,56344,39579,,71601,42189,29412,,24322,14155,10167,
CHAMAN,CHAMAN,DISTRICT,UNDER 10,182044,105844,76200,,135974,79517,56457,,46070,26327,19743,
CHAMAN,CHAMAN,DISTRICT,UNDER 15,251915,146578,105332,5,187341,109763,77573,5,64574,36815,27759,
CHAMAN,CHAMAN,DISTRICT,05 - 24,252665,142593,110063,9,183687,104688,78991,8,68978,37905,31072,1
CHAMAN,CHAMAN,DISTRICT,15 - 49,188833,100354,88471,8,131519,70272,61240,7,57314,30082,27231,1
CHAMAN,CHAMAN,DISTRICT,15 - 64,206793,110241,96544,8,143661,76975,66679,7,63132,33266,29865,1
CHAMAN,CHAMAN,DISTRICT,18 - 60,170899,90259,80634,6,118121,62515,55601,5,52778,27744,25033,1
CHAMAN,CHAMAN,DISTRICT,18 &  ABOVE,181637,96483,85148,6,125442,66749,58688,5,56195,29734,26460,1
CHAMAN,CHAMAN,DISTRICT,60 &  ABOVE,11812,6819,4993,,8026,4627,3399,,3786,2192,1594,
CHAMAN,CHAMAN,DISTRICT,65 &  ABOVE,7510,4375,3135,,5077,2928,2149,,2433,1447,986,
DERA BUGTI,DERA BUGTI,DISTRICT,ALL AGES,355274,194588,160682,4,246827,137659,109165,3,108447,56929,51517,1
DERA BUGTI,DERA BUGTI,DISTRICT,UNDER 1,11164,5848,5316,,7930,4136,3794,,3234,1712,1522,
DERA BUGTI,DERA BUGTI,DISTRICT,UNDER 5,81885,44343,37542,,58250,31890,26360,,23635,12453,11182,
DERA BUGTI,DERA BUGTI,DISTRICT,UNDER 10,152457,84817,67640,,108270,61252,47018,,44187,23565,20622,
DERA BUGTI,DERA BUGTI,DISTRICT,UNDER 15,198402,113892,84509,1,140995,82814,58180,1,57407,31078,26329,
DERA BUGTI,DERA BUGTI,DISTRICT,05 - 24,174540,100820,73717,3,120475,71858,48615,2,54065,28962,25102,1
DERA BUGTI,DERA BUGTI,DISTRICT,15 - 49,133166,68169,64994,3,89540,46041,43497,2,43626,22128,21497,1
DERA BUGTI,DERA BUGTI,DISTRICT,15 - 64,150544,77141,73400,3,101361,52206,49153,2,49183,24935,24247,1
DERA BUGTI,DERA BUGTI,DISTRICT,18 - 60,127556,62482,65073,1,85909,41820,44088,1,41647,20662,20985,
DERA BUGTI,DERA BUGTI,DISTRICT,18 &  ABOVE,137332,67951,69380,1,92728,45796,46931,1,44604,22155,22449,
DERA BUGTI,DERA BUGTI,DISTRICT,60 &  ABOVE,10918,6084,4834,,7679,4445,3234,,3239,1639,1600,
DERA BUGTI,DERA BUGTI,DISTRICT,65 &  ABOVE,6328,3555,2773,,4471,2639,1832,,1857,916,941,
DUKI,DUKI,DISTRICT,ALL AGES,205044,107221,97775,48,195261,101940,93276,45,9783,5281,4499,3
DUKI,DUKI,DISTRICT,UNDER 1,2392,1159,1233,,2373,1152,1221,,19,7,12,
DUKI,DUKI,DISTRICT,UNDER 5,35157,18193,16964,,34150,17688,16462,,1007,505,502,
DUKI,DUKI,DISTRICT,UNDER 10,67333,34867,32466,,65423,33936,31487,,1910,931,979,
DUKI,DUKI,DISTRICT,UNDER 15,92342,47851,44489,2,89452,46424,43026,2,2890,1427,1463,
DUKI,DUKI,DISTRICT,05 - 24,97115,50463,46631,21,92837,48221,44595,21,4278,2242,2036,
DUKI,DUKI,DISTRICT,15 - 49,98778,51250,47484,44,92799,47963,44795,41,5979,3287,2689,3
DUKI,DUKI,DISTRICT,15 - 64,109078,57209,51823,46,102382,53459,48880,43,6696,3750,2943,3
DUKI,DUKI,DISTRICT,18 - 60,94598,49462,45100,36,88679,46179,42467,33,5919,3283,2633,3
DUKI,DUKI,DISTRICT,18 &  ABOVE,99869,52611,47222,36,93655,49155,44467,33,6214,3456,2755,3
DUKI,DUKI,DISTRICT,60 &  ABOVE,5967,3552,2415,,5625,3350,2275,,342,202,140,
DUKI,DUKI,DISTRICT,65 &  ABOVE,3624,2161,1463,,3427,2057,1370,,197,104,93,
GWADAR,GWADAR,DISTRICT,ALL AGES,302831,159626,143174,31,146125,76472,69639,14,156706,83154,73535,17
GWADAR,GWADAR,DISTRICT,UNDER 1,6522,3510,3012,,4065,2179,1886,,2457,1331,1126,
GWADAR,GWADAR,DISTRICT,UNDER 5,46138,24584,21554,,24000,12484,11516,,22138,12100,10038,
GWADAR,GWADAR,DISTRICT,UNDER 10,88795,47189,41606,,46312,24230,22082,,42483,22959,19524,
GWADAR,GWADAR,DISTRICT,UNDER 15,129990,69690,60298,2,68027,36165,31860,2,61963,33525,28438,
GWADAR,GWADAR,DISTRICT,05 - 24,146256,77746,68497,13,73832,39460,34364,8,72424,38286,34133,5
GWADAR,GWADAR,DISTRICT,15 - 49,144946,74549,70374,23,65444,33435,31998,11,79502,41114,38376,12
GWADAR,GWADAR,DISTRICT,15 - 64,163968,85091,78849,28,73663,37917,35734,12,90305,47174,43115,16
GWADAR,GWADAR,DISTRICT,18 - 60,137277,70264,66991,22,60359,30432,29917,10,76918,39832,37074,12
GWADAR,GWADAR,DISTRICT,18 &  ABOVE,149817,77159,72634,24,66348,33684,32654,10,83469,43475,39980,14
GWADAR,GWADAR,DISTRICT,60 &  ABOVE,13800,7604,6193,3,6566,3579,2987,,7234,4025,3206,3
GWADAR,GWADAR,DISTRICT,65 &  ABOVE,8873,4845,4027,1,4435,2390,2045,,4438,2455,1982,1
HARNAI,HARNAI,DISTRICT,ALL AGES,127571,67362,60205,4,94138,48654,45481,3,33433,18708,14724,1
HARNAI,HARNAI,DISTRICT,UNDER 1,4455,2333,2122,,3495,1751,1744,,960,582,378,
HARNAI,HARNAI,DISTRICT,UNDER 5,31481,16823,14658,,22753,11647,11106,,8728,5176,3552,
HARNAI,HARNAI,DISTRICT,UNDER 10,54999,29122,25877,,40455,20661,19794,,14544,8461,6083,
HARNAI,HARNAI,DISTRICT,UNDER 15,72380,38349,34030,1,53896,27667,26228,1,18484,10682,7802,
HARNAI,HARNAI,DISTRICT,05 - 24,60587,31978,28606,3,45541,23594,21945,2,15046,8384,6661,1
HARNAI,HARNAI,DISTRICT,15 - 49,46304,24158,22143,3,33493,17313,16178,2,12811,6845,5965,1
HARNAI,HARNAI,DISTRICT,15 - 64,52573,27575,24995,3,38235,19890,18343,2,14338,7685,6652,1
HARNAI,HARNAI,DISTRICT,18 - 60,43867,22850,21015,2,31659,16360,15297,2,12208,6490,5718,
HARNAI,HARNAI,DISTRICT,18 &  ABOVE,47598,24903,22693,2,34521,17930,16589,2,13077,6973,6104,
HARNAI,HARNAI,DISTRICT,60 &  ABOVE,4214,2334,1880,,3219,1773,1446,,995,561,434,
HARNAI,HARNAI,DISTRICT,65 &  ABOVE,2618,1438,1180,,2007,1097,910,,611,341,270,
JAFFARABAD,JAFFARABAD,DISTRICT,ALL AGES,594558,301370,293177,11,431165,218419,212743,3,163393,82951,80434,8
JAFFARABAD,JAFFARABAD,DISTRICT,UNDER 1,13178,6606,6572,,10069,4975,5094,,3109,1631,1478,
JAFFARABAD,JAFFARABAD,DISTRICT,UNDER 5,118637,60020,58617,,87996,44188,43808,,30641,15832,14809,
JAFFARABAD,JAFFARABAD,DISTRICT,UNDER 10,224911,113956,110955,,168751,85336,83415,,56160,28620,27540,
JAFFARABAD,JAFFARABAD,DISTRICT,UNDER 15,305940,155460,150479,1,227509,115493,112015,1,78431,39967,38464,
JAFFARABAD,JAFFARABAD,DISTRICT,05 - 24,296910,151452,145454,4,216074,110368,105703,3,80836,41084,39751,1
JAFFARABAD,JAFFARABAD,DISTRICT,15 - 49,244260,123686,120566,8,171613,86824,84787,2,72647,36862,35779,6
JAFFARABAD,JAFFARABAD,DISTRICT,15 - 64,276095,139726,136360,9,194479,98325,96152,2,81616,41401,40208,7
JAFFARABAD,JAFFARABAD,DISTRICT,18 - 60,231302,116586,114708,8,163253,82194,81057,2,68049,34392,33651,6
JAFFARABAD,JAFFARABAD,DISTRICT,18 &  ABOVE,250187,125903,124275,9,177055,89084,87969,2,73132,36819,36306,7
JAFFARABAD,JAFFARABAD,DISTRICT,60 &  ABOVE,20620,10188,10431,1,15065,7527,7538,,5555,2661,2893,1
JAFFARABAD,JAFFARABAD,DISTRICT,65 &  ABOVE,12523,6184,6338,1,9177,4601,4576,,3346,1583,1762,1
JHAL MAGSI,JHAL MAGSI,DISTRICT,ALL AGES,203368,103422,99933,13,179238,91912,87315,11,24130,11510,12618,2
JHAL MAGSI,JHAL MAGSI,DISTRICT,UNDER 1,3456,1747,1709,,2975,1523,1452,,481,224,257,
JHAL MAGSI,JHAL MAGSI,DISTRICT,UNDER 5,36042,18246,17796,,32201,16400,15801,,3841,1846,1995,
JHAL MAGSI,JHAL MAGSI,DISTRICT,UNDER 10,73676,37370,36306,,66131,33755,32376,,7545,3615,3930,
JHAL MAGSI,JHAL MAGSI,DISTRICT,UNDER 15,102499,52153,50346,,92079,47223,44856,,10420,4930,5490,
JHAL MAGSI,JHAL MAGSI,DISTRICT,05 - 24,104950,53700,51240,10,93236,48331,44895,10,11714,5369,6345,
JHAL MAGSI,JHAL MAGSI,DISTRICT,15 - 49,85351,42993,42345,13,73758,37542,36205,11,11593,5451,6140,2
JHAL MAGSI,JHAL MAGSI,DISTRICT,15 - 64,96814,49094,47707,13,83636,42777,40848,11,13178,6317,6859,2
JHAL MAGSI,JHAL MAGSI,DISTRICT,18 - 60,80963,40701,40251,11,69679,35244,34426,9,11284,5457,5825,2
JHAL MAGSI,JHAL MAGSI,DISTRICT,18 &  ABOVE,86979,43976,42992,11,74911,38117,36785,9,12068,5859,6207,2
JHAL MAGSI,JHAL MAGSI,DISTRICT,60 &  ABOVE,6824,3705,3119,,5964,3262,2702,,860,443,417,
JHAL MAGSI,JHAL MAGSI,DISTRICT,65 &  ABOVE,4055,2175,1880,,3523,1912,1611,,532,263,269,
KACHHI,KACHHI,DISTRICT,ALL AGES,442674,233584,209056,34,362222,192336,169859,27,80452,41248,39197,7
KACHHI,KACHHI,DISTRICT,UNDER 1,8903,4560,4343,,7009,3587,3422,,1894,973,921,
KACHHI,KACHHI,DISTRICT,UNDER 5,83847,44546,39301,,68384,36767,31617,,15463,7779,7684,
KACHHI,KACHHI,DISTRICT,UNDER 10,165416,88163,77253,,136060,73336,62724,,29356,14827,14529,
KACHHI,KACHHI,DISTRICT,UNDER 15,240066,128949,111109,8,197322,107200,90115,7,42744,21749,20994,1
KACHHI,KACHHI,DISTRICT,05 - 24,238167,128654,109486,27,195204,106459,88723,22,42963,22195,20763,5
KACHHI,KACHHI,DISTRICT,15 - 49,172261,88432,83806,23,139821,71746,68058,17,32440,16686,15748,6
KACHHI,KACHHI,DISTRICT,15 - 64,194350,100195,94131,24,158006,81365,76623,18,36344,18830,17508,6
KACHHI,KACHHI,DISTRICT,18 - 60,151371,76127,75234,10,122898,61503,61387,8,28473,14624,13847,2
KACHHI,KACHHI,DISTRICT,18 &  ABOVE,163412,82686,80714,12,132870,66999,65861,10,30542,15687,14853,2
KACHHI,KACHHI,DISTRICT,60 &  ABOVE,13496,7324,6169,3,11242,6156,5083,3,2254,1168,1086,
KACHHI,KACHHI,DISTRICT,65 &  ABOVE,8258,4440,3816,2,6894,3771,3121,2,1364,669,695,
KALAT,KALAT,DISTRICT,ALL AGES,271560,138611,132942,7,227120,115646,111468,6,44440,22965,21474,1
KALAT,KALAT,DISTRICT,UNDER 1,7033,3538,3495,,5880,2937,2943,,1153,601,552,
KALAT,KALAT,DISTRICT,UNDER 5,52318,26526,25792,,44151,22332,21819,,8167,4194,3973,
KALAT,KALAT,DISTRICT,UNDER 10,100643,51214,49429,,84700,42750,41950,,15943,8464,7479,
KALAT,KALAT,DISTRICT,UNDER 15,141437,72206,69228,3,118911,60205,58703,3,22526,12001,10525,
KALAT,KALAT,DISTRICT,05 - 24,138111,70858,67248,5,115652,59005,56642,5,22459,11853,10606,
KALAT,KALAT,DISTRICT,15 - 49,109052,55147,53903,2,90770,46093,44675,2,18282,9054,9228,
KALAT,KALAT,DISTRICT,15 - 64,124421,63188,61230,3,103491,52731,50758,2,20930,10457,10472,1
KALAT,KALAT,DISTRICT,18 - 60,103067,51981,51084,2,85620,43295,42324,1,17447,8686,8760,1
KALAT,KALAT,DISTRICT,18 &  ABOVE,111368,56642,54723,3,92421,47168,45251,2,18947,9474,9472,1
KALAT,KALAT,DISTRICT,60 &  ABOVE,9474,5298,4175,1,7835,4439,3395,1,1639,859,780,
KALAT,KALAT,DISTRICT,65 &  ABOVE,5702,3217,2484,1,4718,2710,2007,1,984,507,477,
KECH,KECH,DISTRICT,ALL AGES,1060814,555163,505528,123,674168,349751,324371,46,386646,205412,181157,77
KECH,KECH,DISTRICT,UNDER 1,24161,12177,11984,,14543,7346,7197,,9618,4831,4787,
KECH,KECH,DISTRICT,UNDER 5,193312,100011,93301,,117499,60275,57224,,75813,39736,36077,
KECH,KECH,DISTRICT,UNDER 10,328574,169865,158709,,203367,104193,99174,,125207,65672,59535,
KECH,KECH,DISTRICT,UNDER 15,448911,232428,216474,9,278536,142805,135728,3,170375,89623,80746,6
KECH,KECH,DISTRICT,05 - 24,488519,251377,237064,78,313628,159596,154014,18,174891,91781,83050,60
KECH,KECH,DISTRICT,15 - 49,529758,274927,254734,97,340886,175967,164889,30,188872,98960,89845,67
KECH,KECH,DISTRICT,15 - 64,587785,307932,279743,110,378714,196811,181864,39,209071,111121,97879,71
KECH,KECH,DISTRICT,18 - 60,489047,255576,233385,86,314594,163374,151187,33,174453,92202,82198,53
KECH,KECH,DISTRICT,18 &  ABOVE,523235,276366,246777,92,338333,177426,160868,39,184902,98940,85909,53
KECH,KECH,DISTRICT,60 &  ABOVE,38127,23132,14987,8,26492,15631,10854,7,11635,7501,4133,1
KECH,KECH,DISTRICT,65 &  ABOVE,24118,14803,9311,4,16918,10135,6779,4,7200,4668,2532,
KHARAN,KHARAN,DISTRICT,ALL AGES,260352,139695,120646,11,179546,95343,84198,5,80806,44352,36448,6
KHARAN,KHARAN,DISTRICT,UNDER 1,7907,4205,3702,,6216,3290,2926,,1691,915,776,
KHARAN,KHARAN,DISTRICT,UNDER 5,59584,33121,26463,,42632,23490,19142,,16952,9631,7321,
KHARAN,KHARAN,DISTRICT,UNDER 10,107876,60048,47828,,76598,42302,34296,,31278,17746,13532,
KHARAN,KHARAN,DISTRICT,UNDER 15,146326,81513,64811,2,103733,57215,46516,2,42593,24298,18295,
KHARAN,KHARAN,DISTRICT,05 - 24,134323,72859,61455,9,93192,49977,43210,5,41131,22882,18245,4
KHARAN,KHARAN,DISTRICT,15 - 49,98971,49890,49072,9,65612,32604,33005,3,33359,17286,16067,6
KHARAN,KHARAN,DISTRICT,15 - 64,109965,55780,54176,9,72965,36487,36475,3,37000,19293,17701,6
KHARAN,KHARAN,DISTRICT,18 - 60,87733,43427,44301,5,57282,27831,29450,1,30451,15596,14851,4
KHARAN,KHARAN,DISTRICT,18 &  ABOVE,93685,46965,46715,5,61394,30232,31161,1,32291,16733,15554,4
KHARAN,KHARAN,DISTRICT,60 &  ABOVE,6779,3975,2804,,4696,2693,2003,,2083,1282,801,
KHARAN,KHARAN,DISTRICT,65 &  ABOVE,4061,2402,1659,,2848,1641,1207,,1213,761,452,
KHUZDAR,KHUZDAR,DISTRICT,ALL AGES,997214,537313,459867,34,632836,341182,291627,27,364378,196131,168240,7
KHUZDAR,KHUZDAR,DISTRICT,UNDER 1,25988,13872,12116,,16296,8897,7399,,9692,4975,4717,
KHUZDAR,KHUZDAR,DISTRICT,UNDER 5,201985,110572,91413,,128897,71285,57612,,73088,39287,33801,
KHUZDAR,KHUZDAR,DISTRICT,UNDER 10,375611,206931,168680,,240037,133073,106964,,135574,73858,61716,
KHUZDAR,KHUZDAR,DISTRICT,UNDER 15,516499,287485,229011,3,327301,183317,143981,3,189198,104168,85030,
KHUZDAR,KHUZDAR,DISTRICT,05 - 24,502891,276351,226516,24,313371,172085,141269,17,189520,104266,85247,7
KHUZDAR,KHUZDAR,DISTRICT,15 - 49,410963,211359,199577,27,257735,131529,126186,20,153228,79830,73391,7
KHUZDAR,KHUZDAR,DISTRICT,15 - 64,459783,237921,221832,30,290680,149339,141318,23,169103,88582,80514,7
KHUZDAR,KHUZDAR,DISTRICT,18 - 60,386438,196497,189919,22,246355,124170,122168,17,140083,72327,67751,5
KHUZDAR,KHUZDAR,DISTRICT,18 &  ABOVE,415547,213086,202437,24,266645,135804,130822,19,148902,77282,71615,5
KHUZDAR,KHUZDAR,DISTRICT,60 &  ABOVE,33545,19092,14451,2,23508,13418,10088,2,10037,5674,4363,
KHUZDAR,KHUZDAR,DISTRICT,65 &  ABOVE,20932,11907,9024,1,14855,8526,6328,1,6077,3381,2696,
KILLA ABDULLAH,KILLA ABDULLAH,DISTRICT,ALL AGES,361971,189172,172783,16,326587,169447,157126,14,35384,19725,15657,2
KILLA ABDULLAH,KILLA ABDULLAH,DISTRICT,UNDER 1,6955,3642,3313,,6498,3392,3106,,457,250,207,
KILLA ABDULLAH,KILLA ABDULLAH,DISTRICT,UNDER 5,74462,39606,34856,,68483,36280,32203,,5979,3326,2653,
KILLA ABDULLAH,KILLA ABDULLAH,DISTRICT,UNDER 10,133643,70832,62811,,121554,63851,57703,,12089,6981,5108,
KILLA ABDULLAH,KILLA ABDULLAH,DISTRICT,UNDER 15,178791,94640,84149,2,161932,84902,77028,2,16859,9738,7121,
KILLA ABDULLAH,KILLA ABDULLAH,DISTRICT,05 - 24,181148,93355,87779,14,161736,82270,79453,13,19412,11085,8326,1
KILLA ABDULLAH,KILLA ABDULLAH,DISTRICT,15 - 49,160360,81644,78702,14,144180,72952,71216,12,16180,8692,7486,2
KILLA ABDULLAH,KILLA ABDULLAH,DISTRICT,15 - 64,176335,90376,85945,14,158501,80781,77708,12,17834,9595,8237,2
KILLA ABDULLAH,KILLA ABDULLAH,DISTRICT,18 - 60,150540,76788,73744,8,135582,68851,66725,6,14958,7937,7019,2
KILLA ABDULLAH,KILLA ABDULLAH,DISTRICT,18 &  ABOVE,160267,82539,77720,8,144343,74056,70281,6,15924,8483,7439,2
KILLA ABDULLAH,KILLA ABDULLAH,DISTRICT,60 &  ABOVE,10736,6321,4415,,9683,5724,3959,,1053,597,456,
KILLA ABDULLAH,KILLA ABDULLAH,DISTRICT,65 &  ABOVE,6845,4156,2689,,6154,3764,2390,,691,392,299,
KILLA SAIFULLAH,KILLA SAIFULLAH,DISTRICT,ALL AGES,380200,199074,181125,1,316025,166447,149577,1,64175,32627,31548,
KILLA SAIFULLAH,KILLA SAIFULLAH,DISTRICT,UNDER 1,10578,5577,5001,,9018,4780,4238,,1560,797,763,
KILLA SAIFULLAH,KILLA SAIFULLAH,DISTRICT,UNDER 5,84813,45269,39544,,71432,38336,33096,,13381,6933,6448,
KILLA SAIFULLAH,KILLA SAIFULLAH,DISTRICT,UNDER 10,153619,82042,71577,,129800,69837,59963,,23819,12205,11614,
KILLA SAIFULLAH,KILLA SAIFULLAH,DISTRICT,UNDER 15,204196,109455,94740,1,172300,93051,79248,1,31896,16404,15492,
KILLA SAIFULLAH,KILLA SAIFULLAH,DISTRICT,05 - 24,188750,98673,90076,1,157334,82857,74476,1,31416,15816,15600,
KILLA SAIFULLAH,KILLA SAIFULLAH,DISTRICT,15 - 49,150111,75067,75044,,122309,61350,60959,,27802,13717,14085,
KILLA SAIFULLAH,KILLA SAIFULLAH,DISTRICT,15 - 64,167600,84695,82905,,136596,69195,67401,,31004,15500,15504,
KILLA SAIFULLAH,KILLA SAIFULLAH,DISTRICT,18 - 60,140184,70067,70117,,113763,57053,56710,,26421,13014,13407,
KILLA SAIFULLAH,KILLA SAIFULLAH,DISTRICT,18 &  ABOVE,151899,76909,74990,,123573,62797,60776,,28326,14112,14214,
KILLA SAIFULLAH,KILLA SAIFULLAH,DISTRICT,60 &  ABOVE,12962,7537,5425,,10853,6330,4523,,2109,1207,902,
KILLA SAIFULLAH,KILLA SAIFULLAH,DISTRICT,65 &  ABOVE,8404,4924,3480,,7129,4201,2928,,1275,723,552,
KOHLU,KOHLU,DISTRICT,ALL AGES,260220,136243,123961,16,241242,127186,114040,16,18978,9057,9921,
KOHLU,KOHLU,DISTRICT,UNDER 1,6352,3192,3160,,5935,2989,2946,,417,203,214,
KOHLU,KOHLU,DISTRICT,UNDER 5,49241,25301,23940,,45601,23557,22044,,3640,1744,1896,
KOHLU,KOHLU,DISTRICT,UNDER 10,96678,49891,46787,,89762,46624,43138,,6916,3267,3649,
KOHLU,KOHLU,DISTRICT,UNDER 15,134417,69760,64654,3,124827,65251,59573,3,9590,4509,5081,
KOHLU,KOHLU,DISTRICT,05 - 24,134679,70337,64333,9,125082,65929,59144,9,9597,4408,5189,
KOHLU,KOHLU,DISTRICT,15 - 49,106753,55126,51614,13,98819,51339,47467,13,7934,3787,4147,
KOHLU,KOHLU,DISTRICT,15 - 64,120454,63148,57293,13,111495,58824,52658,13,8959,4324,4635,
KOHLU,KOHLU,DISTRICT,18 - 60,100761,52359,48393,9,93265,48707,44549,9,7496,3652,3844,
KOHLU,KOHLU,DISTRICT,18 &  ABOVE,108546,57195,51342,9,100413,53219,47185,9,8133,3976,4157,
KOHLU,KOHLU,DISTRICT,60 &  ABOVE,8950,5553,3397,,8246,5193,3053,,704,360,344,
KOHLU,KOHLU,DISTRICT,65 &  ABOVE,5349,3335,2014,,4920,3111,1809,,429,224,205,
LASBELA,LASBELA,DISTRICT,ALL AGES,680816,348763,332028,25,350231,178715,171503,13,330585,170048,160525,12
LASBELA,LASBELA,DISTRICT,UNDER 1,12660,6341,6319,,7226,3604,3622,,5434,2737,2697,
LASBELA,LASBELA,DISTRICT,UNDER 5,105407,53195,52212,,58510,29373,29137,,46897,23822,23075,
LASBELA,LASBELA,DISTRICT,UNDER 10,209038,105668,103370,,113893,57438,56455,,95145,48230,46915,
LASBELA,LASBELA,DISTRICT,UNDER 15,298413,151336,147072,5,160571,81232,79334,5,137842,70104,67738,
LASBELA,LASBELA,DISTRICT,05 - 24,321543,164067,157466,10,163747,83341,80398,8,157796,80726,77068,2
LASBELA,LASBELA,DISTRICT,15 - 49,314892,161384,153497,11,153130,78066,75059,5,161762,83318,78438,6
LASBELA,LASBELA,DISTRICT,15 - 64,362412,186899,175494,19,178106,91343,86755,8,184306,95556,88739,11
LASBELA,LASBELA,DISTRICT,18 - 60,310686,159894,150775,17,152034,77677,74351,6,158652,82217,76424,11
LASBELA,LASBELA,DISTRICT,18 &  ABOVE,339184,175046,164120,18,168000,86190,81804,6,171184,88856,82316,12
LASBELA,LASBELA,DISTRICT,60 &  ABOVE,30854,16438,14414,2,17272,9220,8051,1,13582,7218,6363,1
LASBELA,LASBELA,DISTRICT,65 &  ABOVE,19991,10528,9462,1,11554,6140,5414,,8437,4388,4048,1
LORALAI,LORALAI,DISTRICT,ALL AGES,269364,141301,128046,17,211978,111343,100619,16,57386,29958,27427,1
LORALAI,LORALAI,DISTRICT,UNDER 1,6714,3478,3236,,5365,2825,2540,,1349,653,696,
LORALAI,LORALAI,DISTRICT,UNDER 5,54595,28351,26244,,43792,23003,20789,,10803,5348,5455,
LORALAI,LORALAI,DISTRICT,UNDER 10,101407,52854,48553,,81934,43011,38923,,19473,9843,9630,
LORALAI,LORALAI,DISTRICT,UNDER 15,138267,72662,65605,,111321,58821,52500,,26946,13841,13105,
LORALAI,LORALAI,DISTRICT,05 - 24,134911,71391,63511,9,106873,56533,50332,8,28038,14858,13179,1
LORALAI,LORALAI,DISTRICT,15 - 49,110293,57134,53144,15,84547,43644,40889,14,25746,13490,12255,1
LORALAI,LORALAI,DISTRICT,15 - 64,124983,65219,59748,16,95814,49787,46012,15,29169,15432,13736,1
LORALAI,LORALAI,DISTRICT,18 - 60,104023,53840,50172,11,79462,40953,38499,10,24561,12887,11673,1
LORALAI,LORALAI,DISTRICT,18 &  ABOVE,112751,58745,53994,12,86325,44815,41499,11,26426,13930,12495,1
LORALAI,LORALAI,DISTRICT,60 &  ABOVE,9698,5451,4246,1,7644,4304,3339,1,2054,1147,907,
LORALAI,LORALAI,DISTRICT,65 &  ABOVE,6114,3420,2693,1,4843,2735,2107,1,1271,685,586,
MASTUNG,MASTUNG,DISTRICT,ALL AGES,312378,166251,146124,3,272115,144946,127166,3,40263,21305,18958,
MASTUNG,MASTUNG,DISTRICT,UNDER 1,6805,3615,3190,,5967,3159,2808,,838,456,382,
MASTUNG,MASTUNG,DISTRICT,UNDER 5,58388,31314,27074,,50958,27282,23676,,7430,4032,3398,
MASTUNG,MASTUNG,DISTRICT,UNDER 10,109539,58868,50671,,96908,52091,44817,,12631,6777,5854,
MASTUNG,MASTUNG,DISTRICT,UNDER 15,152449,82427,70022,,134831,72948,61883,,17618,9479,8139,
MASTUNG,MASTUNG,DISTRICT,05 - 24,153495,83173,70320,2,135273,73390,61881,2,18222,9783,8439,
MASTUNG,MASTUNG,DISTRICT,15 - 49,134544,69983,64559,2,115787,60261,55524,2,18757,9722,9035,
MASTUNG,MASTUNG,DISTRICT,15 - 64,152961,79886,73072,3,131297,68589,62705,3,21664,11297,10367,
MASTUNG,MASTUNG,DISTRICT,18 - 60,128445,66243,62201,1,110116,56756,53359,1,18329,9487,8842,
MASTUNG,MASTUNG,DISTRICT,18 &  ABOVE,138667,72018,66648,1,118820,61692,57127,1,19847,10326,9521,
MASTUNG,MASTUNG,DISTRICT,60 &  ABOVE,11611,6530,5081,,9912,5589,4323,,1699,941,758,
MASTUNG,MASTUNG,DISTRICT,65 &  ABOVE,6968,3938,3030,,5987,3409,2578,,981,529,452,
MUSAKHEL,MUSAKHEL,DISTRICT,ALL AGES,182275,96706,85566,3,166470,88205,78262,3,15805,8501,7304,
MUSAKHEL,MUSAKHEL,DISTRICT,UNDER 1,4755,2497,2258,,4347,2270,2077,,408,227,181,
MUSAKHEL,MUSAKHEL,DISTRICT,UNDER 5,40177,21786,18391,,36507,19709,16798,,3670,2077,1593,
MUSAKHEL,MUSAKHEL,DISTRICT,UNDER 10,74671,40592,34079,,68075,36882,31193,,6596,3710,2886,
MUSAKHEL,MUSAKHEL,DISTRICT,UNDER 15,100526,54942,45583,1,91556,49908,41647,1,8970,5034,3936,
MUSAKHEL,MUSAKHEL,DISTRICT,05 - 24,91703,49161,42540,2,83213,44546,38665,2,8490,4615,3875,
MUSAKHEL,MUSAKHEL,DISTRICT,15 - 49,67944,34156,33786,2,62050,31178,30870,2,5894,2978,2916,
MUSAKHEL,MUSAKHEL,DISTRICT,15 - 64,77550,39363,38185,2,70998,36046,34950,2,6552,3317,3235,
MUSAKHEL,MUSAKHEL,DISTRICT,18 - 60,63271,31426,31843,2,58187,28951,29234,2,5084,2475,2609,
MUSAKHEL,MUSAKHEL,DISTRICT,18 &  ABOVE,69172,34725,34445,2,63679,32034,31643,2,5493,2691,2802,
MUSAKHEL,MUSAKHEL,DISTRICT,60 &  ABOVE,6457,3598,2859,,6009,3364,2645,,448,234,214,
MUSAKHEL,MUSAKHEL,DISTRICT,65 &  ABOVE,4199,2401,1798,,3916,2251,1665,,283,150,133,
NASIRABAD,NASIRABAD,DISTRICT,ALL AGES,563315,287902,275395,18,456363,234470,221877,16,106952,53432,53518,2
NASIRABAD,NASIRABAD,DISTRICT,UNDER 1,12040,6089,5951,,8770,4501,4269,,3270,1588,1682,
NASIRABAD,NASIRABAD,DISTRICT,UNDER 5,114044,58313,55731,,91393,46875,44518,,22651,11438,11213,
NASIRABAD,NASIRABAD,DISTRICT,UNDER 10,216847,111068,105779,,176420,90855,85565,,40427,20213,20214,
NASIRABAD,NASIRABAD,DISTRICT,UNDER 15,295202,151646,143553,3,240806,124679,116124,3,54396,26967,27429,
NASIRABAD,NASIRABAD,DISTRICT,05 - 24,281318,144901,136404,13,230017,119570,110435,12,51301,25331,25969,1
NASIRABAD,NASIRABAD,DISTRICT,15 - 49,227647,115154,112481,12,182960,92780,90170,10,44687,22374,22311,2
NASIRABAD,NASIRABAD,DISTRICT,15 - 64,256985,130295,126676,14,206373,104826,101535,12,50612,25469,25141,2
NASIRABAD,NASIRABAD,DISTRICT,18 - 60,215883,108541,107337,5,173459,87182,86274,3,42424,21359,21063,2
NASIRABAD,NASIRABAD,DISTRICT,18 &  ABOVE,232437,117343,115088,6,186987,94445,92538,4,45450,22898,22550,2
NASIRABAD,NASIRABAD,DISTRICT,60 &  ABOVE,18358,9707,8650,1,15018,8008,7009,1,3340,1699,1641,
NASIRABAD,NASIRABAD,DISTRICT,65 &  ABOVE,11128,5961,5166,1,9184,4965,4218,1,1944,996,948,
NUSHKI,NUSHKI,DISTRICT,ALL AGES,207200,107967,99228,5,159096,82721,76371,4,48104,25246,22857,1
NUSHKI,NUSHKI,DISTRICT,UNDER 1,5133,2675,2458,,3985,2079,1906,,1148,596,552,
NUSHKI,NUSHKI,DISTRICT,UNDER 5,40263,21450,18813,,31971,17049,14922,,8292,4401,3891,
NUSHKI,NUSHKI,DISTRICT,UNDER 10,73251,38777,34474,,57657,30523,27134,,15594,8254,7340,
NUSHKI,NUSHKI,DISTRICT,UNDER 15,100109,52933,47176,,78334,41400,36934,,21775,11533,10242,
NUSHKI,NUSHKI,DISTRICT,05 - 24,98504,51407,47095,2,75222,39104,36116,2,23282,12303,10979,
NUSHKI,NUSHKI,DISTRICT,15 - 49,90384,46098,44281,5,68149,34507,33638,4,22235,11591,10643,1
NUSHKI,NUSHKI,DISTRICT,15 - 64,102445,52480,49960,5,77242,39374,37864,4,25203,13106,12096,1
NUSHKI,NUSHKI,DISTRICT,18 - 60,86655,44157,42494,4,65426,33152,32271,3,21229,11005,10223,1
NUSHKI,NUSHKI,DISTRICT,18 &  ABOVE,93510,47947,45559,4,70632,36053,34576,3,22878,11894,10983,1
NUSHKI,NUSHKI,DISTRICT,60 &  ABOVE,7562,4153,3409,,5748,3180,2568,,1814,973,841,
NUSHKI,NUSHKI,DISTRICT,65 &  ABOVE,4646,2554,2092,,3520,1947,1573,,1126,607,519,
PANJGUR,PANJGUR,DISTRICT,ALL AGES,509781,269372,240314,95,352088,184562,167494,32,157693,84810,72820,63
PANJGUR,PANJGUR,DISTRICT,UNDER 1,10954,5405,5549,,8625,4206,4419,,2329,1199,1130,
PANJGUR,PANJGUR,DISTRICT,UNDER 5,95114,48997,46117,,70830,36169,34661,,24284,12828,11456,
PANJGUR,PANJGUR,DISTRICT,UNDER 10,155552,80249,75303,,113715,58379,55336,,41837,21870,19967,
PANJGUR,PANJGUR,DISTRICT,UNDER 15,210523,109068,101452,3,151078,77944,73132,2,59445,31124,28320,1
PANJGUR,PANJGUR,DISTRICT,05 - 24,245074,127159,117841,74,168811,87184,81608,19,76263,39975,36233,55
PANJGUR,PANJGUR,DISTRICT,15 - 49,263312,138672,124552,88,177698,92611,85059,28,85614,46061,39493,60
PANJGUR,PANJGUR,DISTRICT,15 - 64,287718,153219,134408,91,193875,102137,91708,30,93843,51082,42700,61
PANJGUR,PANJGUR,DISTRICT,18 - 60,233792,124581,109135,76,157458,82730,74702,26,76334,41851,34433,50
PANJGUR,PANJGUR,DISTRICT,18 &  ABOVE,249802,134502,115222,78,167452,88972,78454,26,82350,45530,36768,52
PANJGUR,PANJGUR,DISTRICT,60 &  ABOVE,17441,10787,6652,2,10987,6861,4126,,6454,3926,2526,2
PANJGUR,PANJGUR,DISTRICT,65 &  ABOVE,11540,7085,4454,1,7135,4481,2654,,4405,2604,1800,1
PISHIN,PISHIN,DISTRICT,ALL AGES,835482,426597,408862,23,591697,302354,289328,15,243785,124243,119534,8
PISHIN,PISHIN,DISTRICT,UNDER 1,17778,9199,8579,,13307,6928,6379,,4471,2271,2200,
PISHIN,PISHIN,DISTRICT,UNDER 5,178385,93651,84734,,129793,68273,61520,,48592,25378,23214,
PISHIN,PISHIN,DISTRICT,UNDER 10,318031,165857,152174,,227878,119192,108686,,90153,46665,43488,
PISHIN,PISHIN,DISTRICT,UNDER 15,428037,223013,205018,6,305554,159725,145824,5,122483,63288,59194,1
PISHIN,PISHIN,DISTRICT,05 - 24,417930,209580,208335,15,295398,148290,147097,11,122532,61290,61238,4
PISHIN,PISHIN,DISTRICT,15 - 49,352524,172933,179577,14,247682,121343,126330,9,104842,51590,53247,5
PISHIN,PISHIN,DISTRICT,15 - 64,392116,194280,197821,15,275289,136066,139214,9,116827,58214,58607,6
PISHIN,PISHIN,DISTRICT,18 - 60,328158,161501,166648,9,229967,112901,117061,5,98191,48600,49587,4
PISHIN,PISHIN,DISTRICT,18 &  ABOVE,350604,174891,175702,11,245804,122289,123509,6,104800,52602,52193,5
PISHIN,PISHIN,DISTRICT,60 &  ABOVE,25257,14934,10321,2,17822,10472,7349,1,7435,4462,2972,1
PISHIN,PISHIN,DISTRICT,65 &  ABOVE,15329,9304,6023,2,10854,6563,4290,1,4475,2741,1733,1
QUETTA,QUETTA,DISTRICT,ALL AGES,2271290,1164248,1106931,111,979434,502170,477235,29,1291856,662078,629696,82
QUETTA,QUETTA,DISTRICT,UNDER 1,44870,22328,22542,,19388,9375,10013,,25482,12953,12529,
QUETTA,QUETTA,DISTRICT,UNDER 5,384482,194923,189559,,172764,86190,86574,,211718,108733,102985,
QUETTA,QUETTA,DISTRICT,UNDER 10,720934,365226,355708,,327774,165099,162675,,393160,200127,193033,
QUETTA,QUETTA,DISTRICT,UNDER 15,1019215,516945,502252,18,460803,233337,227459,7,558412,283608,274793,11
QUETTA,QUETTA,DISTRICT,05 - 24,1106191,562730,543401,60,491060,251266,239775,19,615131,311464,303626,41
QUETTA,QUETTA,DISTRICT,15 - 49,1064321,542025,522211,85,444568,227038,217511,19,619753,314987,304700,66
QUETTA,QUETTA,DISTRICT,15 - 64,1201109,617186,583832,91,498489,256691,241777,21,702620,360495,342055,70
QUETTA,QUETTA,DISTRICT,18 - 60,1019546,522207,497259,80,421465,216368,205080,17,598081,305839,292179,63
QUETTA,QUETTA,DISTRICT,18 &  ABOVE,1095473,566816,528575,82,451155,234040,217097,18,644318,332776,311478,64
QUETTA,QUETTA,DISTRICT,60 &  ABOVE,84683,49473,35208,2,33194,19610,13583,1,51489,29863,21625,1
QUETTA,QUETTA,DISTRICT,65 &  ABOVE,50966,30117,20847,2,20142,12142,7999,1,30824,17975,12848,1
SHERANI,SHERANI,DISTRICT,ALL AGES,191673,105338,86329,6,191673,105338,86329,6,,,,
SHERANI,SHERANI,DISTRICT,UNDER 1,4712,2672,2040,,4712,2672,2040,,,,,
SHERANI,SHERANI,DISTRICT,UNDER 5,41653,23661,17992,,41653,23661,17992,,,,,
SHERANI,SHERANI,DISTRICT,UNDER 10,75400,43083,32317,,75400,43083,32317,,,,,
SHERANI,SHERANI,DISTRICT,UNDER 15,103341,59468,43873,,103341,59468,43873,,,,,
SHERANI,SHERANI,DISTRICT,05 - 24,97856,55384,42467,5,97856,55384,42467,5,,,,
SHERANI,SHERANI,DISTRICT,15 - 49,78143,40158,37979,6,78143,40158,37979,6,,,,
SHERANI,SHERANI,DISTRICT,15 - 64,85604,44255,41343,6,85604,44255,41343,6,,,,
SHERANI,SHERANI,DISTRICT,18 - 60,68721,34013,34707,1,68721,34013,34707,1,,,,
SHERANI,SHERANI,DISTRICT,18 &  ABOVE,72564,36312,36251,1,72564,36312,36251,1,,,,
SHERANI,SHERANI,DISTRICT,60 &  ABOVE,4377,2616,1761,,4377,2616,1761,,,,,
SHERANI,SHERANI,DISTRICT,65 &  ABOVE,2728,1615,1113,,2728,1615,1113,,,,,
SIBI,SIBI,DISTRICT,ALL AGES,224148,115033,109110,5,154848,79939,74904,5,69300,35094,34206,
SIBI,SIBI,DISTRICT,UNDER 1,4541,2277,2264,,2936,1436,1500,,1605,841,764,
SIBI,SIBI,DISTRICT,UNDER 5,43434,22213,21221,,31881,16324,15557,,11553,5889,5664,
SIBI,SIBI,DISTRICT,UNDER 10,79613,40752,38861,,59547,30759,28788,,20066,9993,10073,
SIBI,SIBI,DISTRICT,UNDER 15,108636,55683,52953,,80887,41925,38962,,27749,13758,13991,
SIBI,SIBI,DISTRICT,05 - 24,105750,54323,51425,2,76529,39952,36575,2,29221,14371,14850,
SIBI,SIBI,DISTRICT,15 - 49,96336,48861,47472,3,62460,31724,30733,3,33876,17137,16739,
SIBI,SIBI,DISTRICT,15 - 64,110567,56685,53879,3,70963,36390,34570,3,39604,20295,19309,
SIBI,SIBI,DISTRICT,18 - 60,93113,47350,45761,2,58956,29880,29074,2,34157,17470,16687,
SIBI,SIBI,DISTRICT,18 &  ABOVE,100454,51361,49089,4,63307,32262,31041,4,37147,19099,18048,
SIBI,SIBI,DISTRICT,60 &  ABOVE,8179,4462,3715,2,4877,2672,2203,2,3302,1790,1512,
SIBI,SIBI,DISTRICT,65 &  ABOVE,4945,2665,2278,2,2998,1624,1372,2,1947,1041,906,
SOHBATPUR,SOHBATPUR,DISTRICT,ALL AGES,240106,121863,118241,2,225378,114379,110997,2,14728,7484,7244,
SOHBATPUR,SOHBATPUR,DISTRICT,UNDER 1,8168,4055,4113,,7628,3791,3837,,540,264,276,
SOHBATPUR,SOHBATPUR,DISTRICT,UNDER 5,57732,29280,28452,,54617,27733,26884,,3115,1547,1568,
SOHBATPUR,SOHBATPUR,DISTRICT,UNDER 10,103225,52432,50793,,97208,49394,47814,,6017,3038,2979,
SOHBATPUR,SOHBATPUR,DISTRICT,UNDER 15,135780,69164,66615,1,127281,64830,62450,1,8499,4334,4165,
SOHBATPUR,SOHBATPUR,DISTRICT,05 - 24,116234,59432,56800,2,108314,55333,52979,2,7920,4099,3821,
SOHBATPUR,SOHBATPUR,DISTRICT,15 - 49,87360,44155,43204,1,82112,41509,40602,1,5248,2646,2602,
SOHBATPUR,SOHBATPUR,DISTRICT,15 - 64,99653,50384,49268,1,93671,47352,46318,1,5982,3032,2950,
SOHBATPUR,SOHBATPUR,DISTRICT,18 - 60,82777,41505,41272,,78166,39218,38948,,4611,2287,2324,
SOHBATPUR,SOHBATPUR,DISTRICT,18 &  ABOVE,89811,45051,44760,,84804,42573,42231,,5007,2478,2529,
SOHBATPUR,SOHBATPUR,DISTRICT,60 &  ABOVE,7683,3878,3805,,7257,3670,3587,,426,208,218,
SOHBATPUR,SOHBATPUR,DISTRICT,65 &  ABOVE,4673,2315,2358,,4426,2197,2229,,247,118,129,
SURAB,SURAB,DISTRICT,ALL AGES,279038,141648,137372,18,242570,124517,118035,18,36468,17131,19337,
SURAB,SURAB,DISTRICT,UNDER 1,7663,3899,3764,,6409,3267,3142,,1254,632,622,
SURAB,SURAB,DISTRICT,UNDER 5,64270,32926,31344,,54814,28463,26351,,9456,4463,4993,
SURAB,SURAB,DISTRICT,UNDER 10,114615,58747,55868,,99241,51604,47637,,15374,7143,8231,
SURAB,SURAB,DISTRICT,UNDER 15,151424,77719,73705,,131799,68663,63136,,19625,9056,10569,
SURAB,SURAB,DISTRICT,05 - 24,142841,72655,70173,13,125889,64985,60891,13,16952,7670,9282,
SURAB,SURAB,DISTRICT,15 - 49,112645,56054,56573,18,98004,49105,48881,18,14641,6949,7692,
SURAB,SURAB,DISTRICT,15 - 64,123492,61611,61863,18,107242,53847,53377,18,16250,7764,8486,
SURAB,SURAB,DISTRICT,18 - 60,102265,50223,52033,9,88538,43651,44878,9,13727,6572,7155,
SURAB,SURAB,DISTRICT,18 &  ABOVE,108177,53521,54647,9,93551,46480,47062,9,14626,7041,7585,
SURAB,SURAB,DISTRICT,60 &  ABOVE,6743,3774,2969,,5754,3261,2493,,989,513,476,
SURAB,SURAB,DISTRICT,65 &  ABOVE,4122,2318,1804,,3529,2007,1522,,593,311,282,
WASHUK,WASHUK,DISTRICT,ALL AGES,302367,162790,139552,25,261516,141885,119606,25,40851,20905,19946,
WASHUK,WASHUK,DISTRICT,UNDER 1,8188,4422,3766,,6784,3734,3050,,1404,688,716,
WASHUK,WASHUK,DISTRICT,UNDER 5,64774,35420,29354,,54898,30527,24371,,9876,4893,4983,
WASHUK,WASHUK,DISTRICT,UNDER 10,122766,67784,54982,,105035,58780,46255,,17731,9004,8727,
WASHUK,WASHUK,DISTRICT,UNDER 15,166162,92329,73830,3,143387,80542,62842,3,22775,11787,10988,
WASHUK,WASHUK,DISTRICT,05 - 24,157660,86414,71230,16,137346,75787,61543,16,20314,10627,9687,
WASHUK,WASHUK,DISTRICT,15 - 49,118640,60675,57945,20,103136,52910,50206,20,15504,7765,7739,
WASHUK,WASHUK,DISTRICT,15 - 64,130970,67342,63606,22,113742,58710,55010,22,17228,8632,8596,
WASHUK,WASHUK,DISTRICT,18 - 60,104302,52222,52065,15,89997,45232,44750,15,14305,6990,7315,
WASHUK,WASHUK,DISTRICT,18 &  ABOVE,111658,56585,55058,15,96161,48927,47219,15,15497,7658,7839,
WASHUK,WASHUK,DISTRICT,60 &  ABOVE,8331,4914,3417,,7025,4190,2835,,1306,724,582,
WASHUK,WASHUK,DISTRICT,65 &  ABOVE,5235,3119,2116,,4387,2633,1754,,848,486,362,
ZHOB,ZHOB,DISTRICT,ALL AGES,355556,192137,163414,5,308655,166733,141917,5,46901,25404,21497,
ZHOB,ZHOB,DISTRICT,UNDER 1,11411,6132,5279,,9670,5280,4390,,1741,852,889,
ZHOB,ZHOB,DISTRICT,UNDER 5,90184,49585,40599,,77960,43003,34957,,12224,6582,5642,
ZHOB,ZHOB,DISTRICT,UNDER 10,159100,87525,71575,,138967,76593,62374,,20133,10932,9201,
ZHOB,ZHOB,DISTRICT,UNDER 15,210214,116254,93959,1,184042,101835,82206,1,26172,14419,11753,
ZHOB,ZHOB,DISTRICT,05 - 24,175388,96266,79117,5,153897,84418,69474,5,21491,11848,9643,
ZHOB,ZHOB,DISTRICT,15 - 49,122434,63077,59353,4,105009,53932,51073,4,17425,9145,8280,
ZHOB,ZHOB,DISTRICT,15 - 64,138528,71918,66606,4,118717,61450,57263,4,19811,10468,9343,
ZHOB,ZHOB,DISTRICT,18 - 60,114021,58020,56000,1,97373,49368,48004,1,16648,8652,7996,
ZHOB,ZHOB,DISTRICT,18 &  ABOVE,123786,63683,60102,1,105815,54284,51530,1,17971,9399,8572,
ZHOB,ZHOB,DISTRICT,60 &  ABOVE,10823,6258,4565,,9340,5418,3922,,1483,840,643,
ZHOB,ZHOB,DISTRICT,65 &  ABOVE,6814,3965,2849,,5896,3448,2448,,918,517,401,
ZIARAT,ZIARAT,DISTRICT,ALL AGES,189535,96172,93355,8,140133,70760,69367,6,49402,25412,23988,2
ZIARAT,ZIARAT,DISTRICT,UNDER 1,6801,3402,3399,,5431,2684,2747,,1370,718,652,
ZIARAT,ZIARAT,DISTRICT,UNDER 5,43422,22161,21261,,33263,16869,16394,,10159,5292,4867,
ZIARAT,ZIARAT,DISTRICT,UNDER 10,78905,40340,38565,,58956,30060,28896,,19949,10280,9669,
ZIARAT,ZIARAT,DISTRICT,UNDER 15,105358,53922,51433,3,78287,40015,38270,2,27071,13907,13163,1
ZIARAT,ZIARAT,DISTRICT,05 - 24,93822,47951,45865,6,68126,34626,33496,4,25696,13325,12369,2
ZIARAT,ZIARAT,DISTRICT,15 - 49,70904,35279,35622,3,51933,25517,26414,2,18971,9762,9208,1
ZIARAT,ZIARAT,DISTRICT,15 - 64,80392,40265,40124,3,58918,29188,29728,2,21474,11077,10396,1
ZIARAT,ZIARAT,DISTRICT,18 - 60,66762,33214,33548,,48939,24028,24911,,17823,9186,8637,
ZIARAT,ZIARAT,DISTRICT,18 &  ABOVE,72352,36161,36189,2,53232,26318,26912,2,19120,9843,9277,
ZIARAT,ZIARAT,DISTRICT,60 &  ABOVE,6113,3222,2889,2,4680,2493,2185,2,1433,729,704,
ZIARAT,ZIARAT,DISTRICT,65 &  ABOVE,3785,1985,1798,2,2928,1557,1369,2,857,428,429,
