name_admin_unit,admin_unit,age_group,marital_status,all_sexes_overall,female_overall,male_overall,tgend_overall,all_sexes_rural,female_rural,male_rural,tgend_rural,all_sexes_urban,female_urban,male_urban,tgend_urban
BADIN,DISTRICT,15 &  ABOVE,DIVORCED,1728,1163,565,0,1024,710,314,0,704,453,251,0
BADIN,DISTRICT,15 &  ABOVE,MARRIED,795751,398523,397228,0,621423,311694,309729,0,174328,86829,87499,0
BADIN,DISTRICT,15 &  ABOVE,NEVER MARRIED,250141,93311,156766,64,179646,65652,113969,25,70495,27659,42797,39
BADIN,DISTRICT,15 &  ABOVE,SEPERATION,1213,740,473,0,840,508,332,0,373,232,141,0
BADIN,DISTRICT,15 &  ABOVE,WIDOWED,40799,32029,8770,0,30404,23763,6641,0,10395,8266,2129,0
BADIN,DISTRICT,15 - 19,DIVORCED,49,34,15,0,38,27,11,0,11,7,4,0
BADIN,DISTRICT,15 - 19,MARRIED,34046,22682,11364,0,28429,18819,9610,0,5617,3863,1754,0
BADIN,DISTRICT,15 - 19,NEVER MARRIED,147507,61358,86136,13,110592,45157,65424,11,36915,16201,20712,2
BADIN,DISTRICT,15 - 19,SEPERATION,58,27,31,0,44,20,24,0,14,7,7,0
BADIN,DISTRICT,15 - 19,WIDOWED,64,31,33,0,56,27,29,0,8,4,4,0
BADIN,DISTRICT,20 - 24,DIVORCED,168,127,41,0,109,84,25,0,59,43,16,0
BADIN,DISTRICT,20 - 24,MARRIED,104041,62162,41879,0,85276,50485,34791,0,18765,11677,7088,0
BADIN,DISTRICT,20 - 24,NEVER MARRIED,56935,18730,38203,2,39074,12159,26913,2,17861,6571,11290,0
BADIN,DISTRICT,20 - 24,SEPERATION,107,62,45,0,75,41,34,0,32,21,11,0
BADIN,DISTRICT,20 - 24,WIDOWED,256,156,100,0,205,125,80,0,51,31,20,0
BADIN,DISTRICT,25 - 29,DIVORCED,258,170,88,0,164,106,58,0,94,64,30,0
BADIN,DISTRICT,25 - 29,MARRIED,112629,57883,54746,0,88923,45175,43748,0,23706,12708,10998,0
BADIN,DISTRICT,25 - 29,NEVER MARRIED,24138,6551,17580,7,15845,4056,11787,2,8293,2495,5793,5
BADIN,DISTRICT,25 - 29,SEPERATION,114,61,53,0,76,40,36,0,38,21,17,0
BADIN,DISTRICT,25 - 29,WIDOWED,466,281,185,0,369,224,145,0,97,57,40,0
BADIN,DISTRICT,30 - 34,DIVORCED,282,193,89,0,152,108,44,0,130,85,45,0
BADIN,DISTRICT,30 - 34,MARRIED,110211,57784,52427,0,84996,44648,40348,0,25215,13136,12079,0
BADIN,DISTRICT,30 - 34,NEVER MARRIED,9738,2976,6758,4,6278,1863,4414,1,3460,1113,2344,3
BADIN,DISTRICT,30 - 34,SEPERATION,138,86,52,0,90,55,35,0,48,31,17,0
BADIN,DISTRICT,30 - 34,WIDOWED,833,572,261,0,603,418,185,0,230,154,76,0
BADIN,DISTRICT,35 - 39,DIVORCED,262,186,76,0,163,113,50,0,99,73,26,0
BADIN,DISTRICT,35 - 39,MARRIED,106283,52650,53633,0,81141,40168,40973,0,25142,12482,12660,0
BADIN,DISTRICT,35 - 39,NEVER MARRIED,5185,1582,3598,5,3404,1014,2389,1,1781,568,1209,4
BADIN,DISTRICT,35 - 39,SEPERATION,164,100,64,0,104,64,40,0,60,36,24,0
BADIN,DISTRICT,35 - 39,WIDOWED,1392,1019,373,0,1011,737,274,0,381,282,99,0
BADIN,DISTRICT,40 - 44,DIVORCED,260,166,94,0,151,110,41,0,109,56,53,0
BADIN,DISTRICT,40 - 44,MARRIED,100069,47406,52663,0,77455,36721,40734,0,22614,10685,11929,0
BADIN,DISTRICT,40 - 44,NEVER MARRIED,2860,866,1987,7,1939,574,1364,1,921,292,623,6
BADIN,DISTRICT,40 - 44,SEPERATION,156,103,53,0,102,69,33,0,54,34,20,0
BADIN,DISTRICT,40 - 44,WIDOWED,2545,1972,573,0,1911,1464,447,0,634,508,126,0
BADIN,DISTRICT,45 - 49,DIVORCED,162,110,52,0,81,54,27,0,81,56,25,0
BADIN,DISTRICT,45 - 49,MARRIED,67481,31631,35850,0,51374,24228,27146,0,16107,7403,8704,0
BADIN,DISTRICT,45 - 49,NEVER MARRIED,1534,488,1040,6,1011,323,688,0,523,165,352,6
BADIN,DISTRICT,45 - 49,SEPERATION,134,88,46,0,98,63,35,0,36,25,11,0
BADIN,DISTRICT,45 - 49,WIDOWED,2903,2322,581,0,2093,1666,427,0,810,656,154,0
BADIN,DISTRICT,50 - 54,DIVORCED,120,74,46,0,71,47,24,0,49,27,22,0
BADIN,DISTRICT,50 - 54,MARRIED,57337,25829,31508,0,43989,19941,24048,0,13348,5888,7460,0
BADIN,DISTRICT,50 - 54,NEVER MARRIED,904,286,613,5,605,208,396,1,299,78,217,4
BADIN,DISTRICT,50 - 54,SEPERATION,101,66,35,0,75,48,27,0,26,18,8,0
BADIN,DISTRICT,50 - 54,WIDOWED,4421,3528,893,0,3242,2553,689,0,1179,975,204,0
BADIN,DISTRICT,55 - 59,DIVORCED,78,48,30,0,37,24,13,0,41,24,17,0
BADIN,DISTRICT,55 - 59,MARRIED,38252,15475,22777,0,28922,11827,17095,0,9330,3648,5682,0
BADIN,DISTRICT,55 - 59,NEVER MARRIED,523,193,326,4,343,127,215,1,180,66,111,3
BADIN,DISTRICT,55 - 59,SEPERATION,75,48,27,0,52,34,18,0,23,14,9,0
BADIN,DISTRICT,55 - 59,WIDOWED,4261,3333,928,0,3056,2359,697,0,1205,974,231,0
BADIN,DISTRICT,60 - 64,DIVORCED,36,22,14,0,24,16,8,0,12,6,6,0
BADIN,DISTRICT,60 - 64,MARRIED,25436,10663,14773,0,19469,8265,11204,0,5967,2398,3569,0
BADIN,DISTRICT,60 - 64,NEVER MARRIED,351,124,223,4,226,77,148,1,125,47,75,3
BADIN,DISTRICT,60 - 64,SEPERATION,70,47,23,0,45,31,14,0,25,16,9,0
BADIN,DISTRICT,60 - 64,WIDOWED,5191,4195,996,0,3838,3095,743,0,1353,1100,253,0
BADIN,DISTRICT,65 - 69,DIVORCED,25,16,9,0,14,9,5,0,11,7,4,0
BADIN,DISTRICT,65 - 69,MARRIED,18258,7189,11069,0,14114,5629,8485,0,4144,1560,2584,0
BADIN,DISTRICT,65 - 69,NEVER MARRIED,211,77,132,2,132,36,95,1,79,41,37,1
BADIN,DISTRICT,65 - 69,SEPERATION,35,21,14,0,27,16,11,0,8,5,3,0
BADIN,DISTRICT,65 - 69,WIDOWED,5460,4350,1110,0,3991,3191,800,0,1469,1159,310,0
BADIN,DISTRICT,70 - 74,DIVORCED,17,12,5,0,12,9,3,0,5,3,2,0
BADIN,DISTRICT,70 - 74,MARRIED,12657,4557,8100,0,9960,3640,6320,0,2697,917,1780,0
BADIN,DISTRICT,70 - 74,NEVER MARRIED,134,41,90,3,97,25,71,1,37,16,19,2
BADIN,DISTRICT,70 - 74,SEPERATION,36,18,18,0,32,16,16,0,4,2,2,0
BADIN,DISTRICT,70 - 74,WIDOWED,5846,4731,1115,0,4437,3583,854,0,1409,1148,261,0
BADIN,DISTRICT,75 & ABOVE,DIVORCED,11,5,6,0,8,3,5,0,3,2,1,0
BADIN,DISTRICT,75 & ABOVE,MARRIED,9051,2612,6439,0,7375,2148,5227,0,1676,464,1212,0
BADIN,DISTRICT,75 & ABOVE,NEVER MARRIED,121,39,80,2,100,33,65,2,21,6,15,0
BADIN,DISTRICT,75 & ABOVE,SEPERATION,25,13,12,0,20,11,9,0,5,2,3,0
BADIN,DISTRICT,75 & ABOVE,WIDOWED,7161,5539,1622,0,5592,4321,1271,0,1569,1218,351,0
DADU,DISTRICT,15 &  ABOVE,DIVORCED,1116,709,407,0,691,445,246,0,425,264,161,0
DADU,DISTRICT,15 &  ABOVE,MARRIED,669302,335893,333409,0,501339,251482,249857,0,167963,84411,83552,0
DADU,DISTRICT,15 &  ABOVE,NEVER MARRIED,276075,116511,159484,80,193032,79581,113419,32,83043,36930,46065,48
DADU,DISTRICT,15 &  ABOVE,SEPERATION,1118,638,480,0,867,489,378,0,251,149,102,0
DADU,DISTRICT,15 &  ABOVE,WIDOWED,35967,28607,7360,0,25746,20363,5383,0,10221,8244,1977,0
DADU,DISTRICT,15 - 19,DIVORCED,31,18,13,0,25,12,13,0,6,6,0,0
DADU,DISTRICT,15 - 19,MARRIED,25696,17707,7989,0,20167,13806,6361,0,5529,3901,1628,0
DADU,DISTRICT,15 - 19,NEVER MARRIED,160276,72976,87283,17,117102,52661,64431,10,43174,20315,22852,7
DADU,DISTRICT,15 - 19,SEPERATION,60,23,37,0,54,20,34,0,6,3,3,0
DADU,DISTRICT,15 - 19,WIDOWED,68,34,34,0,55,25,30,0,13,9,4,0
DADU,DISTRICT,20 - 24,DIVORCED,97,66,31,0,60,37,23,0,37,29,8,0
DADU,DISTRICT,20 - 24,MARRIED,88610,54028,34582,0,69391,41769,27622,0,19219,12259,6960,0
DADU,DISTRICT,20 - 24,NEVER MARRIED,67378,24222,43141,15,45850,15545,30299,6,21528,8677,12842,9
DADU,DISTRICT,20 - 24,SEPERATION,98,47,51,0,80,36,44,0,18,11,7,0
DADU,DISTRICT,20 - 24,WIDOWED,272,165,107,0,212,126,86,0,60,39,21,0
DADU,DISTRICT,25 - 29,DIVORCED,176,107,69,0,120,71,49,0,56,36,20,0
DADU,DISTRICT,25 - 29,MARRIED,88901,47000,41901,0,66429,34763,31666,0,22472,12237,10235,0
DADU,DISTRICT,25 - 29,NEVER MARRIED,26216,10232,15973,11,16415,6043,10368,4,9801,4189,5605,7
DADU,DISTRICT,25 - 29,SEPERATION,123,61,62,0,89,44,45,0,34,17,17,0
DADU,DISTRICT,25 - 29,WIDOWED,474,279,195,0,358,212,146,0,116,67,49,0
DADU,DISTRICT,30 - 34,DIVORCED,179,117,62,0,110,74,36,0,69,43,26,0
DADU,DISTRICT,30 - 34,MARRIED,91416,46790,44626,0,67678,34413,33265,0,23738,12377,11361,0
DADU,DISTRICT,30 - 34,NEVER MARRIED,10507,4767,5736,4,6429,2800,3628,1,4078,1967,2108,3
DADU,DISTRICT,30 - 34,SEPERATION,121,69,52,0,95,52,43,0,26,17,9,0
DADU,DISTRICT,30 - 34,WIDOWED,815,560,255,0,576,382,194,0,239,178,61,0
DADU,DISTRICT,35 - 39,DIVORCED,172,106,66,0,95,65,30,0,77,41,36,0
DADU,DISTRICT,35 - 39,MARRIED,86915,42296,44619,0,63862,31085,32777,0,23053,11211,11842,0
DADU,DISTRICT,35 - 39,NEVER MARRIED,5225,1834,3382,9,3242,1067,2173,2,1983,767,1209,7
DADU,DISTRICT,35 - 39,SEPERATION,139,75,64,0,95,52,43,0,44,23,21,0
DADU,DISTRICT,35 - 39,WIDOWED,1325,946,379,0,944,661,283,0,381,285,96,0
DADU,DISTRICT,40 - 44,DIVORCED,139,99,40,0,88,69,19,0,51,30,21,0
DADU,DISTRICT,40 - 44,MARRIED,76688,36449,40239,0,56977,27024,29953,0,19711,9425,10286,0
DADU,DISTRICT,40 - 44,NEVER MARRIED,2729,1000,1721,8,1672,599,1071,2,1057,401,650,6
DADU,DISTRICT,40 - 44,SEPERATION,135,102,33,0,110,81,29,0,25,21,4,0
DADU,DISTRICT,40 - 44,WIDOWED,2053,1605,448,0,1470,1133,337,0,583,472,111,0
DADU,DISTRICT,45 - 49,DIVORCED,126,77,49,0,77,46,31,0,49,31,18,0
DADU,DISTRICT,45 - 49,MARRIED,60001,28376,31625,0,43929,20903,23026,0,16072,7473,8599,0
DADU,DISTRICT,45 - 49,NEVER MARRIED,1599,599,996,4,979,338,639,2,620,261,357,2
DADU,DISTRICT,45 - 49,SEPERATION,95,60,35,0,75,47,28,0,20,13,7,0
DADU,DISTRICT,45 - 49,WIDOWED,2566,2065,501,0,1817,1455,362,0,749,610,139,0
DADU,DISTRICT,50 - 54,DIVORCED,74,43,31,0,34,20,14,0,40,23,17,0
DADU,DISTRICT,50 - 54,MARRIED,50712,22918,27794,0,37581,17178,20403,0,13131,5740,7391,0
DADU,DISTRICT,50 - 54,NEVER MARRIED,900,375,521,4,553,223,328,2,347,152,193,2
DADU,DISTRICT,50 - 54,SEPERATION,112,68,44,0,86,51,35,0,26,17,9,0
DADU,DISTRICT,50 - 54,WIDOWED,4070,3331,739,0,2932,2370,562,0,1138,961,177,0
DADU,DISTRICT,55 - 59,DIVORCED,48,30,18,0,29,16,13,0,19,14,5,0
DADU,DISTRICT,55 - 59,MARRIED,37280,15662,21618,0,27388,11672,15716,0,9892,3990,5902,0
DADU,DISTRICT,55 - 59,NEVER MARRIED,559,220,334,5,335,123,209,3,224,97,125,2
DADU,DISTRICT,55 - 59,SEPERATION,84,55,29,0,66,43,23,0,18,12,6,0
DADU,DISTRICT,55 - 59,WIDOWED,4201,3403,798,0,2872,2296,576,0,1329,1107,222,0
DADU,DISTRICT,60 - 64,DIVORCED,29,17,12,0,20,12,8,0,9,5,4,0
DADU,DISTRICT,60 - 64,MARRIED,25754,10762,14992,0,19271,8158,11113,0,6483,2604,3879,0
DADU,DISTRICT,60 - 64,NEVER MARRIED,324,135,189,0,207,83,124,0,117,52,65,0
DADU,DISTRICT,60 - 64,SEPERATION,55,34,21,0,42,26,16,0,13,8,5,0
DADU,DISTRICT,60 - 64,WIDOWED,4788,3919,869,0,3426,2776,650,0,1362,1143,219,0
DADU,DISTRICT,65 - 69,DIVORCED,20,13,7,0,15,11,4,0,5,2,3,0
DADU,DISTRICT,65 - 69,MARRIED,17307,7045,10262,0,13074,5378,7696,0,4233,1667,2566,0
DADU,DISTRICT,65 - 69,NEVER MARRIED,176,69,105,2,118,43,75,0,58,26,30,2
DADU,DISTRICT,65 - 69,SEPERATION,39,23,16,0,32,20,12,0,7,3,4,0
DADU,DISTRICT,65 - 69,WIDOWED,4835,3973,862,0,3439,2818,621,0,1396,1155,241,0
DADU,DISTRICT,70 - 74,DIVORCED,16,12,4,0,11,9,2,0,5,3,2,0
DADU,DISTRICT,70 - 74,MARRIED,11517,4150,7367,0,8850,3206,5644,0,2667,944,1723,0
DADU,DISTRICT,70 - 74,NEVER MARRIED,111,50,60,1,81,37,44,0,30,13,16,1
DADU,DISTRICT,70 - 74,SEPERATION,24,11,13,0,19,9,10,0,5,2,3,0
DADU,DISTRICT,70 - 74,WIDOWED,4766,3853,913,0,3431,2783,648,0,1335,1070,265,0
DADU,DISTRICT,75 & ABOVE,DIVORCED,9,4,5,0,7,3,4,0,2,1,1,0
DADU,DISTRICT,75 & ABOVE,MARRIED,8505,2710,5795,0,6742,2127,4615,0,1763,583,1180,0
DADU,DISTRICT,75 & ABOVE,NEVER MARRIED,75,32,43,0,49,19,30,0,26,13,13,0
DADU,DISTRICT,75 & ABOVE,SEPERATION,33,10,23,0,24,8,16,0,9,2,7,0
DADU,DISTRICT,75 & ABOVE,WIDOWED,5734,4474,1260,0,4214,3326,888,0,1520,1148,372,0
GHOTKI,DISTRICT,15 &  ABOVE,DIVORCED,1185,815,370,0,733,519,214,0,452,296,156,0
GHOTKI,DISTRICT,15 &  ABOVE,MARRIED,694390,350759,343631,0,542786,274734,268052,0,151604,76025,75579,0
GHOTKI,DISTRICT,15 &  ABOVE,NEVER MARRIED,251138,93937,157159,42,182260,66304,115938,18,68878,27633,41221,24
GHOTKI,DISTRICT,15 &  ABOVE,SEPERATION,669,379,290,0,478,257,221,0,191,122,69,0
GHOTKI,DISTRICT,15 &  ABOVE,WIDOWED,34669,27873,6796,0,26246,20937,5309,0,8423,6936,1487,0
GHOTKI,DISTRICT,15 - 19,DIVORCED,36,28,8,0,27,20,7,0,9,8,1,0
GHOTKI,DISTRICT,15 - 19,MARRIED,33728,22347,11381,0,28703,18862,9841,0,5025,3485,1540,0
GHOTKI,DISTRICT,15 - 19,NEVER MARRIED,155632,65477,90146,9,117891,48819,69064,8,37741,16658,21082,1
GHOTKI,DISTRICT,15 - 19,SEPERATION,59,27,32,0,47,20,27,0,12,7,5,0
GHOTKI,DISTRICT,15 - 19,WIDOWED,82,40,42,0,69,33,36,0,13,7,6,0
GHOTKI,DISTRICT,20 - 24,DIVORCED,167,128,39,0,104,80,24,0,63,48,15,0
GHOTKI,DISTRICT,20 - 24,MARRIED,96678,58744,37934,0,79862,48063,31799,0,16816,10681,6135,0
GHOTKI,DISTRICT,20 - 24,NEVER MARRIED,60199,18598,41597,4,41289,11616,29671,2,18910,6982,11926,2
GHOTKI,DISTRICT,20 - 24,SEPERATION,51,26,25,0,38,18,20,0,13,8,5,0
GHOTKI,DISTRICT,20 - 24,WIDOWED,306,169,137,0,265,146,119,0,41,23,18,0
GHOTKI,DISTRICT,25 - 29,DIVORCED,180,105,75,0,107,65,42,0,73,40,33,0
GHOTKI,DISTRICT,25 - 29,MARRIED,101224,52942,48282,0,79648,41246,38402,0,21576,11696,9880,0
GHOTKI,DISTRICT,25 - 29,NEVER MARRIED,21620,5847,15768,5,14063,3356,10705,2,7557,2491,5063,3
GHOTKI,DISTRICT,25 - 29,SEPERATION,89,42,47,0,65,30,35,0,24,12,12,0
GHOTKI,DISTRICT,25 - 29,WIDOWED,472,265,207,0,395,213,182,0,77,52,25,0
GHOTKI,DISTRICT,30 - 34,DIVORCED,170,113,57,0,102,67,35,0,68,46,22,0
GHOTKI,DISTRICT,30 - 34,MARRIED,92946,48007,44939,0,71147,36846,34301,0,21799,11161,10638,0
GHOTKI,DISTRICT,30 - 34,NEVER MARRIED,7065,2048,5012,5,4515,1232,3281,2,2550,816,1731,3
GHOTKI,DISTRICT,30 - 34,SEPERATION,50,31,19,0,28,17,11,0,22,14,8,0
GHOTKI,DISTRICT,30 - 34,WIDOWED,761,525,236,0,595,411,184,0,166,114,52,0
GHOTKI,DISTRICT,35 - 39,DIVORCED,179,118,61,0,106,75,31,0,73,43,30,0
GHOTKI,DISTRICT,35 - 39,MARRIED,88552,43692,44860,0,67304,33204,34100,0,21248,10488,10760,0
GHOTKI,DISTRICT,35 - 39,NEVER MARRIED,3167,900,2265,2,2125,571,1554,0,1042,329,711,2
GHOTKI,DISTRICT,35 - 39,SEPERATION,72,44,28,0,47,25,22,0,25,19,6,0
GHOTKI,DISTRICT,35 - 39,WIDOWED,1250,918,332,0,962,688,274,0,288,230,58,0
GHOTKI,DISTRICT,40 - 44,DIVORCED,170,119,51,0,100,72,28,0,70,47,23,0
GHOTKI,DISTRICT,40 - 44,MARRIED,85288,40757,44531,0,65724,31358,34366,0,19564,9399,10165,0
GHOTKI,DISTRICT,40 - 44,NEVER MARRIED,1607,461,1141,5,1089,317,770,2,518,144,371,3
GHOTKI,DISTRICT,40 - 44,SEPERATION,84,50,34,0,61,37,24,0,23,13,10,0
GHOTKI,DISTRICT,40 - 44,WIDOWED,2199,1799,400,0,1665,1353,312,0,534,446,88,0
GHOTKI,DISTRICT,45 - 49,DIVORCED,111,75,36,0,72,51,21,0,39,24,15,0
GHOTKI,DISTRICT,45 - 49,MARRIED,59398,28153,31245,0,45012,21535,23477,0,14386,6618,7768,0
GHOTKI,DISTRICT,45 - 49,NEVER MARRIED,850,251,593,6,582,156,425,1,268,95,168,5
GHOTKI,DISTRICT,45 - 49,SEPERATION,73,49,24,0,55,38,17,0,18,11,7,0
GHOTKI,DISTRICT,45 - 49,WIDOWED,2761,2304,457,0,2081,1725,356,0,680,579,101,0
GHOTKI,DISTRICT,50 - 54,DIVORCED,77,59,18,0,49,39,10,0,28,20,8,0
GHOTKI,DISTRICT,50 - 54,MARRIED,48354,21697,26657,0,36865,16671,20194,0,11489,5026,6463,0
GHOTKI,DISTRICT,50 - 54,NEVER MARRIED,429,145,282,2,292,98,194,0,137,47,88,2
GHOTKI,DISTRICT,50 - 54,SEPERATION,62,38,24,0,45,25,20,0,17,13,4,0
GHOTKI,DISTRICT,50 - 54,WIDOWED,3976,3365,611,0,2995,2508,487,0,981,857,124,0
GHOTKI,DISTRICT,55 - 59,DIVORCED,31,22,9,0,23,17,6,0,8,5,3,0
GHOTKI,DISTRICT,55 - 59,MARRIED,33517,13565,19952,0,25464,10456,15008,0,8053,3109,4944,0
GHOTKI,DISTRICT,55 - 59,NEVER MARRIED,220,65,154,1,161,43,118,0,59,22,36,1
GHOTKI,DISTRICT,55 - 59,SEPERATION,47,25,22,0,35,18,17,0,12,7,5,0
GHOTKI,DISTRICT,55 - 59,WIDOWED,3917,3217,700,0,2886,2355,531,0,1031,862,169,0
GHOTKI,DISTRICT,60 - 64,DIVORCED,27,19,8,0,17,14,3,0,10,5,5,0
GHOTKI,DISTRICT,60 - 64,MARRIED,21666,8797,12869,0,16766,6892,9874,0,4900,1905,2995,0
GHOTKI,DISTRICT,60 - 64,NEVER MARRIED,138,52,84,2,95,36,59,0,43,16,25,2
GHOTKI,DISTRICT,60 - 64,SEPERATION,29,20,9,0,19,12,7,0,10,8,2,0
GHOTKI,DISTRICT,60 - 64,WIDOWED,4309,3556,753,0,3179,2620,559,0,1130,936,194,0
GHOTKI,DISTRICT,65 - 69,DIVORCED,11,10,1,0,9,8,1,0,2,2,0,0
GHOTKI,DISTRICT,65 - 69,MARRIED,15266,6037,9229,0,11817,4682,7135,0,3449,1355,2094,0
GHOTKI,DISTRICT,65 - 69,NEVER MARRIED,105,46,59,0,79,29,50,0,26,17,9,0
GHOTKI,DISTRICT,65 - 69,SEPERATION,23,15,8,0,12,6,6,0,11,9,2,0
GHOTKI,DISTRICT,65 - 69,WIDOWED,4533,3748,785,0,3321,2729,592,0,1212,1019,193,0
GHOTKI,DISTRICT,70 - 74,DIVORCED,16,12,4,0,9,5,4,0,7,7,0,0
GHOTKI,DISTRICT,70 - 74,MARRIED,10093,3660,6433,0,8088,2971,5117,0,2005,689,1316,0
GHOTKI,DISTRICT,70 - 74,NEVER MARRIED,56,18,37,1,43,11,31,1,13,7,6,0
GHOTKI,DISTRICT,70 - 74,SEPERATION,19,8,11,0,16,7,9,0,3,1,2,0
GHOTKI,DISTRICT,70 - 74,WIDOWED,4429,3592,837,0,3339,2692,647,0,1090,900,190,0
GHOTKI,DISTRICT,75 & ABOVE,DIVORCED,10,7,3,0,8,6,2,0,2,1,1,0
GHOTKI,DISTRICT,75 & ABOVE,MARRIED,7680,2361,5319,0,6386,1948,4438,0,1294,413,881,0
GHOTKI,DISTRICT,75 & ABOVE,NEVER MARRIED,50,29,21,0,36,20,16,0,14,9,5,0
GHOTKI,DISTRICT,75 & ABOVE,SEPERATION,11,4,7,0,10,4,6,0,1,0,1,0
GHOTKI,DISTRICT,75 & ABOVE,WIDOWED,5674,4375,1299,0,4494,3464,1030,0,1180,911,269,0
HYDERABAD,DISTRICT,15 &  ABOVE,DIVORCED,5679,3417,2262,0,475,268,207,0,5204,3149,2055,0
HYDERABAD,DISTRICT,15 &  ABOVE,MARRIED,960940,474412,486528,0,160239,79918,80321,0,800701,394494,406207,0
HYDERABAD,DISTRICT,15 &  ABOVE,NEVER MARRIED,485210,187645,297400,165,64216,24486,39724,6,420994,163159,257676,159
HYDERABAD,DISTRICT,15 &  ABOVE,SEPERATION,2338,1154,1184,0,395,226,169,0,1943,928,1015,0
HYDERABAD,DISTRICT,15 &  ABOVE,WIDOWED,62246,46697,15549,0,9617,7192,2425,0,52629,39505,13124,0
HYDERABAD,DISTRICT,15 - 19,DIVORCED,58,43,15,0,19,14,5,0,39,29,10,0
HYDERABAD,DISTRICT,15 - 19,MARRIED,18240,13127,5113,0,6174,4219,1955,0,12066,8908,3158,0
HYDERABAD,DISTRICT,15 - 19,NEVER MARRIED,215840,91641,124173,26,33841,13982,19854,5,181999,77659,104319,21
HYDERABAD,DISTRICT,15 - 19,SEPERATION,63,22,41,0,18,7,11,0,45,15,30,0
HYDERABAD,DISTRICT,15 - 19,WIDOWED,62,38,24,0,15,8,7,0,47,30,17,0
HYDERABAD,DISTRICT,20 - 24,DIVORCED,321,242,79,0,35,23,12,0,286,219,67,0
HYDERABAD,DISTRICT,20 - 24,MARRIED,78038,52528,25510,0,19229,11691,7538,0,58809,40837,17972,0
HYDERABAD,DISTRICT,20 - 24,NEVER MARRIED,131781,51246,80508,27,15237,5333,9904,0,116544,45913,70604,27
HYDERABAD,DISTRICT,20 - 24,SEPERATION,167,96,71,0,21,11,10,0,146,85,61,0
HYDERABAD,DISTRICT,20 - 24,WIDOWED,274,147,127,0,69,30,39,0,205,117,88,0
HYDERABAD,DISTRICT,25 - 29,DIVORCED,669,447,222,0,69,43,26,0,600,404,196,0
HYDERABAD,DISTRICT,25 - 29,MARRIED,128283,74377,53906,0,24131,12743,11388,0,104152,61634,42518,0
HYDERABAD,DISTRICT,25 - 29,NEVER MARRIED,67618,21722,45879,17,7550,2372,5178,0,60068,19350,40701,17
HYDERABAD,DISTRICT,25 - 29,SEPERATION,246,123,123,0,55,30,25,0,191,93,98,0
HYDERABAD,DISTRICT,25 - 29,WIDOWED,611,350,261,0,141,73,68,0,470,277,193,0
HYDERABAD,DISTRICT,30 - 34,DIVORCED,867,553,314,0,87,54,33,0,780,499,281,0
HYDERABAD,DISTRICT,30 - 34,MARRIED,139926,73783,66143,0,22577,11648,10929,0,117349,62135,55214,0
HYDERABAD,DISTRICT,30 - 34,NEVER MARRIED,30651,9311,21319,21,3257,1115,2142,0,27394,8196,19177,21
HYDERABAD,DISTRICT,30 - 34,SEPERATION,291,154,137,0,56,33,23,0,235,121,114,0
HYDERABAD,DISTRICT,30 - 34,WIDOWED,1102,717,385,0,230,144,86,0,872,573,299,0
HYDERABAD,DISTRICT,35 - 39,DIVORCED,973,555,418,0,74,37,37,0,899,518,381,0
HYDERABAD,DISTRICT,35 - 39,MARRIED,141549,69081,72468,0,21948,10764,11184,0,119601,58317,61284,0
HYDERABAD,DISTRICT,35 - 39,NEVER MARRIED,16729,5108,11600,21,1827,667,1160,0,14902,4441,10440,21
HYDERABAD,DISTRICT,35 - 39,SEPERATION,328,156,172,0,61,32,29,0,267,124,143,0
HYDERABAD,DISTRICT,35 - 39,WIDOWED,1988,1359,629,0,349,247,102,0,1639,1112,527,0
HYDERABAD,DISTRICT,40 - 44,DIVORCED,912,536,376,0,72,40,32,0,840,496,344,0
HYDERABAD,DISTRICT,40 - 44,MARRIED,124534,57204,67330,0,20079,9372,10707,0,104455,47832,56623,0
HYDERABAD,DISTRICT,40 - 44,NEVER MARRIED,9143,3101,6026,16,1073,395,678,0,8070,2706,5348,16
HYDERABAD,DISTRICT,40 - 44,SEPERATION,346,181,165,0,57,36,21,0,289,145,144,0
HYDERABAD,DISTRICT,40 - 44,WIDOWED,3363,2451,912,0,605,439,166,0,2758,2012,746,0
HYDERABAD,DISTRICT,45 - 49,DIVORCED,709,405,304,0,37,20,17,0,672,385,287,0
HYDERABAD,DISTRICT,45 - 49,MARRIED,102343,46270,56073,0,14513,6751,7762,0,87830,39519,48311,0
HYDERABAD,DISTRICT,45 - 49,NEVER MARRIED,5705,2115,3581,9,577,247,330,0,5128,1868,3251,9
HYDERABAD,DISTRICT,45 - 49,SEPERATION,305,145,160,0,42,25,17,0,263,120,143,0
HYDERABAD,DISTRICT,45 - 49,WIDOWED,5109,3981,1128,0,887,689,198,0,4222,3292,930,0
HYDERABAD,DISTRICT,50 - 54,DIVORCED,474,261,213,0,27,13,14,0,447,248,199,0
HYDERABAD,DISTRICT,50 - 54,MARRIED,79362,33131,46231,0,11389,4943,6446,0,67973,28188,39785,0
HYDERABAD,DISTRICT,50 - 54,NEVER MARRIED,3145,1265,1872,8,367,155,212,0,2778,1110,1660,8
HYDERABAD,DISTRICT,50 - 54,SEPERATION,219,112,107,0,28,18,10,0,191,94,97,0
HYDERABAD,DISTRICT,50 - 54,WIDOWED,7004,5504,1500,0,1208,944,264,0,5796,4560,1236,0
HYDERABAD,DISTRICT,55 - 59,DIVORCED,327,171,156,0,23,10,13,0,304,161,143,0
HYDERABAD,DISTRICT,55 - 59,MARRIED,61348,24298,37050,0,8010,3220,4790,0,53338,21078,32260,0
HYDERABAD,DISTRICT,55 - 59,NEVER MARRIED,2073,859,1208,6,213,99,114,0,1860,760,1094,6
HYDERABAD,DISTRICT,55 - 59,SEPERATION,155,66,89,0,13,7,6,0,142,59,83,0
HYDERABAD,DISTRICT,55 - 59,WIDOWED,8376,6457,1919,0,1155,877,278,0,7221,5580,1641,0
HYDERABAD,DISTRICT,60 - 64,DIVORCED,200,113,87,0,18,8,10,0,182,105,77,0
HYDERABAD,DISTRICT,60 - 64,MARRIED,38738,14444,24294,0,5056,2079,2977,0,33682,12365,21317,0
HYDERABAD,DISTRICT,60 - 64,NEVER MARRIED,1205,605,591,9,115,54,60,1,1090,551,531,8
HYDERABAD,DISTRICT,60 - 64,SEPERATION,101,47,54,0,22,13,9,0,79,34,45,0
HYDERABAD,DISTRICT,60 - 64,WIDOWED,9040,6943,2097,0,1270,992,278,0,7770,5951,1819,0
HYDERABAD,DISTRICT,65 - 69,DIVORCED,99,52,47,0,6,3,3,0,93,49,44,0
HYDERABAD,DISTRICT,65 - 69,MARRIED,24914,8967,15947,0,3487,1287,2200,0,21427,7680,13747,0
HYDERABAD,DISTRICT,65 - 69,NEVER MARRIED,702,357,345,0,85,39,46,0,617,318,299,0
HYDERABAD,DISTRICT,65 - 69,SEPERATION,59,27,32,0,10,7,3,0,49,20,29,0
HYDERABAD,DISTRICT,65 - 69,WIDOWED,9181,6894,2287,0,1298,984,314,0,7883,5910,1973,0
HYDERABAD,DISTRICT,70 - 74,DIVORCED,41,20,21,0,4,1,3,0,37,19,18,0
HYDERABAD,DISTRICT,70 - 74,MARRIED,14269,4517,9752,0,2177,763,1414,0,12092,3754,8338,0
HYDERABAD,DISTRICT,70 - 74,NEVER MARRIED,377,185,190,2,39,14,25,0,338,171,165,2
HYDERABAD,DISTRICT,70 - 74,SEPERATION,37,16,21,0,7,3,4,0,30,13,17,0
HYDERABAD,DISTRICT,70 - 74,WIDOWED,7717,5721,1996,0,1205,884,321,0,6512,4837,1675,0
HYDERABAD,DISTRICT,75 & ABOVE,DIVORCED,29,19,10,0,4,2,2,0,25,17,8,0
HYDERABAD,DISTRICT,75 & ABOVE,MARRIED,9396,2685,6711,0,1469,438,1031,0,7927,2247,5680,0
HYDERABAD,DISTRICT,75 & ABOVE,NEVER MARRIED,241,130,108,3,35,14,21,0,206,116,87,3
HYDERABAD,DISTRICT,75 & ABOVE,SEPERATION,21,9,12,0,5,4,1,0,16,5,11,0
HYDERABAD,DISTRICT,75 & ABOVE,WIDOWED,8419,6135,2284,0,1185,881,304,0,7234,5254,1980,0
JACOBABAD,DISTRICT,15 &  ABOVE,DIVORCED,418,284,134,0,234,161,73,0,184,123,61,0
JACOBABAD,DISTRICT,15 &  ABOVE,MARRIED,401724,202553,199171,0,282994,143249,139745,0,118730,59304,59426,0
JACOBABAD,DISTRICT,15 &  ABOVE,NEVER MARRIED,147969,62465,85401,103,88265,36104,52135,26,59704,26361,33266,77
JACOBABAD,DISTRICT,15 &  ABOVE,SEPERATION,447,193,254,0,287,136,151,0,160,57,103,0
JACOBABAD,DISTRICT,15 &  ABOVE,WIDOWED,19778,16136,3642,0,12605,10238,2367,0,7173,5898,1275,0
JACOBABAD,DISTRICT,15 - 19,DIVORCED,14,10,4,0,10,8,2,0,4,2,2,0
JACOBABAD,DISTRICT,15 - 19,MARRIED,25699,16427,9272,0,20786,13056,7730,0,4913,3371,1542,0
JACOBABAD,DISTRICT,15 - 19,NEVER MARRIED,98946,44081,54842,23,64080,27695,36381,4,34866,16386,18461,19
JACOBABAD,DISTRICT,15 - 19,SEPERATION,75,28,47,0,41,17,24,0,34,11,23,0
JACOBABAD,DISTRICT,15 - 19,WIDOWED,72,29,43,0,56,20,36,0,16,9,7,0
JACOBABAD,DISTRICT,20 - 24,DIVORCED,39,26,13,0,23,16,7,0,16,10,6,0
JACOBABAD,DISTRICT,20 - 24,MARRIED,52750,30872,21878,0,39908,22975,16933,0,12842,7897,4945,0
JACOBABAD,DISTRICT,20 - 24,NEVER MARRIED,29780,10953,18810,17,15894,5455,10434,5,13886,5498,8376,12
JACOBABAD,DISTRICT,20 - 24,SEPERATION,42,8,34,0,32,7,25,0,10,1,9,0
JACOBABAD,DISTRICT,20 - 24,WIDOWED,125,71,54,0,90,46,44,0,35,25,10,0
JACOBABAD,DISTRICT,25 - 29,DIVORCED,69,46,23,0,41,29,12,0,28,17,11,0
JACOBABAD,DISTRICT,25 - 29,MARRIED,54539,28363,26176,0,38179,19647,18532,0,16360,8716,7644,0
JACOBABAD,DISTRICT,25 - 29,NEVER MARRIED,10968,4348,6598,22,4815,1740,3072,3,6153,2608,3526,19
JACOBABAD,DISTRICT,25 - 29,SEPERATION,45,11,34,0,30,8,22,0,15,3,12,0
JACOBABAD,DISTRICT,25 - 29,WIDOWED,249,154,95,0,173,109,64,0,76,45,31,0
JACOBABAD,DISTRICT,30 - 34,DIVORCED,53,36,17,0,24,14,10,0,29,22,7,0
JACOBABAD,DISTRICT,30 - 34,MARRIED,54524,28438,26086,0,37291,19483,17808,0,17233,8955,8278,0
JACOBABAD,DISTRICT,30 - 34,NEVER MARRIED,4109,1656,2444,9,1696,638,1054,4,2413,1018,1390,5
JACOBABAD,DISTRICT,30 - 34,SEPERATION,45,19,26,0,22,14,8,0,23,5,18,0
JACOBABAD,DISTRICT,30 - 34,WIDOWED,460,326,134,0,324,231,93,0,136,95,41,0
JACOBABAD,DISTRICT,35 - 39,DIVORCED,70,46,24,0,35,23,12,0,35,23,12,0
JACOBABAD,DISTRICT,35 - 39,MARRIED,54245,27032,27213,0,36595,18392,18203,0,17650,8640,9010,0
JACOBABAD,DISTRICT,35 - 39,NEVER MARRIED,2004,655,1339,10,803,270,530,3,1201,385,809,7
JACOBABAD,DISTRICT,35 - 39,SEPERATION,51,24,27,0,34,18,16,0,17,6,11,0
JACOBABAD,DISTRICT,35 - 39,WIDOWED,782,589,193,0,500,364,136,0,282,225,57,0
JACOBABAD,DISTRICT,40 - 44,DIVORCED,50,35,15,0,27,19,8,0,23,16,7,0
JACOBABAD,DISTRICT,40 - 44,MARRIED,48941,23228,25713,0,34027,16139,17888,0,14914,7089,7825,0
JACOBABAD,DISTRICT,40 - 44,NEVER MARRIED,929,322,603,4,404,127,276,1,525,195,327,3
JACOBABAD,DISTRICT,40 - 44,SEPERATION,45,30,15,0,33,26,7,0,12,4,8,0
JACOBABAD,DISTRICT,40 - 44,WIDOWED,1313,1024,289,0,893,688,205,0,420,336,84,0
JACOBABAD,DISTRICT,45 - 49,DIVORCED,46,32,14,0,33,24,9,0,13,8,5,0
JACOBABAD,DISTRICT,45 - 49,MARRIED,34811,16128,18683,0,23629,11049,12580,0,11182,5079,6103,0
JACOBABAD,DISTRICT,45 - 49,NEVER MARRIED,543,197,336,10,232,62,168,2,311,135,168,8
JACOBABAD,DISTRICT,45 - 49,SEPERATION,34,21,13,0,22,16,6,0,12,5,7,0
JACOBABAD,DISTRICT,45 - 49,WIDOWED,1711,1403,308,0,1094,886,208,0,617,517,100,0
JACOBABAD,DISTRICT,50 - 54,DIVORCED,29,17,12,0,15,10,5,0,14,7,7,0
JACOBABAD,DISTRICT,50 - 54,MARRIED,27509,12766,14743,0,18605,8794,9811,0,8904,3972,4932,0
JACOBABAD,DISTRICT,50 - 54,NEVER MARRIED,282,103,177,2,129,40,88,1,153,63,89,1
JACOBABAD,DISTRICT,50 - 54,SEPERATION,27,9,18,0,16,5,11,0,11,4,7,0
JACOBABAD,DISTRICT,50 - 54,WIDOWED,2421,2091,330,0,1510,1298,212,0,911,793,118,0
JACOBABAD,DISTRICT,55 - 59,DIVORCED,19,12,7,0,9,5,4,0,10,7,3,0
JACOBABAD,DISTRICT,55 - 59,MARRIED,19554,8235,11319,0,13151,5648,7503,0,6403,2587,3816,0
JACOBABAD,DISTRICT,55 - 59,NEVER MARRIED,169,53,111,5,86,22,62,2,83,31,49,3
JACOBABAD,DISTRICT,55 - 59,SEPERATION,25,12,13,0,19,8,11,0,6,4,2,0
JACOBABAD,DISTRICT,55 - 59,WIDOWED,2474,2053,421,0,1478,1207,271,0,996,846,150,0
JACOBABAD,DISTRICT,60 - 64,DIVORCED,9,9,0,0,6,6,0,0,3,3,0,0
JACOBABAD,DISTRICT,60 - 64,MARRIED,12915,5307,7608,0,9039,3846,5193,0,3876,1461,2415,0
JACOBABAD,DISTRICT,60 - 64,NEVER MARRIED,131,47,84,0,62,24,38,0,69,23,46,0
JACOBABAD,DISTRICT,60 - 64,SEPERATION,29,16,13,0,17,7,10,0,12,9,3,0
JACOBABAD,DISTRICT,60 - 64,WIDOWED,2748,2303,445,0,1714,1424,290,0,1034,879,155,0
JACOBABAD,DISTRICT,65 - 69,DIVORCED,8,5,3,0,4,2,2,0,4,3,1,0
JACOBABAD,DISTRICT,65 - 69,MARRIED,7649,2935,4714,0,5375,2084,3291,0,2274,851,1423,0
JACOBABAD,DISTRICT,65 - 69,NEVER MARRIED,60,24,36,0,30,12,18,0,30,12,18,0
JACOBABAD,DISTRICT,65 - 69,SEPERATION,15,8,7,0,10,5,5,0,5,3,2,0
JACOBABAD,DISTRICT,65 - 69,WIDOWED,2459,2046,413,0,1493,1256,237,0,966,790,176,0
JACOBABAD,DISTRICT,70 - 74,DIVORCED,6,6,0,0,2,2,0,0,4,4,0,0
JACOBABAD,DISTRICT,70 - 74,MARRIED,5096,1795,3301,0,3696,1324,2372,0,1400,471,929,0
JACOBABAD,DISTRICT,70 - 74,NEVER MARRIED,26,13,13,0,17,10,7,0,9,3,6,0
JACOBABAD,DISTRICT,70 - 74,SEPERATION,9,5,4,0,6,3,3,0,3,2,1,0
JACOBABAD,DISTRICT,70 - 74,WIDOWED,2470,2031,439,0,1577,1311,266,0,893,720,173,0
JACOBABAD,DISTRICT,75 & ABOVE,DIVORCED,6,4,2,0,5,3,2,0,1,1,0,0
JACOBABAD,DISTRICT,75 & ABOVE,MARRIED,3492,1027,2465,0,2713,812,1901,0,779,215,564,0
JACOBABAD,DISTRICT,75 & ABOVE,NEVER MARRIED,22,13,8,1,17,9,7,1,5,4,1,0
JACOBABAD,DISTRICT,75 & ABOVE,SEPERATION,5,2,3,0,5,2,3,0,0,0,0,0
JACOBABAD,DISTRICT,75 & ABOVE,WIDOWED,2494,2016,478,0,1703,1398,305,0,791,618,173,0
JAMSHORO,DISTRICT,15 &  ABOVE,DIVORCED,1146,730,416,0,307,206,101,0,839,524,315,0
JAMSHORO,DISTRICT,15 &  ABOVE,MARRIED,428104,212585,215519,0,227438,113423,114015,0,200666,99162,101504,0
JAMSHORO,DISTRICT,15 &  ABOVE,NEVER MARRIED,196487,79443,116979,65,93767,36825,56935,7,102720,42618,60044,58
JAMSHORO,DISTRICT,15 &  ABOVE,SEPERATION,913,404,509,0,502,187,315,0,411,217,194,0
JAMSHORO,DISTRICT,15 &  ABOVE,WIDOWED,24909,19123,5786,0,12466,9372,3094,0,12443,9751,2692,0
JAMSHORO,DISTRICT,15 - 19,DIVORCED,23,20,3,0,8,6,2,0,15,14,1,0
JAMSHORO,DISTRICT,15 - 19,MARRIED,14055,9795,4260,0,8761,5914,2847,0,5294,3881,1413,0
JAMSHORO,DISTRICT,15 - 19,NEVER MARRIED,99645,44514,55122,9,50401,21943,28456,2,49244,22571,26666,7
JAMSHORO,DISTRICT,15 - 19,SEPERATION,43,20,23,0,25,9,16,0,18,11,7,0
JAMSHORO,DISTRICT,15 - 19,WIDOWED,45,22,23,0,23,9,14,0,22,13,9,0
JAMSHORO,DISTRICT,20 - 24,DIVORCED,99,81,18,0,36,30,6,0,63,51,12,0
JAMSHORO,DISTRICT,20 - 24,MARRIED,44817,28332,16485,0,24822,15311,9511,0,19995,13021,6974,0
JAMSHORO,DISTRICT,20 - 24,NEVER MARRIED,51296,19305,31980,11,22776,8113,14661,2,28520,11192,17319,9
JAMSHORO,DISTRICT,20 - 24,SEPERATION,75,35,40,0,40,9,31,0,35,26,9,0
JAMSHORO,DISTRICT,20 - 24,WIDOWED,165,94,71,0,83,39,44,0,82,55,27,0
JAMSHORO,DISTRICT,25 - 29,DIVORCED,165,99,66,0,41,24,17,0,124,75,49,0
JAMSHORO,DISTRICT,25 - 29,MARRIED,57384,31179,26205,0,29783,16057,13726,0,27601,15122,12479,0
JAMSHORO,DISTRICT,25 - 29,NEVER MARRIED,23982,8557,15416,9,10602,3559,7043,0,13380,4998,8373,9
JAMSHORO,DISTRICT,25 - 29,SEPERATION,99,35,64,0,58,14,44,0,41,21,20,0
JAMSHORO,DISTRICT,25 - 29,WIDOWED,319,175,144,0,177,84,93,0,142,91,51,0
JAMSHORO,DISTRICT,30 - 34,DIVORCED,190,115,75,0,41,27,14,0,149,88,61,0
JAMSHORO,DISTRICT,30 - 34,MARRIED,60725,31519,29206,0,31782,16672,15110,0,28943,14847,14096,0
JAMSHORO,DISTRICT,30 - 34,NEVER MARRIED,10016,3196,6810,10,4667,1450,3216,1,5349,1746,3594,9
JAMSHORO,DISTRICT,30 - 34,SEPERATION,99,38,61,0,53,18,35,0,46,20,26,0
JAMSHORO,DISTRICT,30 - 34,WIDOWED,583,373,210,0,317,192,125,0,266,181,85,0
JAMSHORO,DISTRICT,35 - 39,DIVORCED,204,132,72,0,53,39,14,0,151,93,58,0
JAMSHORO,DISTRICT,35 - 39,MARRIED,60257,29794,30463,0,31235,15634,15601,0,29022,14160,14862,0
JAMSHORO,DISTRICT,35 - 39,NEVER MARRIED,5211,1686,3517,8,2420,801,1619,0,2791,885,1898,8
JAMSHORO,DISTRICT,35 - 39,SEPERATION,135,50,85,0,77,31,46,0,58,19,39,0
JAMSHORO,DISTRICT,35 - 39,WIDOWED,918,627,291,0,455,296,159,0,463,331,132,0
JAMSHORO,DISTRICT,40 - 44,DIVORCED,167,98,69,0,44,28,16,0,123,70,53,0
JAMSHORO,DISTRICT,40 - 44,MARRIED,54026,25585,28441,0,28304,13511,14793,0,25722,12074,13648,0
JAMSHORO,DISTRICT,40 - 44,NEVER MARRIED,2780,918,1857,5,1342,448,893,1,1438,470,964,4
JAMSHORO,DISTRICT,40 - 44,SEPERATION,127,65,62,0,61,32,29,0,66,33,33,0
JAMSHORO,DISTRICT,40 - 44,WIDOWED,1537,1157,380,0,780,585,195,0,757,572,185,0
JAMSHORO,DISTRICT,45 - 49,DIVORCED,106,71,35,0,31,22,9,0,75,49,26,0
JAMSHORO,DISTRICT,45 - 49,MARRIED,42657,19520,23137,0,22399,10329,12070,0,20258,9191,11067,0
JAMSHORO,DISTRICT,45 - 49,NEVER MARRIED,1584,560,1017,7,719,258,461,0,865,302,556,7
JAMSHORO,DISTRICT,45 - 49,SEPERATION,98,45,53,0,49,18,31,0,49,27,22,0
JAMSHORO,DISTRICT,45 - 49,WIDOWED,2055,1582,473,0,1008,740,268,0,1047,842,205,0
JAMSHORO,DISTRICT,50 - 54,DIVORCED,76,45,31,0,18,11,7,0,58,34,24,0
JAMSHORO,DISTRICT,50 - 54,MARRIED,33299,14330,18969,0,17500,7566,9934,0,15799,6764,9035,0
JAMSHORO,DISTRICT,50 - 54,NEVER MARRIED,798,292,502,4,345,117,227,1,453,175,275,3
JAMSHORO,DISTRICT,50 - 54,SEPERATION,69,35,34,0,38,16,22,0,31,19,12,0
JAMSHORO,DISTRICT,50 - 54,WIDOWED,2923,2373,550,0,1420,1122,298,0,1503,1251,252,0
JAMSHORO,DISTRICT,55 - 59,DIVORCED,50,23,27,0,14,5,9,0,36,18,18,0
JAMSHORO,DISTRICT,55 - 59,MARRIED,23984,9404,14580,0,12289,4936,7353,0,11695,4468,7227,0
JAMSHORO,DISTRICT,55 - 59,NEVER MARRIED,519,168,351,0,209,56,153,0,310,112,198,0
JAMSHORO,DISTRICT,55 - 59,SEPERATION,64,37,27,0,33,17,16,0,31,20,11,0
JAMSHORO,DISTRICT,55 - 59,WIDOWED,3027,2371,656,0,1365,1048,317,0,1662,1323,339,0
JAMSHORO,DISTRICT,60 - 64,DIVORCED,37,28,9,0,13,10,3,0,24,18,6,0
JAMSHORO,DISTRICT,60 - 64,MARRIED,15423,5919,9504,0,8155,3233,4922,0,7268,2686,4582,0
JAMSHORO,DISTRICT,60 - 64,NEVER MARRIED,299,108,190,1,125,37,88,0,174,71,102,1
JAMSHORO,DISTRICT,60 - 64,SEPERATION,37,20,17,0,23,12,11,0,14,8,6,0
JAMSHORO,DISTRICT,60 - 64,WIDOWED,3300,2597,703,0,1596,1235,361,0,1704,1362,342,0
JAMSHORO,DISTRICT,65 - 69,DIVORCED,15,10,5,0,2,1,1,0,13,9,4,0
JAMSHORO,DISTRICT,65 - 69,MARRIED,10260,3797,6463,0,5527,2100,3427,0,4733,1697,3036,0
JAMSHORO,DISTRICT,65 - 69,NEVER MARRIED,174,72,102,0,76,18,58,0,98,54,44,0
JAMSHORO,DISTRICT,65 - 69,SEPERATION,28,13,15,0,18,6,12,0,10,7,3,0
JAMSHORO,DISTRICT,65 - 69,WIDOWED,3267,2562,705,0,1532,1191,341,0,1735,1371,364,0
JAMSHORO,DISTRICT,70 - 74,DIVORCED,9,6,3,0,3,2,1,0,6,4,2,0
JAMSHORO,DISTRICT,70 - 74,MARRIED,6397,2056,4341,0,3699,1228,2471,0,2698,828,1870,0
JAMSHORO,DISTRICT,70 - 74,NEVER MARRIED,99,38,60,1,40,14,26,0,59,24,34,1
JAMSHORO,DISTRICT,70 - 74,SEPERATION,21,2,19,0,14,0,14,0,7,2,5,0
JAMSHORO,DISTRICT,70 - 74,WIDOWED,3114,2424,690,0,1560,1217,343,0,1554,1207,347,0
JAMSHORO,DISTRICT,75 & ABOVE,DIVORCED,5,2,3,0,3,1,2,0,2,1,1,0
JAMSHORO,DISTRICT,75 & ABOVE,MARRIED,4820,1355,3465,0,3182,932,2250,0,1638,423,1215,0
JAMSHORO,DISTRICT,75 & ABOVE,NEVER MARRIED,84,29,55,0,45,11,34,0,39,18,21,0
JAMSHORO,DISTRICT,75 & ABOVE,SEPERATION,18,9,9,0,13,5,8,0,5,4,1,0
JAMSHORO,DISTRICT,75 & ABOVE,WIDOWED,3656,2766,890,0,2150,1614,536,0,1506,1152,354,0
KAMBAR SHAHDAD KOT,DISTRICT,15 &  ABOVE,DIVORCED,590,402,188,0,345,237,108,0,245,165,80,0
KAMBAR SHAHDAD KOT,DISTRICT,15 &  ABOVE,MARRIED,554098,280721,273377,0,399563,202470,197093,0,154535,78251,76284,0
KAMBAR SHAHDAD KOT,DISTRICT,15 &  ABOVE,NEVER MARRIED,219631,85432,134164,35,149283,57378,91896,9,70348,28054,42268,26
KAMBAR SHAHDAD KOT,DISTRICT,15 &  ABOVE,SEPERATION,1034,445,589,0,769,291,478,0,265,154,111,0
KAMBAR SHAHDAD KOT,DISTRICT,15 &  ABOVE,WIDOWED,24604,19571,5033,0,16645,13119,3526,0,7959,6452,1507,0
KAMBAR SHAHDAD KOT,DISTRICT,15 - 19,DIVORCED,15,9,6,0,9,6,3,0,6,3,3,0
KAMBAR SHAHDAD KOT,DISTRICT,15 - 19,MARRIED,22789,15154,7635,0,16922,11192,5730,0,5867,3962,1905,0
KAMBAR SHAHDAD KOT,DISTRICT,15 - 19,NEVER MARRIED,134259,57422,76828,9,94372,40019,54349,4,39887,17403,22479,5
KAMBAR SHAHDAD KOT,DISTRICT,15 - 19,SEPERATION,40,19,21,0,33,15,18,0,7,4,3,0
KAMBAR SHAHDAD KOT,DISTRICT,15 - 19,WIDOWED,93,51,42,0,73,38,35,0,20,13,7,0
KAMBAR SHAHDAD KOT,DISTRICT,20 - 24,DIVORCED,57,39,18,0,32,20,12,0,25,19,6,0
KAMBAR SHAHDAD KOT,DISTRICT,20 - 24,MARRIED,75835,45772,30063,0,56727,33986,22741,0,19108,11786,7322,0
KAMBAR SHAHDAD KOT,DISTRICT,20 - 24,NEVER MARRIED,52109,17222,34883,4,34719,10995,23724,0,17390,6227,11159,4
KAMBAR SHAHDAD KOT,DISTRICT,20 - 24,SEPERATION,98,33,65,0,81,22,59,0,17,11,6,0
KAMBAR SHAHDAD KOT,DISTRICT,20 - 24,WIDOWED,224,118,106,0,161,84,77,0,63,34,29,0
KAMBAR SHAHDAD KOT,DISTRICT,25 - 29,DIVORCED,79,50,29,0,49,32,17,0,30,18,12,0
KAMBAR SHAHDAD KOT,DISTRICT,25 - 29,MARRIED,74959,39423,35536,0,54221,28373,25848,0,20738,11050,9688,0
KAMBAR SHAHDAD KOT,DISTRICT,25 - 29,NEVER MARRIED,18602,5741,12858,3,11478,3441,8036,1,7124,2300,4822,2
KAMBAR SHAHDAD KOT,DISTRICT,25 - 29,SEPERATION,106,25,81,0,79,14,65,0,27,11,16,0
KAMBAR SHAHDAD KOT,DISTRICT,25 - 29,WIDOWED,386,234,152,0,275,164,111,0,111,70,41,0
KAMBAR SHAHDAD KOT,DISTRICT,30 - 34,DIVORCED,76,50,26,0,36,23,13,0,40,27,13,0
KAMBAR SHAHDAD KOT,DISTRICT,30 - 34,MARRIED,72862,37868,34994,0,51715,26802,24913,0,21147,11066,10081,0
KAMBAR SHAHDAD KOT,DISTRICT,30 - 34,NEVER MARRIED,7022,2322,4695,5,4228,1352,2875,1,2794,970,1820,4
KAMBAR SHAHDAD KOT,DISTRICT,30 - 34,SEPERATION,100,38,62,0,72,19,53,0,28,19,9,0
KAMBAR SHAHDAD KOT,DISTRICT,30 - 34,WIDOWED,577,383,194,0,417,271,146,0,160,112,48,0
KAMBAR SHAHDAD KOT,DISTRICT,35 - 39,DIVORCED,95,67,28,0,60,43,17,0,35,24,11,0
KAMBAR SHAHDAD KOT,DISTRICT,35 - 39,MARRIED,70939,35055,35884,0,50265,24887,25378,0,20674,10168,10506,0
KAMBAR SHAHDAD KOT,DISTRICT,35 - 39,NEVER MARRIED,3447,1198,2247,2,1988,647,1341,0,1459,551,906,2
KAMBAR SHAHDAD KOT,DISTRICT,35 - 39,SEPERATION,114,38,76,0,90,24,66,0,24,14,10,0
KAMBAR SHAHDAD KOT,DISTRICT,35 - 39,WIDOWED,939,676,263,0,667,475,192,0,272,201,71,0
KAMBAR SHAHDAD KOT,DISTRICT,40 - 44,DIVORCED,85,57,28,0,52,35,17,0,33,22,11,0
KAMBAR SHAHDAD KOT,DISTRICT,40 - 44,MARRIED,67416,32232,35184,0,48250,23035,25215,0,19166,9197,9969,0
KAMBAR SHAHDAD KOT,DISTRICT,40 - 44,NEVER MARRIED,1803,629,1169,5,1068,365,702,1,735,264,467,4
KAMBAR SHAHDAD KOT,DISTRICT,40 - 44,SEPERATION,103,45,58,0,79,29,50,0,24,16,8,0
KAMBAR SHAHDAD KOT,DISTRICT,40 - 44,WIDOWED,1528,1197,331,0,1026,806,220,0,502,391,111,0
KAMBAR SHAHDAD KOT,DISTRICT,45 - 49,DIVORCED,66,46,20,0,39,29,10,0,27,17,10,0
KAMBAR SHAHDAD KOT,DISTRICT,45 - 49,MARRIED,48176,23007,25169,0,34280,16450,17830,0,13896,6557,7339,0
KAMBAR SHAHDAD KOT,DISTRICT,45 - 49,NEVER MARRIED,1011,366,642,3,594,217,376,1,417,149,266,2
KAMBAR SHAHDAD KOT,DISTRICT,45 - 49,SEPERATION,113,60,53,0,86,45,41,0,27,15,12,0
KAMBAR SHAHDAD KOT,DISTRICT,45 - 49,WIDOWED,1915,1562,353,0,1311,1064,247,0,604,498,106,0
KAMBAR SHAHDAD KOT,DISTRICT,50 - 54,DIVORCED,42,29,13,0,24,17,7,0,18,12,6,0
KAMBAR SHAHDAD KOT,DISTRICT,50 - 54,MARRIED,38648,18051,20597,0,27682,13006,14676,0,10966,5045,5921,0
KAMBAR SHAHDAD KOT,DISTRICT,50 - 54,NEVER MARRIED,564,204,358,2,330,124,206,0,234,80,152,2
KAMBAR SHAHDAD KOT,DISTRICT,50 - 54,SEPERATION,99,57,42,0,66,37,29,0,33,20,13,0
KAMBAR SHAHDAD KOT,DISTRICT,50 - 54,WIDOWED,2501,2060,441,0,1680,1381,299,0,821,679,142,0
KAMBAR SHAHDAD KOT,DISTRICT,55 - 59,DIVORCED,29,23,6,0,19,15,4,0,10,8,2,0
KAMBAR SHAHDAD KOT,DISTRICT,55 - 59,MARRIED,29241,12709,16532,0,20920,9170,11750,0,8321,3539,4782,0
KAMBAR SHAHDAD KOT,DISTRICT,55 - 59,NEVER MARRIED,340,130,209,1,200,83,117,0,140,47,92,1
KAMBAR SHAHDAD KOT,DISTRICT,55 - 59,SEPERATION,84,44,40,0,53,26,27,0,31,18,13,0
KAMBAR SHAHDAD KOT,DISTRICT,55 - 59,WIDOWED,2728,2251,477,0,1816,1485,331,0,912,766,146,0
KAMBAR SHAHDAD KOT,DISTRICT,60 - 64,DIVORCED,19,13,6,0,13,10,3,0,6,3,3,0
KAMBAR SHAHDAD KOT,DISTRICT,60 - 64,MARRIED,21248,9302,11946,0,15153,6686,8467,0,6095,2616,3479,0
KAMBAR SHAHDAD KOT,DISTRICT,60 - 64,NEVER MARRIED,200,90,109,1,123,62,60,1,77,28,49,0
KAMBAR SHAHDAD KOT,DISTRICT,60 - 64,SEPERATION,57,30,27,0,39,22,17,0,18,8,10,0
KAMBAR SHAHDAD KOT,DISTRICT,60 - 64,WIDOWED,3308,2741,567,0,2185,1786,399,0,1123,955,168,0
KAMBAR SHAHDAD KOT,DISTRICT,65 - 69,DIVORCED,12,8,4,0,5,3,2,0,7,5,2,0
KAMBAR SHAHDAD KOT,DISTRICT,65 - 69,MARRIED,14272,5904,8368,0,10328,4290,6038,0,3944,1614,2330,0
KAMBAR SHAHDAD KOT,DISTRICT,65 - 69,NEVER MARRIED,127,47,80,0,83,32,51,0,44,15,29,0
KAMBAR SHAHDAD KOT,DISTRICT,65 - 69,SEPERATION,57,37,20,0,41,24,17,0,16,13,3,0
KAMBAR SHAHDAD KOT,DISTRICT,65 - 69,WIDOWED,3288,2650,638,0,2187,1755,432,0,1101,895,206,0
KAMBAR SHAHDAD KOT,DISTRICT,70 - 74,DIVORCED,11,8,3,0,6,4,2,0,5,4,1,0
KAMBAR SHAHDAD KOT,DISTRICT,70 - 74,MARRIED,9977,3725,6252,0,7341,2749,4592,0,2636,976,1660,0
KAMBAR SHAHDAD KOT,DISTRICT,70 - 74,NEVER MARRIED,71,29,42,0,47,20,27,0,24,9,15,0
KAMBAR SHAHDAD KOT,DISTRICT,70 - 74,SEPERATION,28,11,17,0,24,9,15,0,4,2,2,0
KAMBAR SHAHDAD KOT,DISTRICT,70 - 74,WIDOWED,3178,2559,619,0,2121,1705,416,0,1057,854,203,0
KAMBAR SHAHDAD KOT,DISTRICT,75 & ABOVE,DIVORCED,4,3,1,0,1,0,1,0,3,3,0,0
KAMBAR SHAHDAD KOT,DISTRICT,75 & ABOVE,MARRIED,7736,2519,5217,0,5759,1844,3915,0,1977,675,1302,0
KAMBAR SHAHDAD KOT,DISTRICT,75 & ABOVE,NEVER MARRIED,76,32,44,0,53,21,32,0,23,11,12,0
KAMBAR SHAHDAD KOT,DISTRICT,75 & ABOVE,SEPERATION,35,8,27,0,26,5,21,0,9,3,6,0
KAMBAR SHAHDAD KOT,DISTRICT,75 & ABOVE,WIDOWED,3939,3089,850,0,2726,2105,621,0,1213,984,229,0
KARACHI CENTRAL,DISTRICT,15 &  ABOVE,DIVORCED,13155,8674,4481,0,0,0,0,0,13155,8674,4481,0
KARACHI CENTRAL,DISTRICT,15 &  ABOVE,MARRIED,1534941,755493,779448,0,0,0,0,0,1534941,755493,779448,0
KARACHI CENTRAL,DISTRICT,15 &  ABOVE,NEVER MARRIED,851164,334279,516336,549,0,0,0,0,851164,334279,516336,549
KARACHI CENTRAL,DISTRICT,15 &  ABOVE,SEPERATION,5351,2800,2551,0,0,0,0,0,5351,2800,2551,0
KARACHI CENTRAL,DISTRICT,15 &  ABOVE,WIDOWED,103352,78975,24377,0,0,0,0,0,103352,78975,24377,0
KARACHI CENTRAL,DISTRICT,15 - 19,DIVORCED,69,58,11,0,0,0,0,0,69,58,11,0
KARACHI CENTRAL,DISTRICT,15 - 19,MARRIED,14505,10978,3527,0,0,0,0,0,14505,10978,3527,0
KARACHI CENTRAL,DISTRICT,15 - 19,NEVER MARRIED,355528,158482,196980,66,0,0,0,0,355528,158482,196980,66
KARACHI CENTRAL,DISTRICT,15 - 19,SEPERATION,48,26,22,0,0,0,0,0,48,26,22,0
KARACHI CENTRAL,DISTRICT,15 - 19,WIDOWED,54,25,29,0,0,0,0,0,54,25,29,0
KARACHI CENTRAL,DISTRICT,20 - 24,DIVORCED,584,473,111,0,0,0,0,0,584,473,111,0
KARACHI CENTRAL,DISTRICT,20 - 24,MARRIED,87828,64981,22847,0,0,0,0,0,87828,64981,22847,0
KARACHI CENTRAL,DISTRICT,20 - 24,NEVER MARRIED,233545,91344,142136,65,0,0,0,0,233545,91344,142136,65
KARACHI CENTRAL,DISTRICT,20 - 24,SEPERATION,196,133,63,0,0,0,0,0,196,133,63,0
KARACHI CENTRAL,DISTRICT,20 - 24,WIDOWED,298,185,113,0,0,0,0,0,298,185,113,0
KARACHI CENTRAL,DISTRICT,25 - 29,DIVORCED,1278,966,312,0,0,0,0,0,1278,966,312,0
KARACHI CENTRAL,DISTRICT,25 - 29,MARRIED,182782,113049,69733,0,0,0,0,0,182782,113049,69733,0
KARACHI CENTRAL,DISTRICT,25 - 29,NEVER MARRIED,124383,38030,86279,74,0,0,0,0,124383,38030,86279,74
KARACHI CENTRAL,DISTRICT,25 - 29,SEPERATION,445,280,165,0,0,0,0,0,445,280,165,0
KARACHI CENTRAL,DISTRICT,25 - 29,WIDOWED,828,529,299,0,0,0,0,0,828,529,299,0
KARACHI CENTRAL,DISTRICT,30 - 34,DIVORCED,1928,1357,571,0,0,0,0,0,1928,1357,571,0
KARACHI CENTRAL,DISTRICT,30 - 34,MARRIED,219570,117972,101598,0,0,0,0,0,219570,117972,101598,0
KARACHI CENTRAL,DISTRICT,30 - 34,NEVER MARRIED,54190,15733,38387,70,0,0,0,0,54190,15733,38387,70
KARACHI CENTRAL,DISTRICT,30 - 34,SEPERATION,645,360,285,0,0,0,0,0,645,360,285,0
KARACHI CENTRAL,DISTRICT,30 - 34,WIDOWED,1764,1235,529,0,0,0,0,0,1764,1235,529,0
KARACHI CENTRAL,DISTRICT,35 - 39,DIVORCED,2247,1501,746,0,0,0,0,0,2247,1501,746,0
KARACHI CENTRAL,DISTRICT,35 - 39,MARRIED,227797,113057,114740,0,0,0,0,0,227797,113057,114740,0
KARACHI CENTRAL,DISTRICT,35 - 39,NEVER MARRIED,31313,9643,21582,88,0,0,0,0,31313,9643,21582,88
KARACHI CENTRAL,DISTRICT,35 - 39,SEPERATION,821,421,400,0,0,0,0,0,821,421,400,0
KARACHI CENTRAL,DISTRICT,35 - 39,WIDOWED,2808,2006,802,0,0,0,0,0,2808,2006,802,0
KARACHI CENTRAL,DISTRICT,40 - 44,DIVORCED,1996,1249,747,0,0,0,0,0,1996,1249,747,0
KARACHI CENTRAL,DISTRICT,40 - 44,MARRIED,203216,93691,109525,0,0,0,0,0,203216,93691,109525,0
KARACHI CENTRAL,DISTRICT,40 - 44,NEVER MARRIED,18165,6391,11717,57,0,0,0,0,18165,6391,11717,57
KARACHI CENTRAL,DISTRICT,40 - 44,SEPERATION,789,425,364,0,0,0,0,0,789,425,364,0
KARACHI CENTRAL,DISTRICT,40 - 44,WIDOWED,4867,3730,1137,0,0,0,0,0,4867,3730,1137,0
KARACHI CENTRAL,DISTRICT,45 - 49,DIVORCED,1736,1088,648,0,0,0,0,0,1736,1088,648,0
KARACHI CENTRAL,DISTRICT,45 - 49,MARRIED,172667,77661,95006,0,0,0,0,0,172667,77661,95006,0
KARACHI CENTRAL,DISTRICT,45 - 49,NEVER MARRIED,12225,4576,7606,43,0,0,0,0,12225,4576,7606,43
KARACHI CENTRAL,DISTRICT,45 - 49,SEPERATION,735,362,373,0,0,0,0,0,735,362,373,0
KARACHI CENTRAL,DISTRICT,45 - 49,WIDOWED,7066,5491,1575,0,0,0,0,0,7066,5491,1575,0
KARACHI CENTRAL,DISTRICT,50 - 54,DIVORCED,1235,758,477,0,0,0,0,0,1235,758,477,0
KARACHI CENTRAL,DISTRICT,50 - 54,MARRIED,133987,56626,77361,0,0,0,0,0,133987,56626,77361,0
KARACHI CENTRAL,DISTRICT,50 - 54,NEVER MARRIED,7649,3237,4373,39,0,0,0,0,7649,3237,4373,39
KARACHI CENTRAL,DISTRICT,50 - 54,SEPERATION,533,267,266,0,0,0,0,0,533,267,266,0
KARACHI CENTRAL,DISTRICT,50 - 54,WIDOWED,10321,8208,2113,0,0,0,0,0,10321,8208,2113,0
KARACHI CENTRAL,DISTRICT,55 - 59,DIVORCED,912,523,389,0,0,0,0,0,912,523,389,0
KARACHI CENTRAL,DISTRICT,55 - 59,MARRIED,112553,45576,66977,0,0,0,0,0,112553,45576,66977,0
KARACHI CENTRAL,DISTRICT,55 - 59,NEVER MARRIED,6070,2711,3331,28,0,0,0,0,6070,2711,3331,28
KARACHI CENTRAL,DISTRICT,55 - 59,SEPERATION,478,238,240,0,0,0,0,0,478,238,240,0
KARACHI CENTRAL,DISTRICT,55 - 59,WIDOWED,13595,10829,2766,0,0,0,0,0,13595,10829,2766,0
KARACHI CENTRAL,DISTRICT,60 - 64,DIVORCED,561,345,216,0,0,0,0,0,561,345,216,0
KARACHI CENTRAL,DISTRICT,60 - 64,MARRIED,77226,28799,48427,0,0,0,0,0,77226,28799,48427,0
KARACHI CENTRAL,DISTRICT,60 - 64,NEVER MARRIED,3699,1815,1876,8,0,0,0,0,3699,1815,1876,8
KARACHI CENTRAL,DISTRICT,60 - 64,SEPERATION,274,136,138,0,0,0,0,0,274,136,138,0
KARACHI CENTRAL,DISTRICT,60 - 64,WIDOWED,15853,12392,3461,0,0,0,0,0,15853,12392,3461,0
KARACHI CENTRAL,DISTRICT,65 - 69,DIVORCED,332,201,131,0,0,0,0,0,332,201,131,0
KARACHI CENTRAL,DISTRICT,65 - 69,MARRIED,51575,17829,33746,0,0,0,0,0,51575,17829,33746,0
KARACHI CENTRAL,DISTRICT,65 - 69,NEVER MARRIED,2387,1207,1172,8,0,0,0,0,2387,1207,1172,8
KARACHI CENTRAL,DISTRICT,65 - 69,SEPERATION,209,94,115,0,0,0,0,0,209,94,115,0
KARACHI CENTRAL,DISTRICT,65 - 69,WIDOWED,15594,11880,3714,0,0,0,0,0,15594,11880,3714,0
KARACHI CENTRAL,DISTRICT,70 - 74,DIVORCED,168,92,76,0,0,0,0,0,168,92,76,0
KARACHI CENTRAL,DISTRICT,70 - 74,MARRIED,30032,9203,20829,0,0,0,0,0,30032,9203,20829,0
KARACHI CENTRAL,DISTRICT,70 - 74,NEVER MARRIED,1153,625,527,1,0,0,0,0,1153,625,527,1
KARACHI CENTRAL,DISTRICT,70 - 74,SEPERATION,97,36,61,0,0,0,0,0,97,36,61,0
KARACHI CENTRAL,DISTRICT,70 - 74,WIDOWED,14015,10507,3508,0,0,0,0,0,14015,10507,3508,0
KARACHI CENTRAL,DISTRICT,75 & ABOVE,DIVORCED,109,63,46,0,0,0,0,0,109,63,46,0
KARACHI CENTRAL,DISTRICT,75 & ABOVE,MARRIED,21203,6071,15132,0,0,0,0,0,21203,6071,15132,0
KARACHI CENTRAL,DISTRICT,75 & ABOVE,NEVER MARRIED,857,485,370,2,0,0,0,0,857,485,370,2
KARACHI CENTRAL,DISTRICT,75 & ABOVE,SEPERATION,81,22,59,0,0,0,0,0,81,22,59,0
KARACHI CENTRAL,DISTRICT,75 & ABOVE,WIDOWED,16289,11958,4331,0,0,0,0,0,16289,11958,4331,0
KARACHI EAST,DISTRICT,15 &  ABOVE,DIVORCED,10465,7189,3276,0,0,0,0,0,10465,7189,3276,0
KARACHI EAST,DISTRICT,15 &  ABOVE,MARRIED,1589440,778434,811006,0,0,0,0,0,1589440,778434,811006,0
KARACHI EAST,DISTRICT,15 &  ABOVE,NEVER MARRIED,855728,333556,521762,410,0,0,0,0,855728,333556,521762,410
KARACHI EAST,DISTRICT,15 &  ABOVE,SEPERATION,4346,2197,2149,0,0,0,0,0,4346,2197,2149,0
KARACHI EAST,DISTRICT,15 &  ABOVE,WIDOWED,83352,65280,18072,0,0,0,0,0,83352,65280,18072,0
KARACHI EAST,DISTRICT,15 - 19,DIVORCED,57,38,19,0,0,0,0,0,57,38,19,0
KARACHI EAST,DISTRICT,15 - 19,MARRIED,19458,14228,5230,0,0,0,0,0,19458,14228,5230,0
KARACHI EAST,DISTRICT,15 - 19,NEVER MARRIED,380053,162508,217490,55,0,0,0,0,380053,162508,217490,55
KARACHI EAST,DISTRICT,15 - 19,SEPERATION,57,25,32,0,0,0,0,0,57,25,32,0
KARACHI EAST,DISTRICT,15 - 19,WIDOWED,69,34,35,0,0,0,0,0,69,34,35,0
KARACHI EAST,DISTRICT,20 - 24,DIVORCED,484,372,112,0,0,0,0,0,484,372,112,0
KARACHI EAST,DISTRICT,20 - 24,MARRIED,98765,68475,30290,0,0,0,0,0,98765,68475,30290,0
KARACHI EAST,DISTRICT,20 - 24,NEVER MARRIED,236044,90776,145192,76,0,0,0,0,236044,90776,145192,76
KARACHI EAST,DISTRICT,20 - 24,SEPERATION,169,107,62,0,0,0,0,0,169,107,62,0
KARACHI EAST,DISTRICT,20 - 24,WIDOWED,250,181,69,0,0,0,0,0,250,181,69,0
KARACHI EAST,DISTRICT,25 - 29,DIVORCED,1010,761,249,0,0,0,0,0,1010,761,249,0
KARACHI EAST,DISTRICT,25 - 29,MARRIED,190304,112358,77946,0,0,0,0,0,190304,112358,77946,0
KARACHI EAST,DISTRICT,25 - 29,NEVER MARRIED,123928,39185,84661,82,0,0,0,0,123928,39185,84661,82
KARACHI EAST,DISTRICT,25 - 29,SEPERATION,418,195,223,0,0,0,0,0,418,195,223,0
KARACHI EAST,DISTRICT,25 - 29,WIDOWED,674,440,234,0,0,0,0,0,674,440,234,0
KARACHI EAST,DISTRICT,30 - 34,DIVORCED,1568,1097,471,0,0,0,0,0,1568,1097,471,0
KARACHI EAST,DISTRICT,30 - 34,MARRIED,224403,117739,106664,0,0,0,0,0,224403,117739,106664,0
KARACHI EAST,DISTRICT,30 - 34,NEVER MARRIED,49567,15340,34162,65,0,0,0,0,49567,15340,34162,65
KARACHI EAST,DISTRICT,30 - 34,SEPERATION,570,292,278,0,0,0,0,0,570,292,278,0
KARACHI EAST,DISTRICT,30 - 34,WIDOWED,1289,937,352,0,0,0,0,0,1289,937,352,0
KARACHI EAST,DISTRICT,35 - 39,DIVORCED,1748,1189,559,0,0,0,0,0,1748,1189,559,0
KARACHI EAST,DISTRICT,35 - 39,MARRIED,229134,113359,115775,0,0,0,0,0,229134,113359,115775,0
KARACHI EAST,DISTRICT,35 - 39,NEVER MARRIED,25995,8674,17280,41,0,0,0,0,25995,8674,17280,41
KARACHI EAST,DISTRICT,35 - 39,SEPERATION,653,323,330,0,0,0,0,0,653,323,330,0
KARACHI EAST,DISTRICT,35 - 39,WIDOWED,2299,1768,531,0,0,0,0,0,2299,1768,531,0
KARACHI EAST,DISTRICT,40 - 44,DIVORCED,1721,1150,571,0,0,0,0,0,1721,1150,571,0
KARACHI EAST,DISTRICT,40 - 44,MARRIED,205925,95774,110151,0,0,0,0,0,205925,95774,110151,0
KARACHI EAST,DISTRICT,40 - 44,NEVER MARRIED,14257,5309,8912,36,0,0,0,0,14257,5309,8912,36
KARACHI EAST,DISTRICT,40 - 44,SEPERATION,641,339,302,0,0,0,0,0,641,339,302,0
KARACHI EAST,DISTRICT,40 - 44,WIDOWED,3788,3002,786,0,0,0,0,0,3788,3002,786,0
KARACHI EAST,DISTRICT,45 - 49,DIVORCED,1384,898,486,0,0,0,0,0,1384,898,486,0
KARACHI EAST,DISTRICT,45 - 49,MARRIED,173244,78122,95122,0,0,0,0,0,173244,78122,95122,0
KARACHI EAST,DISTRICT,45 - 49,NEVER MARRIED,9110,3656,5432,22,0,0,0,0,9110,3656,5432,22
KARACHI EAST,DISTRICT,45 - 49,SEPERATION,563,272,291,0,0,0,0,0,563,272,291,0
KARACHI EAST,DISTRICT,45 - 49,WIDOWED,5445,4408,1037,0,0,0,0,0,5445,4408,1037,0
KARACHI EAST,DISTRICT,50 - 54,DIVORCED,905,638,267,0,0,0,0,0,905,638,267,0
KARACHI EAST,DISTRICT,50 - 54,MARRIED,135244,58697,76547,0,0,0,0,0,135244,58697,76547,0
KARACHI EAST,DISTRICT,50 - 54,NEVER MARRIED,5633,2484,3128,21,0,0,0,0,5633,2484,3128,21
KARACHI EAST,DISTRICT,50 - 54,SEPERATION,415,217,198,0,0,0,0,0,415,217,198,0
KARACHI EAST,DISTRICT,50 - 54,WIDOWED,7904,6414,1490,0,0,0,0,0,7904,6414,1490,0
KARACHI EAST,DISTRICT,55 - 59,DIVORCED,687,450,237,0,0,0,0,0,687,450,237,0
KARACHI EAST,DISTRICT,55 - 59,MARRIED,112345,47568,64777,0,0,0,0,0,112345,47568,64777,0
KARACHI EAST,DISTRICT,55 - 59,NEVER MARRIED,4236,1958,2274,4,0,0,0,0,4236,1958,2274,4
KARACHI EAST,DISTRICT,55 - 59,SEPERATION,366,186,180,0,0,0,0,0,366,186,180,0
KARACHI EAST,DISTRICT,55 - 59,WIDOWED,10249,8260,1989,0,0,0,0,0,10249,8260,1989,0
KARACHI EAST,DISTRICT,60 - 64,DIVORCED,404,273,131,0,0,0,0,0,404,273,131,0
KARACHI EAST,DISTRICT,60 - 64,MARRIED,82053,32191,49862,0,0,0,0,0,82053,32191,49862,0
KARACHI EAST,DISTRICT,60 - 64,NEVER MARRIED,2801,1452,1345,4,0,0,0,0,2801,1452,1345,4
KARACHI EAST,DISTRICT,60 - 64,SEPERATION,216,107,109,0,0,0,0,0,216,107,109,0
KARACHI EAST,DISTRICT,60 - 64,WIDOWED,12344,9961,2383,0,0,0,0,0,12344,9961,2383,0
KARACHI EAST,DISTRICT,65 - 69,DIVORCED,255,173,82,0,0,0,0,0,255,173,82,0
KARACHI EAST,DISTRICT,65 - 69,MARRIED,56244,20565,35679,0,0,0,0,0,56244,20565,35679,0
KARACHI EAST,DISTRICT,65 - 69,NEVER MARRIED,1959,1082,874,3,0,0,0,0,1959,1082,874,3
KARACHI EAST,DISTRICT,65 - 69,SEPERATION,153,76,77,0,0,0,0,0,153,76,77,0
KARACHI EAST,DISTRICT,65 - 69,WIDOWED,12317,9720,2597,0,0,0,0,0,12317,9720,2597,0
KARACHI EAST,DISTRICT,70 - 74,DIVORCED,144,98,46,0,0,0,0,0,144,98,46,0
KARACHI EAST,DISTRICT,70 - 74,MARRIED,35347,11498,23849,0,0,0,0,0,35347,11498,23849,0
KARACHI EAST,DISTRICT,70 - 74,NEVER MARRIED,1087,608,478,1,0,0,0,0,1087,608,478,1
KARACHI EAST,DISTRICT,70 - 74,SEPERATION,76,34,42,0,0,0,0,0,76,34,42,0
KARACHI EAST,DISTRICT,70 - 74,WIDOWED,11635,8978,2657,0,0,0,0,0,11635,8978,2657,0
KARACHI EAST,DISTRICT,75 & ABOVE,DIVORCED,98,52,46,0,0,0,0,0,98,52,46,0
KARACHI EAST,DISTRICT,75 & ABOVE,MARRIED,26974,7860,19114,0,0,0,0,0,26974,7860,19114,0
KARACHI EAST,DISTRICT,75 & ABOVE,NEVER MARRIED,1058,524,534,0,0,0,0,0,1058,524,534,0
KARACHI EAST,DISTRICT,75 & ABOVE,SEPERATION,49,24,25,0,0,0,0,0,49,24,25,0
KARACHI EAST,DISTRICT,75 & ABOVE,WIDOWED,15089,11177,3912,0,0,0,0,0,15089,11177,3912,0
KARACHI SOUTH,DISTRICT,15 &  ABOVE,DIVORCED,9027,5923,3104,0,0,0,0,0,9027,5923,3104,0
KARACHI SOUTH,DISTRICT,15 &  ABOVE,MARRIED,986692,474415,512277,0,0,0,0,0,986692,474415,512277,0
KARACHI SOUTH,DISTRICT,15 &  ABOVE,NEVER MARRIED,529516,207409,321725,382,0,0,0,0,529516,207409,321725,382
KARACHI SOUTH,DISTRICT,15 &  ABOVE,SEPERATION,2839,1427,1412,0,0,0,0,0,2839,1427,1412,0
KARACHI SOUTH,DISTRICT,15 &  ABOVE,WIDOWED,61410,46660,14750,0,0,0,0,0,61410,46660,14750,0
KARACHI SOUTH,DISTRICT,15 - 19,DIVORCED,82,76,6,0,0,0,0,0,82,76,6,0
KARACHI SOUTH,DISTRICT,15 - 19,MARRIED,9744,7493,2251,0,0,0,0,0,9744,7493,2251,0
KARACHI SOUTH,DISTRICT,15 - 19,NEVER MARRIED,222216,98867,123324,25,0,0,0,0,222216,98867,123324,25
KARACHI SOUTH,DISTRICT,15 - 19,SEPERATION,31,17,14,0,0,0,0,0,31,17,14,0
KARACHI SOUTH,DISTRICT,15 - 19,WIDOWED,41,25,16,0,0,0,0,0,41,25,16,0
KARACHI SOUTH,DISTRICT,20 - 24,DIVORCED,482,400,82,0,0,0,0,0,482,400,82,0
KARACHI SOUTH,DISTRICT,20 - 24,MARRIED,55111,39496,15615,0,0,0,0,0,55111,39496,15615,0
KARACHI SOUTH,DISTRICT,20 - 24,NEVER MARRIED,144513,54606,89863,44,0,0,0,0,144513,54606,89863,44
KARACHI SOUTH,DISTRICT,20 - 24,SEPERATION,101,59,42,0,0,0,0,0,101,59,42,0
KARACHI SOUTH,DISTRICT,20 - 24,WIDOWED,179,129,50,0,0,0,0,0,179,129,50,0
KARACHI SOUTH,DISTRICT,25 - 29,DIVORCED,996,729,267,0,0,0,0,0,996,729,267,0
KARACHI SOUTH,DISTRICT,25 - 29,MARRIED,109247,64784,44463,0,0,0,0,0,109247,64784,44463,0
KARACHI SOUTH,DISTRICT,25 - 29,NEVER MARRIED,75081,23657,51360,64,0,0,0,0,75081,23657,51360,64
KARACHI SOUTH,DISTRICT,25 - 29,SEPERATION,235,146,89,0,0,0,0,0,235,146,89,0
KARACHI SOUTH,DISTRICT,25 - 29,WIDOWED,553,404,149,0,0,0,0,0,553,404,149,0
KARACHI SOUTH,DISTRICT,30 - 34,DIVORCED,1323,879,444,0,0,0,0,0,1323,879,444,0
KARACHI SOUTH,DISTRICT,30 - 34,MARRIED,134822,71193,63629,0,0,0,0,0,134822,71193,63629,0
KARACHI SOUTH,DISTRICT,30 - 34,NEVER MARRIED,34334,10565,23697,72,0,0,0,0,34334,10565,23697,72
KARACHI SOUTH,DISTRICT,30 - 34,SEPERATION,319,174,145,0,0,0,0,0,319,174,145,0
KARACHI SOUTH,DISTRICT,30 - 34,WIDOWED,1102,793,309,0,0,0,0,0,1102,793,309,0
KARACHI SOUTH,DISTRICT,35 - 39,DIVORCED,1482,969,513,0,0,0,0,0,1482,969,513,0
KARACHI SOUTH,DISTRICT,35 - 39,MARRIED,144715,70913,73802,0,0,0,0,0,144715,70913,73802,0
KARACHI SOUTH,DISTRICT,35 - 39,NEVER MARRIED,19995,6554,13377,64,0,0,0,0,19995,6554,13377,64
KARACHI SOUTH,DISTRICT,35 - 39,SEPERATION,372,211,161,0,0,0,0,0,372,211,161,0
KARACHI SOUTH,DISTRICT,35 - 39,WIDOWED,1787,1338,449,0,0,0,0,0,1787,1338,449,0
KARACHI SOUTH,DISTRICT,40 - 44,DIVORCED,1429,921,508,0,0,0,0,0,1429,921,508,0
KARACHI SOUTH,DISTRICT,40 - 44,MARRIED,134934,62044,72890,0,0,0,0,0,134934,62044,72890,0
KARACHI SOUTH,DISTRICT,40 - 44,NEVER MARRIED,11739,4217,7484,38,0,0,0,0,11739,4217,7484,38
KARACHI SOUTH,DISTRICT,40 - 44,SEPERATION,421,217,204,0,0,0,0,0,421,217,204,0
KARACHI SOUTH,DISTRICT,40 - 44,WIDOWED,2896,2279,617,0,0,0,0,0,2896,2279,617,0
KARACHI SOUTH,DISTRICT,45 - 49,DIVORCED,1082,672,410,0,0,0,0,0,1082,672,410,0
KARACHI SOUTH,DISTRICT,45 - 49,MARRIED,114192,50483,63709,0,0,0,0,0,114192,50483,63709,0
KARACHI SOUTH,DISTRICT,45 - 49,NEVER MARRIED,7890,2879,4984,27,0,0,0,0,7890,2879,4984,27
KARACHI SOUTH,DISTRICT,45 - 49,SEPERATION,389,192,197,0,0,0,0,0,389,192,197,0
KARACHI SOUTH,DISTRICT,45 - 49,WIDOWED,4121,3263,858,0,0,0,0,0,4121,3263,858,0
KARACHI SOUTH,DISTRICT,50 - 54,DIVORCED,765,484,281,0,0,0,0,0,765,484,281,0
KARACHI SOUTH,DISTRICT,50 - 54,MARRIED,87854,36146,51708,0,0,0,0,0,87854,36146,51708,0
KARACHI SOUTH,DISTRICT,50 - 54,NEVER MARRIED,4760,1936,2802,22,0,0,0,0,4760,1936,2802,22
KARACHI SOUTH,DISTRICT,50 - 54,SEPERATION,270,118,152,0,0,0,0,0,270,118,152,0
KARACHI SOUTH,DISTRICT,50 - 54,WIDOWED,5964,4723,1241,0,0,0,0,0,5964,4723,1241,0
KARACHI SOUTH,DISTRICT,55 - 59,DIVORCED,571,317,254,0,0,0,0,0,571,317,254,0
KARACHI SOUTH,DISTRICT,55 - 59,MARRIED,72936,28975,43961,0,0,0,0,0,72936,28975,43961,0
KARACHI SOUTH,DISTRICT,55 - 59,NEVER MARRIED,3597,1516,2074,7,0,0,0,0,3597,1516,2074,7
KARACHI SOUTH,DISTRICT,55 - 59,SEPERATION,245,106,139,0,0,0,0,0,245,106,139,0
KARACHI SOUTH,DISTRICT,55 - 59,WIDOWED,7870,6091,1779,0,0,0,0,0,7870,6091,1779,0
KARACHI SOUTH,DISTRICT,60 - 64,DIVORCED,379,223,156,0,0,0,0,0,379,223,156,0
KARACHI SOUTH,DISTRICT,60 - 64,MARRIED,49640,18587,31053,0,0,0,0,0,49640,18587,31053,0
KARACHI SOUTH,DISTRICT,60 - 64,NEVER MARRIED,2272,1031,1236,5,0,0,0,0,2272,1031,1236,5
KARACHI SOUTH,DISTRICT,60 - 64,SEPERATION,177,72,105,0,0,0,0,0,177,72,105,0
KARACHI SOUTH,DISTRICT,60 - 64,WIDOWED,8800,6874,1926,0,0,0,0,0,8800,6874,1926,0
KARACHI SOUTH,DISTRICT,65 - 69,DIVORCED,217,138,79,0,0,0,0,0,217,138,79,0
KARACHI SOUTH,DISTRICT,65 - 69,MARRIED,35369,12437,22932,0,0,0,0,0,35369,12437,22932,0
KARACHI SOUTH,DISTRICT,65 - 69,NEVER MARRIED,1629,811,816,2,0,0,0,0,1629,811,816,2
KARACHI SOUTH,DISTRICT,65 - 69,SEPERATION,152,63,89,0,0,0,0,0,152,63,89,0
KARACHI SOUTH,DISTRICT,65 - 69,WIDOWED,9245,6926,2319,0,0,0,0,0,9245,6926,2319,0
KARACHI SOUTH,DISTRICT,70 - 74,DIVORCED,128,70,58,0,0,0,0,0,128,70,58,0
KARACHI SOUTH,DISTRICT,70 - 74,MARRIED,21582,6851,14731,0,0,0,0,0,21582,6851,14731,0
KARACHI SOUTH,DISTRICT,70 - 74,NEVER MARRIED,821,422,393,6,0,0,0,0,821,422,393,6
KARACHI SOUTH,DISTRICT,70 - 74,SEPERATION,76,23,53,0,0,0,0,0,76,23,53,0
KARACHI SOUTH,DISTRICT,70 - 74,WIDOWED,8451,6240,2211,0,0,0,0,0,8451,6240,2211,0
KARACHI SOUTH,DISTRICT,75 & ABOVE,DIVORCED,91,45,46,0,0,0,0,0,91,45,46,0
KARACHI SOUTH,DISTRICT,75 & ABOVE,MARRIED,16546,5013,11533,0,0,0,0,0,16546,5013,11533,0
KARACHI SOUTH,DISTRICT,75 & ABOVE,NEVER MARRIED,669,348,315,6,0,0,0,0,669,348,315,6
KARACHI SOUTH,DISTRICT,75 & ABOVE,SEPERATION,51,29,22,0,0,0,0,0,51,29,22,0
KARACHI SOUTH,DISTRICT,75 & ABOVE,WIDOWED,10401,7575,2826,0,0,0,0,0,10401,7575,2826,0
KARACHI WEST,DISTRICT,15 &  ABOVE,DIVORCED,7482,4514,2968,0,489,306,183,0,6993,4208,2785,0
KARACHI WEST,DISTRICT,15 &  ABOVE,MARRIED,1091471,542543,548928,0,104043,51242,52801,0,987428,491301,496127,0
KARACHI WEST,DISTRICT,15 &  ABOVE,NEVER MARRIED,528448,197143,331113,192,45939,16915,29018,6,482509,180228,302095,186
KARACHI WEST,DISTRICT,15 &  ABOVE,SEPERATION,3006,1473,1533,0,249,102,147,0,2757,1371,1386,0
KARACHI WEST,DISTRICT,15 &  ABOVE,WIDOWED,58073,43417,14656,0,3881,2913,968,0,54192,40504,13688,0
KARACHI WEST,DISTRICT,15 - 19,DIVORCED,86,75,11,0,9,7,2,0,77,68,9,0
KARACHI WEST,DISTRICT,15 - 19,MARRIED,19050,14993,4057,0,2468,1906,562,0,16582,13087,3495,0
KARACHI WEST,DISTRICT,15 - 19,NEVER MARRIED,253316,112589,140708,19,24883,10695,14185,3,228433,101894,126523,16
KARACHI WEST,DISTRICT,15 - 19,SEPERATION,72,37,35,0,9,6,3,0,63,31,32,0
KARACHI WEST,DISTRICT,15 - 19,WIDOWED,44,32,12,0,8,4,4,0,36,28,8,0
KARACHI WEST,DISTRICT,20 - 24,DIVORCED,580,489,91,0,52,41,11,0,528,448,80,0
KARACHI WEST,DISTRICT,20 - 24,MARRIED,86947,61607,25340,0,9360,6194,3166,0,77587,55413,22174,0
KARACHI WEST,DISTRICT,20 - 24,NEVER MARRIED,150146,53299,96824,23,12322,4034,8288,0,137824,49265,88536,23
KARACHI WEST,DISTRICT,20 - 24,SEPERATION,180,117,63,0,19,12,7,0,161,105,56,0
KARACHI WEST,DISTRICT,20 - 24,WIDOWED,233,159,74,0,26,18,8,0,207,141,66,0
KARACHI WEST,DISTRICT,25 - 29,DIVORCED,1082,753,329,0,85,64,21,0,997,689,308,0
KARACHI WEST,DISTRICT,25 - 29,MARRIED,145634,87270,58364,0,14271,8046,6225,0,131363,79224,52139,0
KARACHI WEST,DISTRICT,25 - 29,NEVER MARRIED,68983,17915,51044,24,5065,1258,3807,0,63918,16657,47237,24
KARACHI WEST,DISTRICT,25 - 29,SEPERATION,319,163,156,0,28,12,16,0,291,151,140,0
KARACHI WEST,DISTRICT,25 - 29,WIDOWED,612,415,197,0,48,29,19,0,564,386,178,0
KARACHI WEST,DISTRICT,30 - 34,DIVORCED,1323,825,498,0,77,47,30,0,1246,778,468,0
KARACHI WEST,DISTRICT,30 - 34,MARRIED,163372,86446,76926,0,14659,7808,6851,0,148713,78638,70075,0
KARACHI WEST,DISTRICT,30 - 34,NEVER MARRIED,27151,6211,20921,19,1791,447,1343,1,25360,5764,19578,18
KARACHI WEST,DISTRICT,30 - 34,SEPERATION,385,183,202,0,28,15,13,0,357,168,189,0
KARACHI WEST,DISTRICT,30 - 34,WIDOWED,1093,719,374,0,87,56,31,0,1006,663,343,0
KARACHI WEST,DISTRICT,35 - 39,DIVORCED,1264,707,557,0,64,38,26,0,1200,669,531,0
KARACHI WEST,DISTRICT,35 - 39,MARRIED,159611,78839,80772,0,15222,7711,7511,0,144389,71128,73261,0
KARACHI WEST,DISTRICT,35 - 39,NEVER MARRIED,12955,3021,9905,29,903,212,690,1,12052,2809,9215,28
KARACHI WEST,DISTRICT,35 - 39,SEPERATION,429,203,226,0,35,9,26,0,394,194,200,0
KARACHI WEST,DISTRICT,35 - 39,WIDOWED,1834,1345,489,0,134,98,36,0,1700,1247,453,0
KARACHI WEST,DISTRICT,40 - 44,DIVORCED,1154,663,491,0,60,41,19,0,1094,622,472,0
KARACHI WEST,DISTRICT,40 - 44,MARRIED,147351,66783,80568,0,13832,6210,7622,0,133519,60573,72946,0
KARACHI WEST,DISTRICT,40 - 44,NEVER MARRIED,7161,1791,5336,34,441,115,325,1,6720,1676,5011,33
KARACHI WEST,DISTRICT,40 - 44,SEPERATION,437,228,209,0,28,6,22,0,409,222,187,0
KARACHI WEST,DISTRICT,40 - 44,WIDOWED,3234,2494,740,0,272,195,77,0,2962,2299,663,0
KARACHI WEST,DISTRICT,45 - 49,DIVORCED,787,430,357,0,46,26,20,0,741,404,337,0
KARACHI WEST,DISTRICT,45 - 49,MARRIED,116340,51417,64923,0,11293,4905,6388,0,105047,46512,58535,0
KARACHI WEST,DISTRICT,45 - 49,NEVER MARRIED,4028,1031,2980,17,248,67,181,0,3780,964,2799,17
KARACHI WEST,DISTRICT,45 - 49,SEPERATION,366,186,180,0,26,12,14,0,340,174,166,0
KARACHI WEST,DISTRICT,45 - 49,WIDOWED,4441,3551,890,0,298,245,53,0,4143,3306,837,0
KARACHI WEST,DISTRICT,50 - 54,DIVORCED,483,264,219,0,28,13,15,0,455,251,204,0
KARACHI WEST,DISTRICT,50 - 54,MARRIED,87563,36365,51198,0,7999,3324,4675,0,79564,33041,46523,0
KARACHI WEST,DISTRICT,50 - 54,NEVER MARRIED,2036,529,1494,13,113,33,80,0,1923,496,1414,13
KARACHI WEST,DISTRICT,50 - 54,SEPERATION,278,136,142,0,25,10,15,0,253,126,127,0
KARACHI WEST,DISTRICT,50 - 54,WIDOWED,6591,5186,1405,0,456,357,99,0,6135,4829,1306,0
KARACHI WEST,DISTRICT,55 - 59,DIVORCED,337,156,181,0,25,14,11,0,312,142,170,0
KARACHI WEST,DISTRICT,55 - 59,MARRIED,67154,26336,40818,0,5989,2320,3669,0,61165,24016,37149,0
KARACHI WEST,DISTRICT,55 - 59,NEVER MARRIED,1302,363,932,7,76,21,55,0,1226,342,877,7
KARACHI WEST,DISTRICT,55 - 59,SEPERATION,222,89,133,0,18,4,14,0,204,85,119,0
KARACHI WEST,DISTRICT,55 - 59,WIDOWED,8009,6189,1820,0,480,376,104,0,7529,5813,1716,0
KARACHI WEST,DISTRICT,60 - 64,DIVORCED,187,74,113,0,11,6,5,0,176,68,108,0
KARACHI WEST,DISTRICT,60 - 64,MARRIED,43193,15620,27573,0,3821,1330,2491,0,39372,14290,25082,0
KARACHI WEST,DISTRICT,60 - 64,NEVER MARRIED,641,197,441,3,41,13,28,0,600,184,413,3
KARACHI WEST,DISTRICT,60 - 64,SEPERATION,129,53,76,0,9,5,4,0,120,48,72,0
KARACHI WEST,DISTRICT,60 - 64,WIDOWED,8982,6826,2156,0,595,466,129,0,8387,6360,2027,0
KARACHI WEST,DISTRICT,65 - 69,DIVORCED,126,44,82,0,19,7,12,0,107,37,70,0
KARACHI WEST,DISTRICT,65 - 69,MARRIED,28172,9354,18818,0,2544,828,1716,0,25628,8526,17102,0
KARACHI WEST,DISTRICT,65 - 69,NEVER MARRIED,372,96,274,2,23,8,15,0,349,88,259,2
KARACHI WEST,DISTRICT,65 - 69,SEPERATION,104,45,59,0,12,6,6,0,92,39,53,0
KARACHI WEST,DISTRICT,65 - 69,WIDOWED,8373,6190,2183,0,517,387,130,0,7856,5803,2053,0
KARACHI WEST,DISTRICT,70 - 74,DIVORCED,49,25,24,0,9,2,7,0,40,23,17,0
KARACHI WEST,DISTRICT,70 - 74,MARRIED,16257,4632,11625,0,1531,416,1115,0,14726,4216,10510,0
KARACHI WEST,DISTRICT,70 - 74,NEVER MARRIED,217,57,159,1,16,4,12,0,201,53,147,1
KARACHI WEST,DISTRICT,70 - 74,SEPERATION,54,20,34,0,7,2,5,0,47,18,29,0
KARACHI WEST,DISTRICT,70 - 74,WIDOWED,7121,5139,1982,0,477,347,130,0,6644,4792,1852,0
KARACHI WEST,DISTRICT,75 & ABOVE,DIVORCED,24,9,15,0,4,0,4,0,20,9,11,0
KARACHI WEST,DISTRICT,75 & ABOVE,MARRIED,10827,2881,7946,0,1054,244,810,0,9773,2637,7136,0
KARACHI WEST,DISTRICT,75 & ABOVE,NEVER MARRIED,140,44,95,1,17,8,9,0,123,36,86,1
KARACHI WEST,DISTRICT,75 & ABOVE,SEPERATION,31,13,18,0,5,3,2,0,26,10,16,0
KARACHI WEST,DISTRICT,75 & ABOVE,WIDOWED,7506,5172,2334,0,483,335,148,0,7023,4837,2186,0
KASHMORE,DISTRICT,15 &  ABOVE,DIVORCED,313,237,76,0,167,129,38,0,146,108,38,0
KASHMORE,DISTRICT,15 &  ABOVE,MARRIED,450362,228455,221907,0,352022,179533,172489,0,98340,48922,49418,0
KASHMORE,DISTRICT,15 &  ABOVE,NEVER MARRIED,124647,49387,75215,45,85403,31769,53613,21,39244,17618,21602,24
KASHMORE,DISTRICT,15 &  ABOVE,SEPERATION,310,148,162,0,202,93,109,0,108,55,53,0
KASHMORE,DISTRICT,15 &  ABOVE,WIDOWED,13544,11258,2286,0,8679,7179,1500,0,4865,4079,786,0
KASHMORE,DISTRICT,15 - 19,DIVORCED,13,9,4,0,8,6,2,0,5,3,2,0
KASHMORE,DISTRICT,15 - 19,MARRIED,31838,19723,12115,0,26715,16303,10412,0,5123,3420,1703,0
KASHMORE,DISTRICT,15 - 19,NEVER MARRIED,86598,37229,49360,9,62668,25569,37090,9,23930,11660,12270,0
KASHMORE,DISTRICT,15 - 19,SEPERATION,38,14,24,0,32,10,22,0,6,4,2,0
KASHMORE,DISTRICT,15 - 19,WIDOWED,59,25,34,0,53,23,30,0,6,2,4,0
KASHMORE,DISTRICT,20 - 24,DIVORCED,36,25,11,0,18,11,7,0,18,14,4,0
KASHMORE,DISTRICT,20 - 24,MARRIED,65805,38020,27785,0,53232,30538,22694,0,12573,7482,5091,0
KASHMORE,DISTRICT,20 - 24,NEVER MARRIED,24580,7460,17114,6,15143,3843,11297,3,9437,3617,5817,3
KASHMORE,DISTRICT,20 - 24,SEPERATION,28,13,15,0,18,8,10,0,10,5,5,0
KASHMORE,DISTRICT,20 - 24,WIDOWED,146,89,57,0,108,61,47,0,38,28,10,0
KASHMORE,DISTRICT,25 - 29,DIVORCED,44,34,10,0,28,21,7,0,16,13,3,0
KASHMORE,DISTRICT,25 - 29,MARRIED,63346,33071,30275,0,49775,26045,23730,0,13571,7026,6545,0
KASHMORE,DISTRICT,25 - 29,NEVER MARRIED,8142,2962,5172,8,4540,1457,3082,1,3602,1505,2090,7
KASHMORE,DISTRICT,25 - 29,SEPERATION,31,13,18,0,17,6,11,0,14,7,7,0
KASHMORE,DISTRICT,25 - 29,WIDOWED,209,127,82,0,156,91,65,0,53,36,17,0
KASHMORE,DISTRICT,30 - 34,DIVORCED,48,37,11,0,23,17,6,0,25,20,5,0
KASHMORE,DISTRICT,30 - 34,MARRIED,58156,30237,27919,0,44355,23282,21073,0,13801,6955,6846,0
KASHMORE,DISTRICT,30 - 34,NEVER MARRIED,2741,1020,1713,8,1508,490,1015,3,1233,530,698,5
KASHMORE,DISTRICT,30 - 34,SEPERATION,32,12,20,0,19,6,13,0,13,6,7,0
KASHMORE,DISTRICT,30 - 34,WIDOWED,311,218,93,0,197,135,62,0,114,83,31,0
KASHMORE,DISTRICT,35 - 39,DIVORCED,39,32,7,0,16,15,1,0,23,17,6,0
KASHMORE,DISTRICT,35 - 39,MARRIED,55502,27600,27902,0,42268,21102,21166,0,13234,6498,6736,0
KASHMORE,DISTRICT,35 - 39,NEVER MARRIED,1282,353,925,4,753,198,555,0,529,155,370,4
KASHMORE,DISTRICT,35 - 39,SEPERATION,23,13,10,0,11,5,6,0,12,8,4,0
KASHMORE,DISTRICT,35 - 39,WIDOWED,459,349,110,0,287,211,76,0,172,138,34,0
KASHMORE,DISTRICT,40 - 44,DIVORCED,40,26,14,0,19,14,5,0,21,12,9,0
KASHMORE,DISTRICT,40 - 44,MARRIED,50555,24377,26178,0,38875,18920,19955,0,11680,5457,6223,0
KASHMORE,DISTRICT,40 - 44,NEVER MARRIED,556,149,403,4,313,80,232,1,243,69,171,3
KASHMORE,DISTRICT,40 - 44,SEPERATION,21,17,4,0,13,11,2,0,8,6,2,0
KASHMORE,DISTRICT,40 - 44,WIDOWED,770,624,146,0,511,411,100,0,259,213,46,0
KASHMORE,DISTRICT,45 - 49,DIVORCED,27,23,4,0,12,12,0,0,15,11,4,0
KASHMORE,DISTRICT,45 - 49,MARRIED,35665,16937,18728,0,27336,13093,14243,0,8329,3844,4485,0
KASHMORE,DISTRICT,45 - 49,NEVER MARRIED,294,81,212,1,161,40,121,0,133,41,91,1
KASHMORE,DISTRICT,45 - 49,SEPERATION,23,10,13,0,13,6,7,0,10,4,6,0
KASHMORE,DISTRICT,45 - 49,WIDOWED,974,800,174,0,601,480,121,0,373,320,53,0
KASHMORE,DISTRICT,50 - 54,DIVORCED,19,17,2,0,11,9,2,0,8,8,0,0
KASHMORE,DISTRICT,50 - 54,MARRIED,29816,14344,15472,0,22701,11111,11590,0,7115,3233,3882,0
KASHMORE,DISTRICT,50 - 54,NEVER MARRIED,180,47,130,3,130,30,98,2,50,17,32,1
KASHMORE,DISTRICT,50 - 54,SEPERATION,23,18,5,0,14,11,3,0,9,7,2,0
KASHMORE,DISTRICT,50 - 54,WIDOWED,1552,1329,223,0,959,805,154,0,593,524,69,0
KASHMORE,DISTRICT,55 - 59,DIVORCED,21,16,5,0,12,11,1,0,9,5,4,0
KASHMORE,DISTRICT,55 - 59,MARRIED,21671,9266,12405,0,16300,7099,9201,0,5371,2167,3204,0
KASHMORE,DISTRICT,55 - 59,NEVER MARRIED,94,28,66,0,63,19,44,0,31,9,22,0
KASHMORE,DISTRICT,55 - 59,SEPERATION,21,11,10,0,16,9,7,0,5,2,3,0
KASHMORE,DISTRICT,55 - 59,WIDOWED,1433,1184,249,0,854,710,144,0,579,474,105,0
KASHMORE,DISTRICT,60 - 64,DIVORCED,10,7,3,0,6,3,3,0,4,4,0,0
KASHMORE,DISTRICT,60 - 64,MARRIED,15598,6661,8937,0,12293,5327,6966,0,3305,1334,1971,0
KASHMORE,DISTRICT,60 - 64,NEVER MARRIED,82,24,57,1,50,16,33,1,32,8,24,0
KASHMORE,DISTRICT,60 - 64,SEPERATION,29,15,14,0,20,11,9,0,9,4,5,0
KASHMORE,DISTRICT,60 - 64,WIDOWED,1919,1665,254,0,1213,1050,163,0,706,615,91,0
KASHMORE,DISTRICT,65 - 69,DIVORCED,8,4,4,0,6,3,3,0,2,1,1,0
KASHMORE,DISTRICT,65 - 69,MARRIED,9687,3852,5835,0,7598,3044,4554,0,2089,808,1281,0
KASHMORE,DISTRICT,65 - 69,NEVER MARRIED,48,18,30,0,35,15,20,0,13,3,10,0
KASHMORE,DISTRICT,65 - 69,SEPERATION,10,4,6,0,6,3,3,0,4,1,3,0
KASHMORE,DISTRICT,65 - 69,WIDOWED,1701,1445,256,0,990,854,136,0,711,591,120,0
KASHMORE,DISTRICT,70 - 74,DIVORCED,2,2,0,0,2,2,0,0,0,0,0,0
KASHMORE,DISTRICT,70 - 74,MARRIED,6980,2571,4409,0,5716,2146,3570,0,1264,425,839,0
KASHMORE,DISTRICT,70 - 74,NEVER MARRIED,24,11,13,0,19,8,11,0,5,3,2,0
KASHMORE,DISTRICT,70 - 74,SEPERATION,11,5,6,0,9,4,5,0,2,1,1,0
KASHMORE,DISTRICT,70 - 74,WIDOWED,1796,1535,261,0,1181,1016,165,0,615,519,96,0
KASHMORE,DISTRICT,75 & ABOVE,DIVORCED,6,5,1,0,6,5,1,0,0,0,0,0
KASHMORE,DISTRICT,75 & ABOVE,MARRIED,5743,1796,3947,0,4858,1523,3335,0,885,273,612,0
KASHMORE,DISTRICT,75 & ABOVE,NEVER MARRIED,26,5,20,1,20,4,15,1,6,1,5,0
KASHMORE,DISTRICT,75 & ABOVE,SEPERATION,20,3,17,0,14,3,11,0,6,0,6,0
KASHMORE,DISTRICT,75 & ABOVE,WIDOWED,2215,1868,347,0,1569,1332,237,0,646,536,110,0
KEAMARI,DISTRICT,15 &  ABOVE,DIVORCED,4824,3125,1699,0,0,0,0,0,4824,3125,1699,0
KEAMARI,DISTRICT,15 &  ABOVE,MARRIED,807956,394031,413925,0,0,0,0,0,807956,394031,413925,0
KEAMARI,DISTRICT,15 &  ABOVE,NEVER MARRIED,418893,159448,259243,202,0,0,0,0,418893,159448,259243,202
KEAMARI,DISTRICT,15 &  ABOVE,SEPERATION,1868,1000,868,0,0,0,0,0,1868,1000,868,0
KEAMARI,DISTRICT,15 &  ABOVE,WIDOWED,38140,28709,9431,0,0,0,0,0,38140,28709,9431,0
KEAMARI,DISTRICT,15 - 19,DIVORCED,75,66,9,0,0,0,0,0,75,66,9,0
KEAMARI,DISTRICT,15 - 19,MARRIED,15432,11966,3466,0,0,0,0,0,15432,11966,3466,0
KEAMARI,DISTRICT,15 - 19,NEVER MARRIED,206772,90651,116100,21,0,0,0,0,206772,90651,116100,21
KEAMARI,DISTRICT,15 - 19,SEPERATION,52,36,16,0,0,0,0,0,52,36,16,0
KEAMARI,DISTRICT,15 - 19,WIDOWED,46,34,12,0,0,0,0,0,46,34,12,0
KEAMARI,DISTRICT,20 - 24,DIVORCED,462,391,71,0,0,0,0,0,462,391,71,0
KEAMARI,DISTRICT,20 - 24,MARRIED,71426,48783,22643,0,0,0,0,0,71426,48783,22643,0
KEAMARI,DISTRICT,20 - 24,NEVER MARRIED,116695,40707,75960,28,0,0,0,0,116695,40707,75960,28
KEAMARI,DISTRICT,20 - 24,SEPERATION,159,102,57,0,0,0,0,0,159,102,57,0
KEAMARI,DISTRICT,20 - 24,WIDOWED,236,165,71,0,0,0,0,0,236,165,71,0
KEAMARI,DISTRICT,25 - 29,DIVORCED,761,542,219,0,0,0,0,0,761,542,219,0
KEAMARI,DISTRICT,25 - 29,MARRIED,117044,66574,50470,0,0,0,0,0,117044,66574,50470,0
KEAMARI,DISTRICT,25 - 29,NEVER MARRIED,52610,15104,37469,37,0,0,0,0,52610,15104,37469,37
KEAMARI,DISTRICT,25 - 29,SEPERATION,249,148,101,0,0,0,0,0,249,148,101,0
KEAMARI,DISTRICT,25 - 29,WIDOWED,527,339,188,0,0,0,0,0,527,339,188,0
KEAMARI,DISTRICT,30 - 34,DIVORCED,836,521,315,0,0,0,0,0,836,521,315,0
KEAMARI,DISTRICT,30 - 34,MARRIED,122842,62504,60338,0,0,0,0,0,122842,62504,60338,0
KEAMARI,DISTRICT,30 - 34,NEVER MARRIED,19866,5387,14458,21,0,0,0,0,19866,5387,14458,21
KEAMARI,DISTRICT,30 - 34,SEPERATION,268,150,118,0,0,0,0,0,268,150,118,0
KEAMARI,DISTRICT,30 - 34,WIDOWED,883,610,273,0,0,0,0,0,883,610,273,0
KEAMARI,DISTRICT,35 - 39,DIVORCED,841,536,305,0,0,0,0,0,841,536,305,0
KEAMARI,DISTRICT,35 - 39,MARRIED,119696,57085,62611,0,0,0,0,0,119696,57085,62611,0
KEAMARI,DISTRICT,35 - 39,NEVER MARRIED,10186,2997,7147,42,0,0,0,0,10186,2997,7147,42
KEAMARI,DISTRICT,35 - 39,SEPERATION,314,150,164,0,0,0,0,0,314,150,164,0
KEAMARI,DISTRICT,35 - 39,WIDOWED,1342,981,361,0,0,0,0,0,1342,981,361,0
KEAMARI,DISTRICT,40 - 44,DIVORCED,623,355,268,0,0,0,0,0,623,355,268,0
KEAMARI,DISTRICT,40 - 44,MARRIED,103967,45887,58080,0,0,0,0,0,103967,45887,58080,0
KEAMARI,DISTRICT,40 - 44,NEVER MARRIED,5309,1761,3535,13,0,0,0,0,5309,1761,3535,13
KEAMARI,DISTRICT,40 - 44,SEPERATION,222,119,103,0,0,0,0,0,222,119,103,0
KEAMARI,DISTRICT,40 - 44,WIDOWED,2197,1681,516,0,0,0,0,0,2197,1681,516,0
KEAMARI,DISTRICT,45 - 49,DIVORCED,455,275,180,0,0,0,0,0,455,275,180,0
KEAMARI,DISTRICT,45 - 49,MARRIED,82912,35825,47087,0,0,0,0,0,82912,35825,47087,0
KEAMARI,DISTRICT,45 - 49,NEVER MARRIED,3151,1138,2007,6,0,0,0,0,3151,1138,2007,6
KEAMARI,DISTRICT,45 - 49,SEPERATION,203,111,92,0,0,0,0,0,203,111,92,0
KEAMARI,DISTRICT,45 - 49,WIDOWED,3022,2401,621,0,0,0,0,0,3022,2401,621,0
KEAMARI,DISTRICT,50 - 54,DIVORCED,322,180,142,0,0,0,0,0,322,180,142,0
KEAMARI,DISTRICT,50 - 54,MARRIED,58752,23843,34909,0,0,0,0,0,58752,23843,34909,0
KEAMARI,DISTRICT,50 - 54,NEVER MARRIED,1633,630,993,10,0,0,0,0,1633,630,993,10
KEAMARI,DISTRICT,50 - 54,SEPERATION,134,66,68,0,0,0,0,0,134,66,68,0
KEAMARI,DISTRICT,50 - 54,WIDOWED,4035,3186,849,0,0,0,0,0,4035,3186,849,0
KEAMARI,DISTRICT,55 - 59,DIVORCED,194,107,87,0,0,0,0,0,194,107,87,0
KEAMARI,DISTRICT,55 - 59,MARRIED,46638,18418,28220,0,0,0,0,0,46638,18418,28220,0
KEAMARI,DISTRICT,55 - 59,NEVER MARRIED,1121,443,668,10,0,0,0,0,1121,443,668,10
KEAMARI,DISTRICT,55 - 59,SEPERATION,102,55,47,0,0,0,0,0,102,55,47,0
KEAMARI,DISTRICT,55 - 59,WIDOWED,5076,3974,1102,0,0,0,0,0,5076,3974,1102,0
KEAMARI,DISTRICT,60 - 64,DIVORCED,119,70,49,0,0,0,0,0,119,70,49,0
KEAMARI,DISTRICT,60 - 64,MARRIED,29445,10748,18697,0,0,0,0,0,29445,10748,18697,0
KEAMARI,DISTRICT,60 - 64,NEVER MARRIED,681,301,371,9,0,0,0,0,681,301,371,9
KEAMARI,DISTRICT,60 - 64,SEPERATION,69,28,41,0,0,0,0,0,69,28,41,0
KEAMARI,DISTRICT,60 - 64,WIDOWED,5405,4146,1259,0,0,0,0,0,5405,4146,1259,0
KEAMARI,DISTRICT,65 - 69,DIVORCED,81,45,36,0,0,0,0,0,81,45,36,0
KEAMARI,DISTRICT,65 - 69,MARRIED,20582,6841,13741,0,0,0,0,0,20582,6841,13741,0
KEAMARI,DISTRICT,65 - 69,NEVER MARRIED,476,192,283,1,0,0,0,0,476,192,283,1
KEAMARI,DISTRICT,65 - 69,SEPERATION,49,19,30,0,0,0,0,0,49,19,30,0
KEAMARI,DISTRICT,65 - 69,WIDOWED,5581,4136,1445,0,0,0,0,0,5581,4136,1445,0
KEAMARI,DISTRICT,70 - 74,DIVORCED,34,21,13,0,0,0,0,0,34,21,13,0
KEAMARI,DISTRICT,70 - 74,MARRIED,11556,3412,8144,0,0,0,0,0,11556,3412,8144,0
KEAMARI,DISTRICT,70 - 74,NEVER MARRIED,217,76,138,3,0,0,0,0,217,76,138,3
KEAMARI,DISTRICT,70 - 74,SEPERATION,29,9,20,0,0,0,0,0,29,9,20,0
KEAMARI,DISTRICT,70 - 74,WIDOWED,4739,3482,1257,0,0,0,0,0,4739,3482,1257,0
KEAMARI,DISTRICT,75 & ABOVE,DIVORCED,21,16,5,0,0,0,0,0,21,16,5,0
KEAMARI,DISTRICT,75 & ABOVE,MARRIED,7664,2145,5519,0,0,0,0,0,7664,2145,5519,0
KEAMARI,DISTRICT,75 & ABOVE,NEVER MARRIED,176,61,114,1,0,0,0,0,176,61,114,1
KEAMARI,DISTRICT,75 & ABOVE,SEPERATION,18,7,11,0,0,0,0,0,18,7,11,0
KEAMARI,DISTRICT,75 & ABOVE,WIDOWED,5051,3574,1477,0,0,0,0,0,5051,3574,1477,0
KHAIRPUR,DISTRICT,15 &  ABOVE,DIVORCED,2669,1752,917,0,1463,956,507,0,1206,796,410,0
KHAIRPUR,DISTRICT,15 &  ABOVE,MARRIED,952574,478384,474190,0,638520,321212,317308,0,314054,157172,156882,0
KHAIRPUR,DISTRICT,15 &  ABOVE,NEVER MARRIED,392173,166748,225297,128,245923,103733,142155,35,146250,63015,83142,93
KHAIRPUR,DISTRICT,15 &  ABOVE,SEPERATION,2096,1249,847,0,1465,901,564,0,631,348,283,0
KHAIRPUR,DISTRICT,15 &  ABOVE,WIDOWED,56168,44292,11876,0,36186,28490,7696,0,19982,15802,4180,0
KHAIRPUR,DISTRICT,15 - 19,DIVORCED,88,56,32,0,58,41,17,0,30,15,15,0
KHAIRPUR,DISTRICT,15 - 19,MARRIED,41147,26923,14224,0,29974,19395,10579,0,11173,7528,3645,0
KHAIRPUR,DISTRICT,15 - 19,NEVER MARRIED,221700,100851,120820,29,144818,65458,79349,11,76882,35393,41471,18
KHAIRPUR,DISTRICT,15 - 19,SEPERATION,72,32,40,0,42,19,23,0,30,13,17,0
KHAIRPUR,DISTRICT,15 - 19,WIDOWED,127,64,63,0,94,44,50,0,33,20,13,0
KHAIRPUR,DISTRICT,20 - 24,DIVORCED,268,179,89,0,156,102,54,0,112,77,35,0
KHAIRPUR,DISTRICT,20 - 24,MARRIED,118610,71353,47257,0,83445,49667,33778,0,35165,21686,13479,0
KHAIRPUR,DISTRICT,20 - 24,NEVER MARRIED,93095,34927,58149,19,56116,20393,35717,6,36979,14534,22432,13
KHAIRPUR,DISTRICT,20 - 24,SEPERATION,167,94,73,0,122,69,53,0,45,25,20,0
KHAIRPUR,DISTRICT,20 - 24,WIDOWED,447,276,171,0,316,192,124,0,131,84,47,0
KHAIRPUR,DISTRICT,25 - 29,DIVORCED,350,230,120,0,181,113,68,0,169,117,52,0
KHAIRPUR,DISTRICT,25 - 29,MARRIED,133714,70663,63051,0,90499,47191,43308,0,43215,23472,19743,0
KHAIRPUR,DISTRICT,25 - 29,NEVER MARRIED,40166,15789,24360,17,23370,9049,14316,5,16796,6740,10044,12
KHAIRPUR,DISTRICT,25 - 29,SEPERATION,233,144,89,0,164,102,62,0,69,42,27,0
KHAIRPUR,DISTRICT,25 - 29,WIDOWED,786,507,279,0,518,333,185,0,268,174,94,0
KHAIRPUR,DISTRICT,30 - 34,DIVORCED,420,286,134,0,218,151,67,0,202,135,67,0
KHAIRPUR,DISTRICT,30 - 34,MARRIED,131370,68555,62815,0,87187,45348,41839,0,44183,23207,20976,0
KHAIRPUR,DISTRICT,30 - 34,NEVER MARRIED,16404,7151,9238,15,9284,4111,5168,5,7120,3040,4070,10
KHAIRPUR,DISTRICT,30 - 34,SEPERATION,215,135,80,0,141,93,48,0,74,42,32,0
KHAIRPUR,DISTRICT,30 - 34,WIDOWED,1334,929,405,0,902,627,275,0,432,302,130,0
KHAIRPUR,DISTRICT,35 - 39,DIVORCED,422,264,158,0,226,142,84,0,196,122,74,0
KHAIRPUR,DISTRICT,35 - 39,MARRIED,128053,62877,65176,0,84061,41387,42674,0,43992,21490,22502,0
KHAIRPUR,DISTRICT,35 - 39,NEVER MARRIED,8983,3234,5737,12,5279,1901,3377,1,3704,1333,2360,11
KHAIRPUR,DISTRICT,35 - 39,SEPERATION,266,154,112,0,191,115,76,0,75,39,36,0
KHAIRPUR,DISTRICT,35 - 39,WIDOWED,2186,1591,595,0,1445,1053,392,0,741,538,203,0
KHAIRPUR,DISTRICT,40 - 44,DIVORCED,337,224,113,0,181,118,63,0,156,106,50,0
KHAIRPUR,DISTRICT,40 - 44,MARRIED,113499,54085,59414,0,74961,35840,39121,0,38538,18245,20293,0
KHAIRPUR,DISTRICT,40 - 44,NEVER MARRIED,4682,1823,2849,10,2748,1103,1643,2,1934,720,1206,8
KHAIRPUR,DISTRICT,40 - 44,SEPERATION,280,175,105,0,206,134,72,0,74,41,33,0
KHAIRPUR,DISTRICT,40 - 44,WIDOWED,3573,2809,764,0,2323,1811,512,0,1250,998,252,0
KHAIRPUR,DISTRICT,45 - 49,DIVORCED,244,156,88,0,130,81,49,0,114,75,39,0
KHAIRPUR,DISTRICT,45 - 49,MARRIED,84221,40453,43768,0,54578,26491,28087,0,29643,13962,15681,0
KHAIRPUR,DISTRICT,45 - 49,NEVER MARRIED,2803,1106,1686,11,1713,656,1056,1,1090,450,630,10
KHAIRPUR,DISTRICT,45 - 49,SEPERATION,241,144,97,0,174,108,66,0,67,36,31,0
KHAIRPUR,DISTRICT,45 - 49,WIDOWED,4544,3663,881,0,2915,2340,575,0,1629,1323,306,0
KHAIRPUR,DISTRICT,50 - 54,DIVORCED,195,119,76,0,109,66,43,0,86,53,33,0
KHAIRPUR,DISTRICT,50 - 54,MARRIED,72178,32539,39639,0,47591,21646,25945,0,24587,10893,13694,0
KHAIRPUR,DISTRICT,50 - 54,NEVER MARRIED,1577,701,870,6,939,420,518,1,638,281,352,5
KHAIRPUR,DISTRICT,50 - 54,SEPERATION,210,135,75,0,136,88,48,0,74,47,27,0
KHAIRPUR,DISTRICT,50 - 54,WIDOWED,6743,5528,1215,0,4302,3526,776,0,2441,2002,439,0
KHAIRPUR,DISTRICT,55 - 59,DIVORCED,151,99,52,0,83,55,28,0,68,44,24,0
KHAIRPUR,DISTRICT,55 - 59,MARRIED,51884,20770,31114,0,33840,13697,20143,0,18044,7073,10971,0
KHAIRPUR,DISTRICT,55 - 59,NEVER MARRIED,1138,470,662,6,680,275,402,3,458,195,260,3
KHAIRPUR,DISTRICT,55 - 59,SEPERATION,156,91,65,0,99,62,37,0,57,29,28,0
KHAIRPUR,DISTRICT,55 - 59,WIDOWED,6721,5361,1360,0,4137,3293,844,0,2584,2068,516,0
KHAIRPUR,DISTRICT,60 - 64,DIVORCED,91,61,30,0,54,39,15,0,37,22,15,0
KHAIRPUR,DISTRICT,60 - 64,MARRIED,31761,12791,18970,0,20840,8597,12243,0,10921,4194,6727,0
KHAIRPUR,DISTRICT,60 - 64,NEVER MARRIED,708,324,382,2,392,165,227,0,316,159,155,2
KHAIRPUR,DISTRICT,60 - 64,SEPERATION,101,59,42,0,69,42,27,0,32,17,15,0
KHAIRPUR,DISTRICT,60 - 64,WIDOWED,7001,5626,1375,0,4406,3530,876,0,2595,2096,499,0
KHAIRPUR,DISTRICT,65 - 69,DIVORCED,54,41,13,0,29,21,8,0,25,20,5,0
KHAIRPUR,DISTRICT,65 - 69,MARRIED,21046,8650,12396,0,14043,5845,8198,0,7003,2805,4198,0
KHAIRPUR,DISTRICT,65 - 69,NEVER MARRIED,391,176,215,0,228,95,133,0,163,81,82,0
KHAIRPUR,DISTRICT,65 - 69,SEPERATION,72,47,25,0,56,37,19,0,16,10,6,0
KHAIRPUR,DISTRICT,65 - 69,WIDOWED,7035,5671,1364,0,4438,3591,847,0,2597,2080,517,0
KHAIRPUR,DISTRICT,70 - 74,DIVORCED,33,23,10,0,25,16,9,0,8,7,1,0
KHAIRPUR,DISTRICT,70 - 74,MARRIED,14734,5349,9385,0,10135,3727,6408,0,4599,1622,2977,0
KHAIRPUR,DISTRICT,70 - 74,NEVER MARRIED,299,113,185,1,188,59,129,0,111,54,56,1
KHAIRPUR,DISTRICT,70 - 74,SEPERATION,47,24,23,0,38,21,17,0,9,3,6,0
KHAIRPUR,DISTRICT,70 - 74,WIDOWED,7170,5666,1504,0,4668,3690,978,0,2502,1976,526,0
KHAIRPUR,DISTRICT,75 & ABOVE,DIVORCED,16,14,2,0,13,11,2,0,3,3,0,0
KHAIRPUR,DISTRICT,75 & ABOVE,MARRIED,10357,3376,6981,0,7366,2381,4985,0,2991,995,1996,0
KHAIRPUR,DISTRICT,75 & ABOVE,NEVER MARRIED,227,83,144,0,168,48,120,0,59,35,24,0
KHAIRPUR,DISTRICT,75 & ABOVE,SEPERATION,36,15,21,0,27,11,16,0,9,4,5,0
KHAIRPUR,DISTRICT,75 & ABOVE,WIDOWED,8501,6601,1900,0,5722,4460,1262,0,2779,2141,638,0
KORANGI,DISTRICT,15 &  ABOVE,DIVORCED,10284,6483,3801,0,0,0,0,0,10284,6483,3801,0
KORANGI,DISTRICT,15 &  ABOVE,MARRIED,1179974,583764,596210,0,0,0,0,0,1179974,583764,596210,0
KORANGI,DISTRICT,15 &  ABOVE,NEVER MARRIED,669130,259044,409445,641,0,0,0,0,669130,259044,409445,641
KORANGI,DISTRICT,15 &  ABOVE,SEPERATION,3729,1851,1878,0,0,0,0,0,3729,1851,1878,0
KORANGI,DISTRICT,15 &  ABOVE,WIDOWED,69644,52554,17090,0,0,0,0,0,69644,52554,17090,0
KORANGI,DISTRICT,15 - 19,DIVORCED,108,89,19,0,0,0,0,0,108,89,19,0
KORANGI,DISTRICT,15 - 19,MARRIED,13790,10711,3079,0,0,0,0,0,13790,10711,3079,0
KORANGI,DISTRICT,15 - 19,NEVER MARRIED,311309,136095,175132,82,0,0,0,0,311309,136095,175132,82
KORANGI,DISTRICT,15 - 19,SEPERATION,76,42,34,0,0,0,0,0,76,42,34,0
KORANGI,DISTRICT,15 - 19,WIDOWED,44,25,19,0,0,0,0,0,44,25,19,0
KORANGI,DISTRICT,20 - 24,DIVORCED,596,459,137,0,0,0,0,0,596,459,137,0
KORANGI,DISTRICT,20 - 24,MARRIED,76513,55475,21038,0,0,0,0,0,76513,55475,21038,0
KORANGI,DISTRICT,20 - 24,NEVER MARRIED,178756,68288,110368,100,0,0,0,0,178756,68288,110368,100
KORANGI,DISTRICT,20 - 24,SEPERATION,190,114,76,0,0,0,0,0,190,114,76,0
KORANGI,DISTRICT,20 - 24,WIDOWED,278,182,96,0,0,0,0,0,278,182,96,0
KORANGI,DISTRICT,25 - 29,DIVORCED,1302,895,407,0,0,0,0,0,1302,895,407,0
KORANGI,DISTRICT,25 - 29,MARRIED,149056,90885,58171,0,0,0,0,0,149056,90885,58171,0
KORANGI,DISTRICT,25 - 29,NEVER MARRIED,91269,27961,63195,113,0,0,0,0,91269,27961,63195,113
KORANGI,DISTRICT,25 - 29,SEPERATION,408,219,189,0,0,0,0,0,408,219,189,0
KORANGI,DISTRICT,25 - 29,WIDOWED,663,437,226,0,0,0,0,0,663,437,226,0
KORANGI,DISTRICT,30 - 34,DIVORCED,1711,1146,565,0,0,0,0,0,1711,1146,565,0
KORANGI,DISTRICT,30 - 34,MARRIED,179090,94910,84180,0,0,0,0,0,179090,94910,84180,0
KORANGI,DISTRICT,30 - 34,NEVER MARRIED,39244,10782,28357,105,0,0,0,0,39244,10782,28357,105
KORANGI,DISTRICT,30 - 34,SEPERATION,530,262,268,0,0,0,0,0,530,262,268,0
KORANGI,DISTRICT,30 - 34,WIDOWED,1254,831,423,0,0,0,0,0,1254,831,423,0
KORANGI,DISTRICT,35 - 39,DIVORCED,1736,1058,678,0,0,0,0,0,1736,1058,678,0
KORANGI,DISTRICT,35 - 39,MARRIED,180552,89049,91503,0,0,0,0,0,180552,89049,91503,0
KORANGI,DISTRICT,35 - 39,NEVER MARRIED,20783,6101,14585,97,0,0,0,0,20783,6101,14585,97
KORANGI,DISTRICT,35 - 39,SEPERATION,613,281,332,0,0,0,0,0,613,281,332,0
KORANGI,DISTRICT,35 - 39,WIDOWED,2138,1546,592,0,0,0,0,0,2138,1546,592,0
KORANGI,DISTRICT,40 - 44,DIVORCED,1596,951,645,0,0,0,0,0,1596,951,645,0
KORANGI,DISTRICT,40 - 44,MARRIED,159143,72803,86340,0,0,0,0,0,159143,72803,86340,0
KORANGI,DISTRICT,40 - 44,NEVER MARRIED,11351,3607,7696,48,0,0,0,0,11351,3607,7696,48
KORANGI,DISTRICT,40 - 44,SEPERATION,517,252,265,0,0,0,0,0,517,252,265,0
KORANGI,DISTRICT,40 - 44,WIDOWED,3683,2718,965,0,0,0,0,0,3683,2718,965,0
KORANGI,DISTRICT,45 - 49,DIVORCED,1280,762,518,0,0,0,0,0,1280,762,518,0
KORANGI,DISTRICT,45 - 49,MARRIED,128317,56891,71426,0,0,0,0,0,128317,56891,71426,0
KORANGI,DISTRICT,45 - 49,NEVER MARRIED,7081,2423,4619,39,0,0,0,0,7081,2423,4619,39
KORANGI,DISTRICT,45 - 49,SEPERATION,472,231,241,0,0,0,0,0,472,231,241,0
KORANGI,DISTRICT,45 - 49,WIDOWED,5119,3983,1136,0,0,0,0,0,5119,3983,1136,0
KORANGI,DISTRICT,50 - 54,DIVORCED,731,403,328,0,0,0,0,0,731,403,328,0
KORANGI,DISTRICT,50 - 54,MARRIED,96564,40580,55984,0,0,0,0,0,96564,40580,55984,0
KORANGI,DISTRICT,50 - 54,NEVER MARRIED,3725,1392,2305,28,0,0,0,0,3725,1392,2305,28
KORANGI,DISTRICT,50 - 54,SEPERATION,305,157,148,0,0,0,0,0,305,157,148,0
KORANGI,DISTRICT,50 - 54,WIDOWED,7259,5782,1477,0,0,0,0,0,7259,5782,1477,0
KORANGI,DISTRICT,55 - 59,DIVORCED,566,352,214,0,0,0,0,0,566,352,214,0
KORANGI,DISTRICT,55 - 59,MARRIED,78907,32036,46871,0,0,0,0,0,78907,32036,46871,0
KORANGI,DISTRICT,55 - 59,NEVER MARRIED,2653,1093,1549,11,0,0,0,0,2653,1093,1549,11
KORANGI,DISTRICT,55 - 59,SEPERATION,284,152,132,0,0,0,0,0,284,152,132,0
KORANGI,DISTRICT,55 - 59,WIDOWED,9468,7444,2024,0,0,0,0,0,9468,7444,2024,0
KORANGI,DISTRICT,60 - 64,DIVORCED,346,195,151,0,0,0,0,0,346,195,151,0
KORANGI,DISTRICT,60 - 64,MARRIED,52612,19435,33177,0,0,0,0,0,52612,19435,33177,0
KORANGI,DISTRICT,60 - 64,NEVER MARRIED,1431,622,798,11,0,0,0,0,1431,622,798,11
KORANGI,DISTRICT,60 - 64,SEPERATION,150,73,77,0,0,0,0,0,150,73,77,0
KORANGI,DISTRICT,60 - 64,WIDOWED,10746,8308,2438,0,0,0,0,0,10746,8308,2438,0
KORANGI,DISTRICT,65 - 69,DIVORCED,186,99,87,0,0,0,0,0,186,99,87,0
KORANGI,DISTRICT,65 - 69,MARRIED,34221,11653,22568,0,0,0,0,0,34221,11653,22568,0
KORANGI,DISTRICT,65 - 69,NEVER MARRIED,830,390,438,2,0,0,0,0,830,390,438,2
KORANGI,DISTRICT,65 - 69,SEPERATION,93,35,58,0,0,0,0,0,93,35,58,0
KORANGI,DISTRICT,65 - 69,WIDOWED,10543,7956,2587,0,0,0,0,0,10543,7956,2587,0
KORANGI,DISTRICT,70 - 74,DIVORCED,77,47,30,0,0,0,0,0,77,47,30,0
KORANGI,DISTRICT,70 - 74,MARRIED,18973,5770,13203,0,0,0,0,0,18973,5770,13203,0
KORANGI,DISTRICT,70 - 74,NEVER MARRIED,406,179,226,1,0,0,0,0,406,179,226,1
KORANGI,DISTRICT,70 - 74,SEPERATION,59,25,34,0,0,0,0,0,59,25,34,0
KORANGI,DISTRICT,70 - 74,WIDOWED,8857,6433,2424,0,0,0,0,0,8857,6433,2424,0
KORANGI,DISTRICT,75 & ABOVE,DIVORCED,49,27,22,0,0,0,0,0,49,27,22,0
KORANGI,DISTRICT,75 & ABOVE,MARRIED,12236,3566,8670,0,0,0,0,0,12236,3566,8670,0
KORANGI,DISTRICT,75 & ABOVE,NEVER MARRIED,292,111,177,4,0,0,0,0,292,111,177,4
KORANGI,DISTRICT,75 & ABOVE,SEPERATION,32,8,24,0,0,0,0,0,32,8,24,0
KORANGI,DISTRICT,75 & ABOVE,WIDOWED,9592,6909,2683,0,0,0,0,0,9592,6909,2683,0
LARKANA,DISTRICT,15 &  ABOVE,DIVORCED,1097,736,361,0,490,346,144,0,607,390,217,0
LARKANA,DISTRICT,15 &  ABOVE,MARRIED,653778,328765,325013,0,356675,179509,177166,0,297103,149256,147847,0
LARKANA,DISTRICT,15 &  ABOVE,NEVER MARRIED,310433,124622,185698,113,156131,62409,93694,28,154302,62213,92004,85
LARKANA,DISTRICT,15 &  ABOVE,SEPERATION,1021,474,547,0,528,270,258,0,493,204,289,0
LARKANA,DISTRICT,15 &  ABOVE,WIDOWED,34231,26986,7245,0,18684,14621,4063,0,15547,12365,3182,0
LARKANA,DISTRICT,15 - 19,DIVORCED,35,26,9,0,17,14,3,0,18,12,6,0
LARKANA,DISTRICT,15 - 19,MARRIED,22339,15268,7071,0,13940,9343,4597,0,8399,5925,2474,0
LARKANA,DISTRICT,15 - 19,NEVER MARRIED,171028,74181,96828,19,92888,40069,52813,6,78140,34112,44015,13
LARKANA,DISTRICT,15 - 19,SEPERATION,29,12,17,0,21,10,11,0,8,2,6,0
LARKANA,DISTRICT,15 - 19,WIDOWED,84,47,37,0,58,31,27,0,26,16,10,0
LARKANA,DISTRICT,20 - 24,DIVORCED,97,75,22,0,47,40,7,0,50,35,15,0
LARKANA,DISTRICT,20 - 24,MARRIED,78186,48160,30026,0,46129,27918,18211,0,32057,20242,11815,0
LARKANA,DISTRICT,20 - 24,NEVER MARRIED,78479,28955,49506,18,37877,13356,24519,2,40602,15599,24987,16
LARKANA,DISTRICT,20 - 24,SEPERATION,67,24,43,0,36,11,25,0,31,13,18,0
LARKANA,DISTRICT,20 - 24,WIDOWED,225,114,111,0,142,62,80,0,83,52,31,0
LARKANA,DISTRICT,25 - 29,DIVORCED,153,101,52,0,78,53,25,0,75,48,27,0
LARKANA,DISTRICT,25 - 29,MARRIED,90223,48077,42146,0,49092,25471,23621,0,41131,22606,18525,0
LARKANA,DISTRICT,25 - 29,NEVER MARRIED,32886,11242,21627,17,13894,4529,9362,3,18992,6713,12265,14
LARKANA,DISTRICT,25 - 29,SEPERATION,86,42,44,0,40,18,22,0,46,24,22,0
LARKANA,DISTRICT,25 - 29,WIDOWED,432,245,187,0,268,146,122,0,164,99,65,0
LARKANA,DISTRICT,30 - 34,DIVORCED,164,114,50,0,65,47,18,0,99,67,32,0
LARKANA,DISTRICT,30 - 34,MARRIED,91912,48379,43533,0,48993,25817,23176,0,42919,22562,20357,0
LARKANA,DISTRICT,30 - 34,NEVER MARRIED,13516,4776,8722,18,5518,2126,3388,4,7998,2650,5334,14
LARKANA,DISTRICT,30 - 34,SEPERATION,106,47,59,0,49,25,24,0,57,22,35,0
LARKANA,DISTRICT,30 - 34,WIDOWED,748,492,256,0,445,294,151,0,303,198,105,0
LARKANA,DISTRICT,35 - 39,DIVORCED,165,111,54,0,66,46,20,0,99,65,34,0
LARKANA,DISTRICT,35 - 39,MARRIED,91008,44582,46426,0,48406,23780,24626,0,42602,20802,21800,0
LARKANA,DISTRICT,35 - 39,NEVER MARRIED,6685,2427,4244,14,2733,1018,1712,3,3952,1409,2532,11
LARKANA,DISTRICT,35 - 39,SEPERATION,153,68,85,0,74,43,31,0,79,25,54,0
LARKANA,DISTRICT,35 - 39,WIDOWED,1327,920,407,0,699,463,236,0,628,457,171,0
LARKANA,DISTRICT,40 - 44,DIVORCED,149,97,52,0,66,46,20,0,83,51,32,0
LARKANA,DISTRICT,40 - 44,MARRIED,77163,36961,40202,0,41494,19851,21643,0,35669,17110,18559,0
LARKANA,DISTRICT,40 - 44,NEVER MARRIED,3402,1259,2126,17,1334,518,808,8,2068,741,1318,9
LARKANA,DISTRICT,40 - 44,SEPERATION,134,71,63,0,61,34,27,0,73,37,36,0
LARKANA,DISTRICT,40 - 44,WIDOWED,2055,1619,436,0,1135,876,259,0,920,743,177,0
LARKANA,DISTRICT,45 - 49,DIVORCED,125,74,51,0,55,35,20,0,70,39,31,0
LARKANA,DISTRICT,45 - 49,MARRIED,61732,29136,32596,0,32386,15460,16926,0,29346,13676,15670,0
LARKANA,DISTRICT,45 - 49,NEVER MARRIED,2007,739,1263,5,793,326,467,0,1214,413,796,5
LARKANA,DISTRICT,45 - 49,SEPERATION,133,67,66,0,61,37,24,0,72,30,42,0
LARKANA,DISTRICT,45 - 49,WIDOWED,2832,2307,525,0,1490,1212,278,0,1342,1095,247,0
LARKANA,DISTRICT,50 - 54,DIVORCED,63,40,23,0,27,20,7,0,36,20,16,0
LARKANA,DISTRICT,50 - 54,MARRIED,48348,21628,26720,0,25884,11756,14128,0,22464,9872,12592,0
LARKANA,DISTRICT,50 - 54,NEVER MARRIED,1073,434,636,3,458,182,274,2,615,252,362,1
LARKANA,DISTRICT,50 - 54,SEPERATION,82,37,45,0,43,21,22,0,39,16,23,0
LARKANA,DISTRICT,50 - 54,WIDOWED,3893,3231,662,0,2127,1736,391,0,1766,1495,271,0
LARKANA,DISTRICT,55 - 59,DIVORCED,71,43,28,0,32,20,12,0,39,23,16,0
LARKANA,DISTRICT,55 - 59,MARRIED,37009,15541,21468,0,19619,8380,11239,0,17390,7161,10229,0
LARKANA,DISTRICT,55 - 59,NEVER MARRIED,596,258,338,0,271,124,147,0,325,134,191,0
LARKANA,DISTRICT,55 - 59,SEPERATION,86,42,44,0,61,34,27,0,25,8,17,0
LARKANA,DISTRICT,55 - 59,WIDOWED,4600,3689,911,0,2385,1907,478,0,2215,1782,433,0
LARKANA,DISTRICT,60 - 64,DIVORCED,32,22,10,0,21,13,8,0,11,9,2,0
LARKANA,DISTRICT,60 - 64,MARRIED,24061,9622,14439,0,12881,5327,7554,0,11180,4295,6885,0
LARKANA,DISTRICT,60 - 64,NEVER MARRIED,350,151,198,1,172,71,101,0,178,80,97,1
LARKANA,DISTRICT,60 - 64,SEPERATION,51,21,30,0,25,9,16,0,26,12,14,0
LARKANA,DISTRICT,60 - 64,WIDOWED,4703,3804,899,0,2469,1992,477,0,2234,1812,422,0
LARKANA,DISTRICT,65 - 69,DIVORCED,21,18,3,0,9,6,3,0,12,12,0,0
LARKANA,DISTRICT,65 - 69,MARRIED,15391,5999,9392,0,8517,3379,5138,0,6874,2620,4254,0
LARKANA,DISTRICT,65 - 69,NEVER MARRIED,208,102,105,1,92,40,52,0,116,62,53,1
LARKANA,DISTRICT,65 - 69,SEPERATION,37,19,18,0,24,14,10,0,13,5,8,0
LARKANA,DISTRICT,65 - 69,WIDOWED,4679,3744,935,0,2590,2083,507,0,2089,1661,428,0
LARKANA,DISTRICT,70 - 74,DIVORCED,11,10,1,0,3,3,0,0,8,7,1,0
LARKANA,DISTRICT,70 - 74,MARRIED,9740,3350,6390,0,5496,1905,3591,0,4244,1445,2799,0
LARKANA,DISTRICT,70 - 74,NEVER MARRIED,108,57,51,0,50,25,25,0,58,32,26,0
LARKANA,DISTRICT,70 - 74,SEPERATION,27,13,14,0,15,7,8,0,12,6,6,0
LARKANA,DISTRICT,70 - 74,WIDOWED,4066,3206,860,0,2335,1816,519,0,1731,1390,341,0
LARKANA,DISTRICT,75 & ABOVE,DIVORCED,11,5,6,0,4,3,1,0,7,2,5,0
LARKANA,DISTRICT,75 & ABOVE,MARRIED,6666,2062,4604,0,3838,1122,2716,0,2828,940,1888,0
LARKANA,DISTRICT,75 & ABOVE,NEVER MARRIED,95,41,54,0,51,25,26,0,44,16,28,0
LARKANA,DISTRICT,75 & ABOVE,SEPERATION,30,11,19,0,18,7,11,0,12,4,8,0
LARKANA,DISTRICT,75 & ABOVE,WIDOWED,4587,3568,1019,0,2541,2003,538,0,2046,1565,481,0
MALIR,DISTRICT,15 &  ABOVE,DIVORCED,4731,3117,1614,0,2390,1564,826,0,2341,1553,788,0
MALIR,DISTRICT,15 &  ABOVE,MARRIED,993610,481692,511918,0,519070,250758,268312,0,474540,230934,243606,0
MALIR,DISTRICT,15 &  ABOVE,NEVER MARRIED,467874,178021,289639,214,234830,88110,146609,111,233044,89911,143030,103
MALIR,DISTRICT,15 &  ABOVE,SEPERATION,1959,891,1068,0,1082,468,614,0,877,423,454,0
MALIR,DISTRICT,15 &  ABOVE,WIDOWED,44978,33801,11177,0,23267,17237,6030,0,21711,16564,5147,0
MALIR,DISTRICT,15 - 19,DIVORCED,88,80,8,0,48,43,5,0,40,37,3,0
MALIR,DISTRICT,15 - 19,MARRIED,21013,15985,5028,0,13095,9784,3311,0,7918,6201,1717,0
MALIR,DISTRICT,15 - 19,NEVER MARRIED,223956,99437,124495,24,115728,50286,65430,12,108228,49151,59065,12
MALIR,DISTRICT,15 - 19,SEPERATION,40,25,15,0,35,20,15,0,5,5,0,0
MALIR,DISTRICT,15 - 19,WIDOWED,50,30,20,0,30,18,12,0,20,12,8,0
MALIR,DISTRICT,20 - 24,DIVORCED,400,309,91,0,225,168,57,0,175,141,34,0
MALIR,DISTRICT,20 - 24,MARRIED,86473,58137,28336,0,50015,32662,17353,0,36458,25475,10983,0
MALIR,DISTRICT,20 - 24,NEVER MARRIED,129340,46603,82712,25,63244,22289,40945,10,66096,24314,41767,15
MALIR,DISTRICT,20 - 24,SEPERATION,154,77,77,0,95,41,54,0,59,36,23,0
MALIR,DISTRICT,20 - 24,WIDOWED,284,172,112,0,192,111,81,0,92,61,31,0
MALIR,DISTRICT,25 - 29,DIVORCED,690,478,212,0,368,247,121,0,322,231,91,0
MALIR,DISTRICT,25 - 29,MARRIED,142552,79129,63423,0,78197,42142,36055,0,64355,36987,27368,0
MALIR,DISTRICT,25 - 29,NEVER MARRIED,62660,17229,45397,34,30531,8233,22275,23,32129,8996,23122,11
MALIR,DISTRICT,25 - 29,SEPERATION,233,106,127,0,142,60,82,0,91,46,45,0
MALIR,DISTRICT,25 - 29,WIDOWED,634,374,260,0,388,238,150,0,246,136,110,0
MALIR,DISTRICT,30 - 34,DIVORCED,771,515,256,0,378,249,129,0,393,266,127,0
MALIR,DISTRICT,30 - 34,MARRIED,152301,76419,75882,0,78852,39152,39700,0,73449,37267,36182,0
MALIR,DISTRICT,30 - 34,NEVER MARRIED,24891,6587,18262,42,12197,3318,8858,21,12694,3269,9404,21
MALIR,DISTRICT,30 - 34,SEPERATION,303,133,170,0,165,71,94,0,138,62,76,0
MALIR,DISTRICT,30 - 34,WIDOWED,1049,689,360,0,611,385,226,0,438,304,134,0
MALIR,DISTRICT,35 - 39,DIVORCED,807,511,296,0,417,258,159,0,390,253,137,0
MALIR,DISTRICT,35 - 39,MARRIED,149350,69498,79852,0,76692,35178,41514,0,72658,34320,38338,0
MALIR,DISTRICT,35 - 39,NEVER MARRIED,12850,3555,9258,37,6382,1819,4542,21,6468,1736,4716,16
MALIR,DISTRICT,35 - 39,SEPERATION,302,129,173,0,162,67,95,0,140,62,78,0
MALIR,DISTRICT,35 - 39,WIDOWED,1642,1139,503,0,916,626,290,0,726,513,213,0
MALIR,DISTRICT,40 - 44,DIVORCED,708,451,257,0,362,226,136,0,346,225,121,0
MALIR,DISTRICT,40 - 44,MARRIED,126153,56110,70043,0,64079,28440,35639,0,62074,27670,34404,0
MALIR,DISTRICT,40 - 44,NEVER MARRIED,6249,1967,4268,14,3077,963,2106,8,3172,1004,2162,6
MALIR,DISTRICT,40 - 44,SEPERATION,241,107,134,0,129,51,78,0,112,56,56,0
MALIR,DISTRICT,40 - 44,WIDOWED,2746,2074,672,0,1556,1153,403,0,1190,921,269,0
MALIR,DISTRICT,45 - 49,DIVORCED,497,301,196,0,217,142,75,0,280,159,121,0
MALIR,DISTRICT,45 - 49,MARRIED,97896,42781,55115,0,49166,21511,27655,0,48730,21270,27460,0
MALIR,DISTRICT,45 - 49,NEVER MARRIED,3419,1085,2320,14,1551,494,1050,7,1868,591,1270,7
MALIR,DISTRICT,45 - 49,SEPERATION,239,105,134,0,124,45,79,0,115,60,55,0
MALIR,DISTRICT,45 - 49,WIDOWED,3713,2932,781,0,2001,1567,434,0,1712,1365,347,0
MALIR,DISTRICT,50 - 54,DIVORCED,310,197,113,0,160,105,55,0,150,92,58,0
MALIR,DISTRICT,50 - 54,MARRIED,73224,30787,42437,0,36965,15639,21326,0,36259,15148,21111,0
MALIR,DISTRICT,50 - 54,NEVER MARRIED,1879,647,1222,10,883,292,585,6,996,355,637,4
MALIR,DISTRICT,50 - 54,SEPERATION,161,81,80,0,78,40,38,0,83,41,42,0
MALIR,DISTRICT,50 - 54,WIDOWED,5262,4237,1025,0,2855,2272,583,0,2407,1965,442,0
MALIR,DISTRICT,55 - 59,DIVORCED,219,136,83,0,99,62,37,0,120,74,46,0
MALIR,DISTRICT,55 - 59,MARRIED,56555,22615,33940,0,28517,11340,17177,0,28038,11275,16763,0
MALIR,DISTRICT,55 - 59,NEVER MARRIED,1227,416,804,7,580,195,385,0,647,221,419,7
MALIR,DISTRICT,55 - 59,SEPERATION,128,55,73,0,67,32,35,0,61,23,38,0
MALIR,DISTRICT,55 - 59,WIDOWED,5976,4705,1271,0,3163,2451,712,0,2813,2254,559,0
MALIR,DISTRICT,60 - 64,DIVORCED,116,70,46,0,57,33,24,0,59,37,22,0
MALIR,DISTRICT,60 - 64,MARRIED,38425,14239,24186,0,19146,6999,12147,0,19279,7240,12039,0
MALIR,DISTRICT,60 - 64,NEVER MARRIED,661,239,418,4,297,96,200,1,364,143,218,3
MALIR,DISTRICT,60 - 64,SEPERATION,73,36,37,0,35,18,17,0,38,18,20,0
MALIR,DISTRICT,60 - 64,WIDOWED,6442,4944,1498,0,3154,2355,799,0,3288,2589,699,0
MALIR,DISTRICT,65 - 69,DIVORCED,69,40,29,0,38,21,17,0,31,19,12,0
MALIR,DISTRICT,65 - 69,MARRIED,24968,8624,16344,0,12332,4273,8059,0,12636,4351,8285,0
MALIR,DISTRICT,65 - 69,NEVER MARRIED,400,133,266,1,185,59,125,1,215,74,141,0
MALIR,DISTRICT,65 - 69,SEPERATION,38,17,21,0,20,10,10,0,18,7,11,0
MALIR,DISTRICT,65 - 69,WIDOWED,6039,4490,1549,0,2991,2190,801,0,3048,2300,748,0
MALIR,DISTRICT,70 - 74,DIVORCED,37,19,18,0,17,6,11,0,20,13,7,0
MALIR,DISTRICT,70 - 74,MARRIED,14875,4519,10356,0,7299,2248,5051,0,7576,2271,5305,0
MALIR,DISTRICT,70 - 74,NEVER MARRIED,200,71,129,0,106,40,66,0,94,31,63,0
MALIR,DISTRICT,70 - 74,SEPERATION,28,12,16,0,17,7,10,0,11,5,6,0
MALIR,DISTRICT,70 - 74,WIDOWED,5234,3870,1364,0,2540,1849,691,0,2694,2021,673,0
MALIR,DISTRICT,75 & ABOVE,DIVORCED,19,10,9,0,4,4,0,0,15,6,9,0
MALIR,DISTRICT,75 & ABOVE,MARRIED,9825,2849,6976,0,4715,1390,3325,0,5110,1459,3651,0
MALIR,DISTRICT,75 & ABOVE,NEVER MARRIED,142,52,88,2,69,26,42,1,73,26,46,1
MALIR,DISTRICT,75 & ABOVE,SEPERATION,19,8,11,0,13,6,7,0,6,2,4,0
MALIR,DISTRICT,75 & ABOVE,WIDOWED,5907,4145,1762,0,2870,2022,848,0,3037,2123,914,0
MATIARI,DISTRICT,15 &  ABOVE,DIVORCED,988,634,354,0,620,404,216,0,368,230,138,0
MATIARI,DISTRICT,15 &  ABOVE,MARRIED,324779,162929,161850,0,248051,124470,123581,0,76728,38459,38269,0
MATIARI,DISTRICT,15 &  ABOVE,NEVER MARRIED,138219,59239,78957,23,100273,42672,57594,7,37946,16567,21363,16
MATIARI,DISTRICT,15 &  ABOVE,SEPERATION,575,359,216,0,402,258,144,0,173,101,72,0
MATIARI,DISTRICT,15 &  ABOVE,WIDOWED,20332,15789,4543,0,14929,11709,3220,0,5403,4080,1323,0
MATIARI,DISTRICT,15 - 19,DIVORCED,24,18,6,0,15,11,4,0,9,7,2,0
MATIARI,DISTRICT,15 - 19,MARRIED,12215,8169,4046,0,10082,6667,3415,0,2133,1502,631,0
MATIARI,DISTRICT,15 - 19,NEVER MARRIED,71500,32561,38935,4,53498,24264,29233,1,18002,8297,9702,3
MATIARI,DISTRICT,15 - 19,SEPERATION,16,10,6,0,12,6,6,0,4,4,0,0
MATIARI,DISTRICT,15 - 19,WIDOWED,35,14,21,0,25,11,14,0,10,3,7,0
MATIARI,DISTRICT,20 - 24,DIVORCED,97,71,26,0,66,48,18,0,31,23,8,0
MATIARI,DISTRICT,20 - 24,MARRIED,36892,22567,14325,0,29453,17812,11641,0,7439,4755,2684,0
MATIARI,DISTRICT,20 - 24,NEVER MARRIED,32809,12618,20190,1,23233,8644,14588,1,9576,3974,5602,0
MATIARI,DISTRICT,20 - 24,SEPERATION,60,46,14,0,40,28,12,0,20,18,2,0
MATIARI,DISTRICT,20 - 24,WIDOWED,137,83,54,0,104,59,45,0,33,24,9,0
MATIARI,DISTRICT,25 - 29,DIVORCED,137,86,51,0,84,54,30,0,53,32,21,0
MATIARI,DISTRICT,25 - 29,MARRIED,45406,24045,21361,0,34966,18223,16743,0,10440,5822,4618,0
MATIARI,DISTRICT,25 - 29,NEVER MARRIED,16433,6686,9745,2,11515,4644,6869,2,4918,2042,2876,0
MATIARI,DISTRICT,25 - 29,SEPERATION,62,40,22,0,41,27,14,0,21,13,8,0
MATIARI,DISTRICT,25 - 29,WIDOWED,248,143,105,0,187,103,84,0,61,40,21,0
MATIARI,DISTRICT,30 - 34,DIVORCED,158,105,53,0,100,70,30,0,58,35,23,0
MATIARI,DISTRICT,30 - 34,MARRIED,45615,23837,21778,0,34713,18077,16636,0,10902,5760,5142,0
MATIARI,DISTRICT,30 - 34,NEVER MARRIED,7632,3165,4464,3,5328,2224,3103,1,2304,941,1361,2
MATIARI,DISTRICT,30 - 34,SEPERATION,65,45,20,0,44,29,15,0,21,16,5,0
MATIARI,DISTRICT,30 - 34,WIDOWED,438,316,122,0,315,234,81,0,123,82,41,0
MATIARI,DISTRICT,35 - 39,DIVORCED,149,92,57,0,96,60,36,0,53,32,21,0
MATIARI,DISTRICT,35 - 39,MARRIED,42899,21413,21486,0,32146,16042,16104,0,10753,5371,5382,0
MATIARI,DISTRICT,35 - 39,NEVER MARRIED,3952,1532,2420,0,2706,1060,1646,0,1246,472,774,0
MATIARI,DISTRICT,35 - 39,SEPERATION,77,49,28,0,57,39,18,0,20,10,10,0
MATIARI,DISTRICT,35 - 39,WIDOWED,704,518,186,0,525,394,131,0,179,124,55,0
MATIARI,DISTRICT,40 - 44,DIVORCED,148,96,52,0,88,54,34,0,60,42,18,0
MATIARI,DISTRICT,40 - 44,MARRIED,43347,20881,22466,0,32828,15884,16944,0,10519,4997,5522,0
MATIARI,DISTRICT,40 - 44,NEVER MARRIED,2411,1019,1387,5,1651,718,933,0,760,301,454,5
MATIARI,DISTRICT,40 - 44,SEPERATION,74,40,34,0,51,31,20,0,23,9,14,0
MATIARI,DISTRICT,40 - 44,WIDOWED,1363,1060,303,0,1051,823,228,0,312,237,75,0
MATIARI,DISTRICT,45 - 49,DIVORCED,99,59,40,0,63,39,24,0,36,20,16,0
MATIARI,DISTRICT,45 - 49,MARRIED,30545,14332,16213,0,22931,10897,12034,0,7614,3435,4179,0
MATIARI,DISTRICT,45 - 49,NEVER MARRIED,1416,623,790,3,947,421,525,1,469,202,265,2
MATIARI,DISTRICT,45 - 49,SEPERATION,59,32,27,0,37,21,16,0,22,11,11,0
MATIARI,DISTRICT,45 - 49,WIDOWED,1737,1424,313,0,1302,1066,236,0,435,358,77,0
MATIARI,DISTRICT,50 - 54,DIVORCED,79,52,27,0,48,34,14,0,31,18,13,0
MATIARI,DISTRICT,50 - 54,MARRIED,25111,11123,13988,0,18954,8421,10533,0,6157,2702,3455,0
MATIARI,DISTRICT,50 - 54,NEVER MARRIED,800,391,408,1,562,275,286,1,238,116,122,0
MATIARI,DISTRICT,50 - 54,SEPERATION,56,33,23,0,44,26,18,0,12,7,5,0
MATIARI,DISTRICT,50 - 54,WIDOWED,2537,2009,528,0,1876,1496,380,0,661,513,148,0
MATIARI,DISTRICT,55 - 59,DIVORCED,42,25,17,0,26,16,10,0,16,9,7,0
MATIARI,DISTRICT,55 - 59,MARRIED,16874,6708,10166,0,12547,4979,7568,0,4327,1729,2598,0
MATIARI,DISTRICT,55 - 59,NEVER MARRIED,539,280,258,1,358,189,169,0,181,91,89,1
MATIARI,DISTRICT,55 - 59,SEPERATION,42,22,20,0,28,16,12,0,14,6,8,0
MATIARI,DISTRICT,55 - 59,WIDOWED,2469,1923,546,0,1791,1400,391,0,678,523,155,0
MATIARI,DISTRICT,60 - 64,DIVORCED,24,14,10,0,15,8,7,0,9,6,3,0
MATIARI,DISTRICT,60 - 64,MARRIED,10609,4289,6320,0,7827,3231,4596,0,2782,1058,1724,0
MATIARI,DISTRICT,60 - 64,NEVER MARRIED,320,165,155,0,215,108,107,0,105,57,48,0
MATIARI,DISTRICT,60 - 64,SEPERATION,27,21,6,0,22,19,3,0,5,2,3,0
MATIARI,DISTRICT,60 - 64,WIDOWED,2677,2167,510,0,1883,1539,344,0,794,628,166,0
MATIARI,DISTRICT,65 - 69,DIVORCED,19,9,10,0,12,6,6,0,7,3,4,0
MATIARI,DISTRICT,65 - 69,MARRIED,7330,2815,4515,0,5483,2114,3369,0,1847,701,1146,0
MATIARI,DISTRICT,65 - 69,NEVER MARRIED,199,96,103,0,127,62,65,0,72,34,38,0
MATIARI,DISTRICT,65 - 69,SEPERATION,23,13,10,0,16,11,5,0,7,2,5,0
MATIARI,DISTRICT,65 - 69,WIDOWED,2687,2124,563,0,1933,1537,396,0,754,587,167,0
MATIARI,DISTRICT,70 - 74,DIVORCED,6,2,4,0,3,1,2,0,3,1,2,0
MATIARI,DISTRICT,70 - 74,MARRIED,4840,1769,3071,0,3711,1359,2352,0,1129,410,719,0
MATIARI,DISTRICT,70 - 74,NEVER MARRIED,127,61,65,1,80,39,41,0,47,22,24,1
MATIARI,DISTRICT,70 - 74,SEPERATION,7,5,2,0,5,3,2,0,2,2,0,0
MATIARI,DISTRICT,70 - 74,WIDOWED,2503,1891,612,0,1853,1439,414,0,650,452,198,0
MATIARI,DISTRICT,75 & ABOVE,DIVORCED,6,5,1,0,4,3,1,0,2,2,0,0
MATIARI,DISTRICT,75 & ABOVE,MARRIED,3096,981,2115,0,2410,764,1646,0,686,217,469,0
MATIARI,DISTRICT,75 & ABOVE,NEVER MARRIED,81,42,37,2,53,24,29,0,28,18,8,2
MATIARI,DISTRICT,75 & ABOVE,SEPERATION,7,3,4,0,5,2,3,0,2,1,1,0
MATIARI,DISTRICT,75 & ABOVE,WIDOWED,2797,2117,680,0,2084,1608,476,0,713,509,204,0
MIRPUR KHAS,DISTRICT,15 &  ABOVE,DIVORCED,2271,1455,816,0,968,608,360,0,1303,847,456,0
MIRPUR KHAS,DISTRICT,15 &  ABOVE,MARRIED,658872,329527,329345,0,468941,235066,233875,0,189931,94461,95470,0
MIRPUR KHAS,DISTRICT,15 &  ABOVE,NEVER MARRIED,241528,91309,150143,76,145735,53229,92489,17,95793,38080,57654,59
MIRPUR KHAS,DISTRICT,15 &  ABOVE,SEPERATION,948,507,441,0,591,306,285,0,357,201,156,0
MIRPUR KHAS,DISTRICT,15 &  ABOVE,WIDOWED,37009,28944,8065,0,23847,18679,5168,0,13162,10265,2897,0
MIRPUR KHAS,DISTRICT,15 - 19,DIVORCED,30,24,6,0,19,14,5,0,11,10,1,0
MIRPUR KHAS,DISTRICT,15 - 19,MARRIED,21718,14609,7109,0,18662,12388,6274,0,3056,2221,835,0
MIRPUR KHAS,DISTRICT,15 - 19,NEVER MARRIED,137890,57223,80660,7,93181,37564,55613,4,44709,19659,25047,3
MIRPUR KHAS,DISTRICT,15 - 19,SEPERATION,35,20,15,0,29,15,14,0,6,5,1,0
MIRPUR KHAS,DISTRICT,15 - 19,WIDOWED,35,13,22,0,30,10,20,0,5,3,2,0
MIRPUR KHAS,DISTRICT,20 - 24,DIVORCED,192,138,54,0,107,71,36,0,85,67,18,0
MIRPUR KHAS,DISTRICT,20 - 24,MARRIED,77588,46785,30803,0,63365,37261,26104,0,14223,9524,4699,0
MIRPUR KHAS,DISTRICT,20 - 24,NEVER MARRIED,58963,20522,38435,6,32290,9877,22413,0,26673,10645,16022,6
MIRPUR KHAS,DISTRICT,20 - 24,SEPERATION,83,48,35,0,53,31,22,0,30,17,13,0
MIRPUR KHAS,DISTRICT,20 - 24,WIDOWED,215,125,90,0,169,90,79,0,46,35,11,0
MIRPUR KHAS,DISTRICT,25 - 29,DIVORCED,307,186,121,0,157,84,73,0,150,102,48,0
MIRPUR KHAS,DISTRICT,25 - 29,MARRIED,93753,49283,44470,0,70324,35853,34471,0,23429,13430,9999,0
MIRPUR KHAS,DISTRICT,25 - 29,NEVER MARRIED,24407,7039,17358,10,11483,2913,8569,1,12924,4126,8789,9
MIRPUR KHAS,DISTRICT,25 - 29,SEPERATION,97,51,46,0,62,24,38,0,35,27,8,0
MIRPUR KHAS,DISTRICT,25 - 29,WIDOWED,396,240,156,0,287,173,114,0,109,67,42,0
MIRPUR KHAS,DISTRICT,30 - 34,DIVORCED,392,267,125,0,165,107,58,0,227,160,67,0
MIRPUR KHAS,DISTRICT,30 - 34,MARRIED,94127,48935,45192,0,66477,34297,32180,0,27650,14638,13012,0
MIRPUR KHAS,DISTRICT,30 - 34,NEVER MARRIED,9575,2798,6768,9,4110,1210,2897,3,5465,1588,3871,6
MIRPUR KHAS,DISTRICT,30 - 34,SEPERATION,133,78,55,0,92,52,40,0,41,26,15,0
MIRPUR KHAS,DISTRICT,30 - 34,WIDOWED,734,541,193,0,510,372,138,0,224,169,55,0
MIRPUR KHAS,DISTRICT,35 - 39,DIVORCED,383,260,123,0,164,114,50,0,219,146,73,0
MIRPUR KHAS,DISTRICT,35 - 39,MARRIED,90245,44614,45631,0,61749,30514,31235,0,28496,14100,14396,0
MIRPUR KHAS,DISTRICT,35 - 39,NEVER MARRIED,4553,1415,3129,9,1982,645,1336,1,2571,770,1793,8
MIRPUR KHAS,DISTRICT,35 - 39,SEPERATION,133,71,62,0,75,44,31,0,58,27,31,0
MIRPUR KHAS,DISTRICT,35 - 39,WIDOWED,1262,948,314,0,852,626,226,0,410,322,88,0
MIRPUR KHAS,DISTRICT,40 - 44,DIVORCED,324,213,111,0,132,87,45,0,192,126,66,0
MIRPUR KHAS,DISTRICT,40 - 44,MARRIED,82444,39623,42821,0,57199,27643,29556,0,25245,11980,13265,0
MIRPUR KHAS,DISTRICT,40 - 44,NEVER MARRIED,2490,860,1625,5,1104,383,721,0,1386,477,904,5
MIRPUR KHAS,DISTRICT,40 - 44,SEPERATION,112,62,50,0,73,41,32,0,39,21,18,0
MIRPUR KHAS,DISTRICT,40 - 44,WIDOWED,2038,1598,440,0,1425,1103,322,0,613,495,118,0
MIRPUR KHAS,DISTRICT,45 - 49,DIVORCED,231,146,85,0,81,52,29,0,150,94,56,0
MIRPUR KHAS,DISTRICT,45 - 49,MARRIED,60408,28243,32165,0,40027,18851,21176,0,20381,9392,10989,0
MIRPUR KHAS,DISTRICT,45 - 49,NEVER MARRIED,1484,538,937,9,630,230,398,2,854,308,539,7
MIRPUR KHAS,DISTRICT,45 - 49,SEPERATION,116,60,56,0,71,39,32,0,45,21,24,0
MIRPUR KHAS,DISTRICT,45 - 49,WIDOWED,2655,2145,510,0,1740,1398,342,0,915,747,168,0
MIRPUR KHAS,DISTRICT,50 - 54,DIVORCED,180,99,81,0,59,31,28,0,121,68,53,0
MIRPUR KHAS,DISTRICT,50 - 54,MARRIED,49547,22202,27345,0,32925,14867,18058,0,16622,7335,9287,0
MIRPUR KHAS,DISTRICT,50 - 54,NEVER MARRIED,850,339,504,7,358,147,209,2,492,192,295,5
MIRPUR KHAS,DISTRICT,50 - 54,SEPERATION,82,48,34,0,43,28,15,0,39,20,19,0
MIRPUR KHAS,DISTRICT,50 - 54,WIDOWED,4046,3270,776,0,2650,2140,510,0,1396,1130,266,0
MIRPUR KHAS,DISTRICT,55 - 59,DIVORCED,120,68,52,0,40,26,14,0,80,42,38,0
MIRPUR KHAS,DISTRICT,55 - 59,MARRIED,35151,14426,20725,0,22422,9263,13159,0,12729,5163,7566,0
MIRPUR KHAS,DISTRICT,55 - 59,NEVER MARRIED,575,227,343,5,238,91,146,1,337,136,197,4
MIRPUR KHAS,DISTRICT,55 - 59,SEPERATION,58,22,36,0,34,9,25,0,24,13,11,0
MIRPUR KHAS,DISTRICT,55 - 59,WIDOWED,4201,3291,910,0,2502,1957,545,0,1699,1334,365,0
MIRPUR KHAS,DISTRICT,60 - 64,DIVORCED,55,26,29,0,15,8,7,0,40,18,22,0
MIRPUR KHAS,DISTRICT,60 - 64,MARRIED,22173,9092,13081,0,14199,6054,8145,0,7974,3038,4936,0
MIRPUR KHAS,DISTRICT,60 - 64,NEVER MARRIED,342,151,185,6,148,71,76,1,194,80,109,5
MIRPUR KHAS,DISTRICT,60 - 64,SEPERATION,39,22,17,0,20,9,11,0,19,13,6,0
MIRPUR KHAS,DISTRICT,60 - 64,WIDOWED,4681,3695,986,0,2871,2269,602,0,1810,1426,384,0
MIRPUR KHAS,DISTRICT,65 - 69,DIVORCED,29,15,14,0,13,7,6,0,16,8,8,0
MIRPUR KHAS,DISTRICT,65 - 69,MARRIED,15171,6100,9071,0,9950,4070,5880,0,5221,2030,3191,0
MIRPUR KHAS,DISTRICT,65 - 69,NEVER MARRIED,196,100,94,2,100,50,48,2,96,50,46,0
MIRPUR KHAS,DISTRICT,65 - 69,SEPERATION,29,16,13,0,16,9,7,0,13,7,6,0
MIRPUR KHAS,DISTRICT,65 - 69,WIDOWED,5128,4039,1089,0,3176,2528,648,0,1952,1511,441,0
MIRPUR KHAS,DISTRICT,70 - 74,DIVORCED,13,7,6,0,8,3,5,0,5,4,1,0
MIRPUR KHAS,DISTRICT,70 - 74,MARRIED,9681,3570,6111,0,6737,2516,4221,0,2944,1054,1890,0
MIRPUR KHAS,DISTRICT,70 - 74,NEVER MARRIED,126,51,74,1,67,25,42,0,59,26,32,1
MIRPUR KHAS,DISTRICT,70 - 74,SEPERATION,14,5,9,0,9,2,7,0,5,3,2,0
MIRPUR KHAS,DISTRICT,70 - 74,WIDOWED,5048,3966,1082,0,3310,2640,670,0,1738,1326,412,0
MIRPUR KHAS,DISTRICT,75 & ABOVE,DIVORCED,15,6,9,0,8,4,4,0,7,2,5,0
MIRPUR KHAS,DISTRICT,75 & ABOVE,MARRIED,6866,2045,4821,0,4905,1489,3416,0,1961,556,1405,0
MIRPUR KHAS,DISTRICT,75 & ABOVE,NEVER MARRIED,77,46,31,0,44,23,21,0,33,23,10,0
MIRPUR KHAS,DISTRICT,75 & ABOVE,SEPERATION,17,4,13,0,14,3,11,0,3,1,2,0
MIRPUR KHAS,DISTRICT,75 & ABOVE,WIDOWED,6570,5073,1497,0,4325,3373,952,0,2245,1700,545,0
NAUSHAHRO FEROZE,DISTRICT,15 &  ABOVE,DIVORCED,1681,1147,534,0,968,660,308,0,713,487,226,0
NAUSHAHRO FEROZE,DISTRICT,15 &  ABOVE,MARRIED,665636,333656,331980,0,472694,237192,235502,0,192942,96464,96478,0
NAUSHAHRO FEROZE,DISTRICT,15 &  ABOVE,NEVER MARRIED,289178,123921,165187,70,195832,83290,112515,27,93346,40631,52672,43
NAUSHAHRO FEROZE,DISTRICT,15 &  ABOVE,SEPERATION,1217,657,560,0,865,460,405,0,352,197,155,0
NAUSHAHRO FEROZE,DISTRICT,15 &  ABOVE,WIDOWED,37081,28979,8102,0,25378,19758,5620,0,11703,9221,2482,0
NAUSHAHRO FEROZE,DISTRICT,15 - 19,DIVORCED,48,39,9,0,30,23,7,0,18,16,2,0
NAUSHAHRO FEROZE,DISTRICT,15 - 19,MARRIED,23324,16078,7246,0,17649,12087,5562,0,5675,3991,1684,0
NAUSHAHRO FEROZE,DISTRICT,15 - 19,NEVER MARRIED,154151,70424,83718,9,106360,48282,58071,7,47791,22142,25647,2
NAUSHAHRO FEROZE,DISTRICT,15 - 19,SEPERATION,56,27,29,0,42,17,25,0,14,10,4,0
NAUSHAHRO FEROZE,DISTRICT,15 - 19,WIDOWED,80,42,38,0,64,33,31,0,16,9,7,0
NAUSHAHRO FEROZE,DISTRICT,20 - 24,DIVORCED,151,111,40,0,84,57,27,0,67,54,13,0
NAUSHAHRO FEROZE,DISTRICT,20 - 24,MARRIED,75417,46816,28601,0,55305,34001,21304,0,20112,12815,7297,0
NAUSHAHRO FEROZE,DISTRICT,20 - 24,NEVER MARRIED,71574,27072,44493,9,47369,17318,30047,4,24205,9754,14446,5
NAUSHAHRO FEROZE,DISTRICT,20 - 24,SEPERATION,98,51,47,0,66,32,34,0,32,19,13,0
NAUSHAHRO FEROZE,DISTRICT,20 - 24,WIDOWED,232,147,85,0,160,97,63,0,72,50,22,0
NAUSHAHRO FEROZE,DISTRICT,25 - 29,DIVORCED,212,154,58,0,126,88,38,0,86,66,20,0
NAUSHAHRO FEROZE,DISTRICT,25 - 29,MARRIED,93084,49967,43117,0,65995,34985,31010,0,27089,14982,12107,0
NAUSHAHRO FEROZE,DISTRICT,25 - 29,NEVER MARRIED,32068,12428,19631,9,20939,7992,12943,4,11129,4436,6688,5
NAUSHAHRO FEROZE,DISTRICT,25 - 29,SEPERATION,138,64,74,0,94,45,49,0,44,19,25,0
NAUSHAHRO FEROZE,DISTRICT,25 - 29,WIDOWED,515,288,227,0,376,205,171,0,139,83,56,0
NAUSHAHRO FEROZE,DISTRICT,30 - 34,DIVORCED,287,191,96,0,162,108,54,0,125,83,42,0
NAUSHAHRO FEROZE,DISTRICT,30 - 34,MARRIED,95319,49384,45935,0,67216,34834,32382,0,28103,14550,13553,0
NAUSHAHRO FEROZE,DISTRICT,30 - 34,NEVER MARRIED,14003,6466,7530,7,9315,4370,4942,3,4688,2096,2588,4
NAUSHAHRO FEROZE,DISTRICT,30 - 34,SEPERATION,136,67,69,0,100,47,53,0,36,20,16,0
NAUSHAHRO FEROZE,DISTRICT,30 - 34,WIDOWED,827,591,236,0,575,404,171,0,252,187,65,0
NAUSHAHRO FEROZE,DISTRICT,35 - 39,DIVORCED,263,163,100,0,139,82,57,0,124,81,43,0
NAUSHAHRO FEROZE,DISTRICT,35 - 39,MARRIED,91540,44498,47042,0,63840,31016,32824,0,27700,13482,14218,0
NAUSHAHRO FEROZE,DISTRICT,35 - 39,NEVER MARRIED,7269,2848,4412,9,4889,1987,2901,1,2380,861,1511,8
NAUSHAHRO FEROZE,DISTRICT,35 - 39,SEPERATION,157,87,70,0,100,53,47,0,57,34,23,0
NAUSHAHRO FEROZE,DISTRICT,35 - 39,WIDOWED,1409,1012,397,0,987,701,286,0,422,311,111,0
NAUSHAHRO FEROZE,DISTRICT,40 - 44,DIVORCED,223,154,69,0,113,84,29,0,110,70,40,0
NAUSHAHRO FEROZE,DISTRICT,40 - 44,MARRIED,79026,37825,41201,0,55311,26554,28757,0,23715,11271,12444,0
NAUSHAHRO FEROZE,DISTRICT,40 - 44,NEVER MARRIED,4007,1680,2315,12,2708,1183,1521,4,1299,497,794,8
NAUSHAHRO FEROZE,DISTRICT,40 - 44,SEPERATION,126,72,54,0,90,55,35,0,36,17,19,0
NAUSHAHRO FEROZE,DISTRICT,40 - 44,WIDOWED,2258,1755,503,0,1586,1216,370,0,672,539,133,0
NAUSHAHRO FEROZE,DISTRICT,45 - 49,DIVORCED,171,126,45,0,103,77,26,0,68,49,19,0
NAUSHAHRO FEROZE,DISTRICT,45 - 49,MARRIED,59775,28191,31584,0,41289,19710,21579,0,18486,8481,10005,0
NAUSHAHRO FEROZE,DISTRICT,45 - 49,NEVER MARRIED,2358,1080,1275,3,1630,797,831,2,728,283,444,1
NAUSHAHRO FEROZE,DISTRICT,45 - 49,SEPERATION,128,84,44,0,93,61,32,0,35,23,12,0
NAUSHAHRO FEROZE,DISTRICT,45 - 49,WIDOWED,2988,2421,567,0,1974,1582,392,0,1014,839,175,0
NAUSHAHRO FEROZE,DISTRICT,50 - 54,DIVORCED,132,88,44,0,80,58,22,0,52,30,22,0
NAUSHAHRO FEROZE,DISTRICT,50 - 54,MARRIED,52713,23766,28947,0,37554,17193,20361,0,15159,6573,8586,0
NAUSHAHRO FEROZE,DISTRICT,50 - 54,NEVER MARRIED,1426,696,724,6,1015,500,514,1,411,196,210,5
NAUSHAHRO FEROZE,DISTRICT,50 - 54,SEPERATION,124,77,47,0,93,54,39,0,31,23,8,0
NAUSHAHRO FEROZE,DISTRICT,50 - 54,WIDOWED,4555,3778,777,0,3079,2526,553,0,1476,1252,224,0
NAUSHAHRO FEROZE,DISTRICT,55 - 59,DIVORCED,77,50,27,0,47,33,14,0,30,17,13,0
NAUSHAHRO FEROZE,DISTRICT,55 - 59,MARRIED,37677,15167,22510,0,26415,10685,15730,0,11262,4482,6780,0
NAUSHAHRO FEROZE,DISTRICT,55 - 59,NEVER MARRIED,997,505,492,0,703,368,335,0,294,137,157,0
NAUSHAHRO FEROZE,DISTRICT,55 - 59,SEPERATION,105,54,51,0,71,40,31,0,34,14,20,0
NAUSHAHRO FEROZE,DISTRICT,55 - 59,WIDOWED,4572,3642,930,0,3044,2420,624,0,1528,1222,306,0
NAUSHAHRO FEROZE,DISTRICT,60 - 64,DIVORCED,56,37,19,0,35,22,13,0,21,15,6,0
NAUSHAHRO FEROZE,DISTRICT,60 - 64,MARRIED,23489,9363,14126,0,16739,6723,10016,0,6750,2640,4110,0
NAUSHAHRO FEROZE,DISTRICT,60 - 64,NEVER MARRIED,576,303,271,2,390,212,178,0,186,91,93,2
NAUSHAHRO FEROZE,DISTRICT,60 - 64,SEPERATION,56,28,28,0,45,21,24,0,11,7,4,0
NAUSHAHRO FEROZE,DISTRICT,60 - 64,WIDOWED,4769,3797,972,0,3173,2512,661,0,1596,1285,311,0
NAUSHAHRO FEROZE,DISTRICT,65 - 69,DIVORCED,30,17,13,0,25,13,12,0,5,4,1,0
NAUSHAHRO FEROZE,DISTRICT,65 - 69,MARRIED,16109,6418,9691,0,11684,4710,6974,0,4425,1708,2717,0
NAUSHAHRO FEROZE,DISTRICT,65 - 69,NEVER MARRIED,371,203,168,0,273,151,122,0,98,52,46,0
NAUSHAHRO FEROZE,DISTRICT,65 - 69,SEPERATION,36,17,19,0,27,14,13,0,9,3,6,0
NAUSHAHRO FEROZE,DISTRICT,65 - 69,WIDOWED,4803,3796,1007,0,3252,2589,663,0,1551,1207,344,0
NAUSHAHRO FEROZE,DISTRICT,70 - 74,DIVORCED,15,8,7,0,13,8,5,0,2,0,2,0
NAUSHAHRO FEROZE,DISTRICT,70 - 74,MARRIED,10711,3854,6857,0,8022,2916,5106,0,2689,938,1751,0
NAUSHAHRO FEROZE,DISTRICT,70 - 74,NEVER MARRIED,227,132,93,2,143,83,59,1,84,49,34,1
NAUSHAHRO FEROZE,DISTRICT,70 - 74,SEPERATION,31,17,14,0,25,13,12,0,6,4,2,0
NAUSHAHRO FEROZE,DISTRICT,70 - 74,WIDOWED,4733,3713,1020,0,3282,2605,677,0,1451,1108,343,0
NAUSHAHRO FEROZE,DISTRICT,75 & ABOVE,DIVORCED,16,9,7,0,11,7,4,0,5,2,3,0
NAUSHAHRO FEROZE,DISTRICT,75 & ABOVE,MARRIED,7452,2329,5123,0,5675,1778,3897,0,1777,551,1226,0
NAUSHAHRO FEROZE,DISTRICT,75 & ABOVE,NEVER MARRIED,151,84,65,2,98,47,51,0,53,37,14,2
NAUSHAHRO FEROZE,DISTRICT,75 & ABOVE,SEPERATION,26,12,14,0,19,8,11,0,7,4,3,0
NAUSHAHRO FEROZE,DISTRICT,75 & ABOVE,WIDOWED,5340,3997,1343,0,3826,2868,958,0,1514,1129,385,0
SANGHAR,DISTRICT,15 &  ABOVE,DIVORCED,2217,1473,744,0,1028,691,337,0,1189,782,407,0
SANGHAR,DISTRICT,15 &  ABOVE,MARRIED,881055,441193,439862,0,638848,320508,318340,0,242207,120685,121522,0
SANGHAR,DISTRICT,15 &  ABOVE,NEVER MARRIED,353494,149203,204190,101,230713,95321,135366,26,122781,53882,68824,75
SANGHAR,DISTRICT,15 &  ABOVE,SEPERATION,1332,737,595,0,867,472,395,0,465,265,200,0
SANGHAR,DISTRICT,15 &  ABOVE,WIDOWED,50850,39288,11562,0,33618,26002,7616,0,17232,13286,3946,0
SANGHAR,DISTRICT,15 - 19,DIVORCED,53,39,14,0,32,23,9,0,21,16,5,0
SANGHAR,DISTRICT,15 - 19,MARRIED,32624,21861,10763,0,26961,17784,9177,0,5663,4077,1586,0
SANGHAR,DISTRICT,15 - 19,NEVER MARRIED,199169,90721,108430,18,137866,61513,76344,9,61303,29208,32086,9
SANGHAR,DISTRICT,15 - 19,SEPERATION,71,33,38,0,62,29,33,0,9,4,5,0
SANGHAR,DISTRICT,15 - 19,WIDOWED,94,44,50,0,78,40,38,0,16,4,12,0
SANGHAR,DISTRICT,20 - 24,DIVORCED,198,153,45,0,108,83,25,0,90,70,20,0
SANGHAR,DISTRICT,20 - 24,MARRIED,106071,63966,42105,0,83922,49503,34419,0,22149,14463,7686,0
SANGHAR,DISTRICT,20 - 24,NEVER MARRIED,88129,33152,54959,18,54013,19187,34824,2,34116,13965,20135,16
SANGHAR,DISTRICT,20 - 24,SEPERATION,105,52,53,0,75,32,43,0,30,20,10,0
SANGHAR,DISTRICT,20 - 24,WIDOWED,336,176,160,0,258,132,126,0,78,44,34,0
SANGHAR,DISTRICT,25 - 29,DIVORCED,301,189,112,0,133,73,60,0,168,116,52,0
SANGHAR,DISTRICT,25 - 29,MARRIED,121533,64127,57406,0,89266,46189,43077,0,32267,17938,14329,0
SANGHAR,DISTRICT,25 - 29,NEVER MARRIED,36145,13814,22325,6,21148,7866,13282,0,14997,5948,9043,6
SANGHAR,DISTRICT,25 - 29,SEPERATION,140,78,62,0,85,46,39,0,55,32,23,0
SANGHAR,DISTRICT,25 - 29,WIDOWED,573,335,238,0,397,228,169,0,176,107,69,0
SANGHAR,DISTRICT,30 - 34,DIVORCED,364,242,122,0,166,110,56,0,198,132,66,0
SANGHAR,DISTRICT,30 - 34,MARRIED,120037,61587,58450,0,84605,43257,41348,0,35432,18330,17102,0
SANGHAR,DISTRICT,30 - 34,NEVER MARRIED,14309,6101,8190,18,8395,3557,4832,6,5914,2544,3358,12
SANGHAR,DISTRICT,30 - 34,SEPERATION,141,89,52,0,80,48,32,0,61,41,20,0
SANGHAR,DISTRICT,30 - 34,WIDOWED,1028,669,359,0,691,457,234,0,337,212,125,0
SANGHAR,DISTRICT,35 - 39,DIVORCED,399,252,147,0,166,103,63,0,233,149,84,0
SANGHAR,DISTRICT,35 - 39,MARRIED,119482,58341,61141,0,83832,41155,42677,0,35650,17186,18464,0
SANGHAR,DISTRICT,35 - 39,NEVER MARRIED,7114,2381,4725,8,4146,1395,2749,2,2968,986,1976,6
SANGHAR,DISTRICT,35 - 39,SEPERATION,183,112,71,0,122,76,46,0,61,36,25,0
SANGHAR,DISTRICT,35 - 39,WIDOWED,1711,1185,526,0,1154,785,369,0,557,400,157,0
SANGHAR,DISTRICT,40 - 44,DIVORCED,331,223,108,0,156,113,43,0,175,110,65,0
SANGHAR,DISTRICT,40 - 44,MARRIED,118947,57793,61154,0,85493,41764,43729,0,33454,16029,17425,0
SANGHAR,DISTRICT,40 - 44,NEVER MARRIED,3840,1290,2538,12,2359,811,1546,2,1481,479,992,10
SANGHAR,DISTRICT,40 - 44,SEPERATION,182,100,82,0,122,71,51,0,60,29,31,0
SANGHAR,DISTRICT,40 - 44,WIDOWED,3408,2626,782,0,2390,1830,560,0,1018,796,222,0
SANGHAR,DISTRICT,45 - 49,DIVORCED,210,147,63,0,101,76,25,0,109,71,38,0
SANGHAR,DISTRICT,45 - 49,MARRIED,80992,38372,42620,0,56394,26999,29395,0,24598,11373,13225,0
SANGHAR,DISTRICT,45 - 49,NEVER MARRIED,1952,665,1278,9,1135,397,736,2,817,268,542,7
SANGHAR,DISTRICT,45 - 49,SEPERATION,162,92,70,0,98,58,40,0,64,34,30,0
SANGHAR,DISTRICT,45 - 49,WIDOWED,4121,3277,844,0,2722,2171,551,0,1399,1106,293,0
SANGHAR,DISTRICT,50 - 54,DIVORCED,141,93,48,0,64,47,17,0,77,46,31,0
SANGHAR,DISTRICT,50 - 54,MARRIED,66789,30170,36619,0,46806,21356,25450,0,19983,8814,11169,0
SANGHAR,DISTRICT,50 - 54,NEVER MARRIED,1131,403,724,4,666,231,434,1,465,172,290,3
SANGHAR,DISTRICT,50 - 54,SEPERATION,111,52,59,0,65,33,32,0,46,19,27,0
SANGHAR,DISTRICT,50 - 54,WIDOWED,6210,5047,1163,0,4060,3302,758,0,2150,1745,405,0
SANGHAR,DISTRICT,55 - 59,DIVORCED,114,73,41,0,49,29,20,0,65,44,21,0
SANGHAR,DISTRICT,55 - 59,MARRIED,45995,18625,27370,0,31714,12904,18810,0,14281,5721,8560,0
SANGHAR,DISTRICT,55 - 59,NEVER MARRIED,734,287,446,1,424,157,267,0,310,130,179,1
SANGHAR,DISTRICT,55 - 59,SEPERATION,84,39,45,0,53,22,31,0,31,17,14,0
SANGHAR,DISTRICT,55 - 59,WIDOWED,6159,4777,1382,0,3861,2990,871,0,2298,1787,511,0
SANGHAR,DISTRICT,60 - 64,DIVORCED,50,34,16,0,23,18,5,0,27,16,11,0
SANGHAR,DISTRICT,60 - 64,MARRIED,28251,11453,16798,0,19752,8257,11495,0,8499,3196,5303,0
SANGHAR,DISTRICT,60 - 64,NEVER MARRIED,431,166,261,4,271,94,176,1,160,72,85,3
SANGHAR,DISTRICT,60 - 64,SEPERATION,57,33,24,0,41,22,19,0,16,11,5,0
SANGHAR,DISTRICT,60 - 64,WIDOWED,6355,5008,1347,0,4113,3255,858,0,2242,1753,489,0
SANGHAR,DISTRICT,65 - 69,DIVORCED,29,14,15,0,16,8,8,0,13,6,7,0
SANGHAR,DISTRICT,65 - 69,MARRIED,18668,7483,11185,0,13292,5424,7868,0,5376,2059,3317,0
SANGHAR,DISTRICT,65 - 69,NEVER MARRIED,234,100,133,1,134,55,79,0,100,45,54,1
SANGHAR,DISTRICT,65 - 69,SEPERATION,52,33,19,0,34,20,14,0,18,13,5,0
SANGHAR,DISTRICT,65 - 69,WIDOWED,6592,5181,1411,0,4075,3224,851,0,2517,1957,560,0
SANGHAR,DISTRICT,70 - 74,DIVORCED,12,7,5,0,6,3,3,0,6,4,2,0
SANGHAR,DISTRICT,70 - 74,MARRIED,12845,4625,8220,0,9837,3652,6185,0,3008,973,2035,0
SANGHAR,DISTRICT,70 - 74,NEVER MARRIED,158,62,96,0,90,33,57,0,68,29,39,0
SANGHAR,DISTRICT,70 - 74,SEPERATION,17,11,6,0,12,7,5,0,5,4,1,0
SANGHAR,DISTRICT,70 - 74,WIDOWED,6666,5211,1455,0,4482,3538,944,0,2184,1673,511,0
SANGHAR,DISTRICT,75 & ABOVE,DIVORCED,15,7,8,0,8,5,3,0,7,2,5,0
SANGHAR,DISTRICT,75 & ABOVE,MARRIED,8821,2790,6031,0,6974,2264,4710,0,1847,526,1321,0
SANGHAR,DISTRICT,75 & ABOVE,NEVER MARRIED,148,61,85,2,66,25,40,1,82,36,45,1
SANGHAR,DISTRICT,75 & ABOVE,SEPERATION,27,13,14,0,18,8,10,0,9,5,4,0
SANGHAR,DISTRICT,75 & ABOVE,WIDOWED,7597,5752,1845,0,5337,4050,1287,0,2260,1702,558,0
SHAHEED BENAZIRABAD,DISTRICT,15 &  ABOVE,DIVORCED,1608,1091,517,0,753,510,243,0,855,581,274,0
SHAHEED BENAZIRABAD,DISTRICT,15 &  ABOVE,MARRIED,699067,351444,347623,0,478355,241172,237183,0,220712,110272,110440,0
SHAHEED BENAZIRABAD,DISTRICT,15 &  ABOVE,NEVER MARRIED,282444,118345,164035,64,174663,70840,103806,17,107781,47505,60229,47
SHAHEED BENAZIRABAD,DISTRICT,15 &  ABOVE,SEPERATION,1086,663,423,0,699,446,253,0,387,217,170,0
SHAHEED BENAZIRABAD,DISTRICT,15 &  ABOVE,WIDOWED,39725,31080,8645,0,25869,20210,5659,0,13856,10870,2986,0
SHAHEED BENAZIRABAD,DISTRICT,15 - 19,DIVORCED,44,28,16,0,20,11,9,0,24,17,7,0
SHAHEED BENAZIRABAD,DISTRICT,15 - 19,MARRIED,26391,17998,8393,0,20361,13738,6623,0,6030,4260,1770,0
SHAHEED BENAZIRABAD,DISTRICT,15 - 19,NEVER MARRIED,155414,70289,85119,6,102056,45288,56765,3,53358,25001,28354,3
SHAHEED BENAZIRABAD,DISTRICT,15 - 19,SEPERATION,55,29,26,0,38,20,18,0,17,9,8,0
SHAHEED BENAZIRABAD,DISTRICT,15 - 19,WIDOWED,72,30,42,0,57,22,35,0,15,8,7,0
SHAHEED BENAZIRABAD,DISTRICT,20 - 24,DIVORCED,172,115,57,0,100,63,37,0,72,52,20,0
SHAHEED BENAZIRABAD,DISTRICT,20 - 24,MARRIED,80823,49954,30869,0,59334,36030,23304,0,21489,13924,7565,0
SHAHEED BENAZIRABAD,DISTRICT,20 - 24,NEVER MARRIED,71127,26580,44539,8,40245,13593,26650,2,30882,12987,17889,6
SHAHEED BENAZIRABAD,DISTRICT,20 - 24,SEPERATION,85,48,37,0,58,36,22,0,27,12,15,0
SHAHEED BENAZIRABAD,DISTRICT,20 - 24,WIDOWED,272,160,112,0,200,112,88,0,72,48,24,0
SHAHEED BENAZIRABAD,DISTRICT,25 - 29,DIVORCED,207,147,60,0,102,72,30,0,105,75,30,0
SHAHEED BENAZIRABAD,DISTRICT,25 - 29,MARRIED,90640,47781,42859,0,62112,32160,29952,0,28528,15621,12907,0
SHAHEED BENAZIRABAD,DISTRICT,25 - 29,NEVER MARRIED,28852,11263,17584,5,16265,6005,10259,1,12587,5258,7325,4
SHAHEED BENAZIRABAD,DISTRICT,25 - 29,SEPERATION,96,58,38,0,58,32,26,0,38,26,12,0
SHAHEED BENAZIRABAD,DISTRICT,25 - 29,WIDOWED,450,261,189,0,310,173,137,0,140,88,52,0
SHAHEED BENAZIRABAD,DISTRICT,30 - 34,DIVORCED,245,160,85,0,102,72,30,0,143,88,55,0
SHAHEED BENAZIRABAD,DISTRICT,30 - 34,MARRIED,95435,50160,45275,0,63564,33445,30119,0,31871,16715,15156,0
SHAHEED BENAZIRABAD,DISTRICT,30 - 34,NEVER MARRIED,12296,4861,7420,15,7070,2761,4305,4,5226,2100,3115,11
SHAHEED BENAZIRABAD,DISTRICT,30 - 34,SEPERATION,136,81,55,0,88,51,37,0,48,30,18,0
SHAHEED BENAZIRABAD,DISTRICT,30 - 34,WIDOWED,917,600,317,0,605,394,211,0,312,206,106,0
SHAHEED BENAZIRABAD,DISTRICT,35 - 39,DIVORCED,282,185,97,0,120,78,42,0,162,107,55,0
SHAHEED BENAZIRABAD,DISTRICT,35 - 39,MARRIED,98135,48297,49838,0,65225,32217,33008,0,32910,16080,16830,0
SHAHEED BENAZIRABAD,DISTRICT,35 - 39,NEVER MARRIED,6537,2202,4330,5,3924,1289,2633,2,2613,913,1697,3
SHAHEED BENAZIRABAD,DISTRICT,35 - 39,SEPERATION,142,92,50,0,95,63,32,0,47,29,18,0
SHAHEED BENAZIRABAD,DISTRICT,35 - 39,WIDOWED,1488,1066,422,0,985,696,289,0,503,370,133,0
SHAHEED BENAZIRABAD,DISTRICT,40 - 44,DIVORCED,239,162,77,0,112,76,36,0,127,86,41,0
SHAHEED BENAZIRABAD,DISTRICT,40 - 44,MARRIED,87360,41528,45832,0,58910,27979,30931,0,28450,13549,14901,0
SHAHEED BENAZIRABAD,DISTRICT,40 - 44,NEVER MARRIED,3341,1161,2173,7,2093,729,1363,1,1248,432,810,6
SHAHEED BENAZIRABAD,DISTRICT,40 - 44,SEPERATION,128,89,39,0,78,54,24,0,50,35,15,0
SHAHEED BENAZIRABAD,DISTRICT,40 - 44,WIDOWED,2445,1870,575,0,1617,1198,419,0,828,672,156,0
SHAHEED BENAZIRABAD,DISTRICT,45 - 49,DIVORCED,184,128,56,0,89,64,25,0,95,64,31,0
SHAHEED BENAZIRABAD,DISTRICT,45 - 49,MARRIED,66499,31768,34731,0,44023,21347,22676,0,22476,10421,12055,0
SHAHEED BENAZIRABAD,DISTRICT,45 - 49,NEVER MARRIED,2003,746,1251,6,1210,431,777,2,793,315,474,4
SHAHEED BENAZIRABAD,DISTRICT,45 - 49,SEPERATION,125,78,47,0,70,48,22,0,55,30,25,0
SHAHEED BENAZIRABAD,DISTRICT,45 - 49,WIDOWED,3366,2720,646,0,2198,1772,426,0,1168,948,220,0
SHAHEED BENAZIRABAD,DISTRICT,50 - 54,DIVORCED,101,75,26,0,50,34,16,0,51,41,10,0
SHAHEED BENAZIRABAD,DISTRICT,50 - 54,MARRIED,55517,25038,30479,0,37815,17308,20507,0,17702,7730,9972,0
SHAHEED BENAZIRABAD,DISTRICT,50 - 54,NEVER MARRIED,1148,506,638,4,706,311,395,0,442,195,243,4
SHAHEED BENAZIRABAD,DISTRICT,50 - 54,SEPERATION,93,52,41,0,57,37,20,0,36,15,21,0
SHAHEED BENAZIRABAD,DISTRICT,50 - 54,WIDOWED,4761,3922,839,0,3114,2547,567,0,1647,1375,272,0
SHAHEED BENAZIRABAD,DISTRICT,55 - 59,DIVORCED,55,34,21,0,25,16,9,0,30,18,12,0
SHAHEED BENAZIRABAD,DISTRICT,55 - 59,MARRIED,38141,15627,22514,0,25128,10396,14732,0,13013,5231,7782,0
SHAHEED BENAZIRABAD,DISTRICT,55 - 59,NEVER MARRIED,728,286,439,3,458,163,293,2,270,123,146,1
SHAHEED BENAZIRABAD,DISTRICT,55 - 59,SEPERATION,77,50,27,0,51,40,11,0,26,10,16,0
SHAHEED BENAZIRABAD,DISTRICT,55 - 59,WIDOWED,4615,3627,988,0,2853,2209,644,0,1762,1418,344,0
SHAHEED BENAZIRABAD,DISTRICT,60 - 64,DIVORCED,29,22,7,0,8,7,1,0,21,15,6,0
SHAHEED BENAZIRABAD,DISTRICT,60 - 64,MARRIED,24611,10089,14522,0,16662,7014,9648,0,7949,3075,4874,0
SHAHEED BENAZIRABAD,DISTRICT,60 - 64,NEVER MARRIED,453,199,251,3,281,113,168,0,172,86,83,3
SHAHEED BENAZIRABAD,DISTRICT,60 - 64,SEPERATION,73,47,26,0,49,32,17,0,24,15,9,0
SHAHEED BENAZIRABAD,DISTRICT,60 - 64,WIDOWED,5035,4093,942,0,3273,2677,596,0,1762,1416,346,0
SHAHEED BENAZIRABAD,DISTRICT,65 - 69,DIVORCED,23,17,6,0,12,7,5,0,11,10,1,0
SHAHEED BENAZIRABAD,DISTRICT,65 - 69,MARRIED,16435,6563,9872,0,11315,4617,6698,0,5120,1946,3174,0
SHAHEED BENAZIRABAD,DISTRICT,65 - 69,NEVER MARRIED,251,117,134,0,165,77,88,0,86,40,46,0
SHAHEED BENAZIRABAD,DISTRICT,65 - 69,SEPERATION,30,20,10,0,24,17,7,0,6,3,3,0
SHAHEED BENAZIRABAD,DISTRICT,65 - 69,WIDOWED,5075,4036,1039,0,3198,2571,627,0,1877,1465,412,0
SHAHEED BENAZIRABAD,DISTRICT,70 - 74,DIVORCED,15,9,6,0,6,5,1,0,9,4,5,0
SHAHEED BENAZIRABAD,DISTRICT,70 - 74,MARRIED,11079,4064,7015,0,7974,2996,4978,0,3105,1068,2037,0
SHAHEED BENAZIRABAD,DISTRICT,70 - 74,NEVER MARRIED,165,70,94,1,99,38,61,0,66,32,33,1
SHAHEED BENAZIRABAD,DISTRICT,70 - 74,SEPERATION,27,13,14,0,20,11,9,0,7,2,5,0
SHAHEED BENAZIRABAD,DISTRICT,70 - 74,WIDOWED,5237,4151,1086,0,3469,2773,696,0,1768,1378,390,0
SHAHEED BENAZIRABAD,DISTRICT,75 & ABOVE,DIVORCED,12,9,3,0,7,5,2,0,5,4,1,0
SHAHEED BENAZIRABAD,DISTRICT,75 & ABOVE,MARRIED,8001,2577,5424,0,5932,1925,4007,0,2069,652,1417,0
SHAHEED BENAZIRABAD,DISTRICT,75 & ABOVE,NEVER MARRIED,129,65,63,1,91,42,49,0,38,23,14,1
SHAHEED BENAZIRABAD,DISTRICT,75 & ABOVE,SEPERATION,19,6,13,0,13,5,8,0,6,1,5,0
SHAHEED BENAZIRABAD,DISTRICT,75 & ABOVE,WIDOWED,5992,4544,1448,0,3990,3066,924,0,2002,1478,524,0
SHIKARPUR,DISTRICT,15 &  ABOVE,DIVORCED,638,419,219,0,346,235,111,0,292,184,108,0
SHIKARPUR,DISTRICT,15 &  ABOVE,MARRIED,460857,235055,225802,0,347289,178034,169255,0,113568,57021,56547,0
SHIKARPUR,DISTRICT,15 &  ABOVE,NEVER MARRIED,202222,86794,115387,41,141645,59306,82316,23,60577,27488,33071,18
SHIKARPUR,DISTRICT,15 &  ABOVE,SEPERATION,483,250,233,0,355,183,172,0,128,67,61,0
SHIKARPUR,DISTRICT,15 &  ABOVE,WIDOWED,23190,18847,4343,0,16194,13127,3067,0,6996,5720,1276,0
SHIKARPUR,DISTRICT,15 - 19,DIVORCED,15,11,4,0,11,7,4,0,4,4,0,0
SHIKARPUR,DISTRICT,15 - 19,MARRIED,18207,11964,6243,0,15171,9830,5341,0,3036,2134,902,0
SHIKARPUR,DISTRICT,15 - 19,NEVER MARRIED,124013,56958,67042,13,93824,42083,51731,10,30189,14875,15311,3
SHIKARPUR,DISTRICT,15 - 19,SEPERATION,64,10,54,0,55,9,46,0,9,1,8,0
SHIKARPUR,DISTRICT,15 - 19,WIDOWED,54,27,27,0,46,22,24,0,8,5,3,0
SHIKARPUR,DISTRICT,20 - 24,DIVORCED,53,40,13,0,31,22,9,0,22,18,4,0
SHIKARPUR,DISTRICT,20 - 24,MARRIED,52677,32145,20532,0,42316,25388,16928,0,10361,6757,3604,0
SHIKARPUR,DISTRICT,20 - 24,NEVER MARRIED,44713,16790,27915,8,29332,10317,19010,5,15381,6473,8905,3
SHIKARPUR,DISTRICT,20 - 24,SEPERATION,48,24,24,0,39,18,21,0,9,6,3,0
SHIKARPUR,DISTRICT,20 - 24,WIDOWED,165,94,71,0,137,77,60,0,28,17,11,0
SHIKARPUR,DISTRICT,25 - 29,DIVORCED,94,59,35,0,62,39,23,0,32,20,12,0
SHIKARPUR,DISTRICT,25 - 29,MARRIED,63038,33748,29290,0,48068,25427,22641,0,14970,8321,6649,0
SHIKARPUR,DISTRICT,25 - 29,NEVER MARRIED,18174,7186,10981,7,10570,3992,6574,4,7604,3194,4407,3
SHIKARPUR,DISTRICT,25 - 29,SEPERATION,54,24,30,0,39,17,22,0,15,7,8,0
SHIKARPUR,DISTRICT,25 - 29,WIDOWED,299,190,109,0,228,147,81,0,71,43,28,0
SHIKARPUR,DISTRICT,30 - 34,DIVORCED,118,80,38,0,64,43,21,0,54,37,17,0
SHIKARPUR,DISTRICT,30 - 34,MARRIED,62677,33409,29268,0,46624,24915,21709,0,16053,8494,7559,0
SHIKARPUR,DISTRICT,30 - 34,NEVER MARRIED,7013,2724,4289,0,3711,1422,2289,0,3302,1302,2000,0
SHIKARPUR,DISTRICT,30 - 34,SEPERATION,47,30,17,0,33,20,13,0,14,10,4,0
SHIKARPUR,DISTRICT,30 - 34,WIDOWED,484,330,154,0,380,258,122,0,104,72,32,0
SHIKARPUR,DISTRICT,35 - 39,DIVORCED,100,67,33,0,51,35,16,0,49,32,17,0
SHIKARPUR,DISTRICT,35 - 39,MARRIED,65124,32912,32212,0,48500,24757,23743,0,16624,8155,8469,0
SHIKARPUR,DISTRICT,35 - 39,NEVER MARRIED,3707,1374,2328,5,1884,688,1196,0,1823,686,1132,5
SHIKARPUR,DISTRICT,35 - 39,SEPERATION,75,39,36,0,55,26,29,0,20,13,7,0
SHIKARPUR,DISTRICT,35 - 39,WIDOWED,926,703,223,0,697,535,162,0,229,168,61,0
SHIKARPUR,DISTRICT,40 - 44,DIVORCED,93,63,30,0,47,36,11,0,46,27,19,0
SHIKARPUR,DISTRICT,40 - 44,MARRIED,59231,29226,30005,0,44401,22111,22290,0,14830,7115,7715,0
SHIKARPUR,DISTRICT,40 - 44,NEVER MARRIED,1887,665,1217,5,963,324,637,2,924,341,580,3
SHIKARPUR,DISTRICT,40 - 44,SEPERATION,46,33,13,0,35,27,8,0,11,6,5,0
SHIKARPUR,DISTRICT,40 - 44,WIDOWED,1547,1268,279,0,1149,928,221,0,398,340,58,0
SHIKARPUR,DISTRICT,45 - 49,DIVORCED,61,40,21,0,29,23,6,0,32,17,15,0
SHIKARPUR,DISTRICT,45 - 49,MARRIED,43725,21215,22510,0,32095,15769,16326,0,11630,5446,6184,0
SHIKARPUR,DISTRICT,45 - 49,NEVER MARRIED,1159,402,757,0,614,188,426,0,545,214,331,0
SHIKARPUR,DISTRICT,45 - 49,SEPERATION,50,32,18,0,34,25,9,0,16,7,9,0
SHIKARPUR,DISTRICT,45 - 49,WIDOWED,1931,1611,320,0,1376,1149,227,0,555,462,93,0
SHIKARPUR,DISTRICT,50 - 54,DIVORCED,41,23,18,0,20,12,8,0,21,11,10,0
SHIKARPUR,DISTRICT,50 - 54,MARRIED,33709,15621,18088,0,24613,11542,13071,0,9096,4079,5017,0
SHIKARPUR,DISTRICT,50 - 54,NEVER MARRIED,629,259,369,1,316,115,201,0,313,144,168,1
SHIKARPUR,DISTRICT,50 - 54,SEPERATION,30,18,12,0,19,12,7,0,11,6,5,0
SHIKARPUR,DISTRICT,50 - 54,WIDOWED,2695,2287,408,0,1862,1576,286,0,833,711,122,0
SHIKARPUR,DISTRICT,55 - 59,DIVORCED,27,14,13,0,11,4,7,0,16,10,6,0
SHIKARPUR,DISTRICT,55 - 59,MARRIED,24824,10573,14251,0,17793,7760,10033,0,7031,2813,4218,0
SHIKARPUR,DISTRICT,55 - 59,NEVER MARRIED,362,162,200,0,160,68,92,0,202,94,108,0
SHIKARPUR,DISTRICT,55 - 59,SEPERATION,20,13,7,0,14,9,5,0,6,4,2,0
SHIKARPUR,DISTRICT,55 - 59,WIDOWED,2810,2329,481,0,1915,1588,327,0,895,741,154,0
SHIKARPUR,DISTRICT,60 - 64,DIVORCED,15,9,6,0,8,5,3,0,7,4,3,0
SHIKARPUR,DISTRICT,60 - 64,MARRIED,16335,6704,9631,0,11907,4926,6981,0,4428,1778,2650,0
SHIKARPUR,DISTRICT,60 - 64,NEVER MARRIED,262,128,132,2,121,53,66,2,141,75,66,0
SHIKARPUR,DISTRICT,60 - 64,SEPERATION,22,12,10,0,14,10,4,0,8,2,6,0
SHIKARPUR,DISTRICT,60 - 64,WIDOWED,3351,2815,536,0,2320,1949,371,0,1031,866,165,0
SHIKARPUR,DISTRICT,65 - 69,DIVORCED,7,3,4,0,4,2,2,0,3,1,2,0
SHIKARPUR,DISTRICT,65 - 69,MARRIED,10178,3906,6272,0,7354,2863,4491,0,2824,1043,1781,0
SHIKARPUR,DISTRICT,65 - 69,NEVER MARRIED,144,77,67,0,56,24,32,0,88,53,35,0
SHIKARPUR,DISTRICT,65 - 69,SEPERATION,11,5,6,0,9,4,5,0,2,1,1,0
SHIKARPUR,DISTRICT,65 - 69,WIDOWED,2907,2385,522,0,1911,1566,345,0,996,819,177,0
SHIKARPUR,DISTRICT,70 - 74,DIVORCED,6,4,2,0,3,2,1,0,3,2,1,0
SHIKARPUR,DISTRICT,70 - 74,MARRIED,6607,2305,4302,0,4936,1736,3200,0,1671,569,1102,0
SHIKARPUR,DISTRICT,70 - 74,NEVER MARRIED,86,39,47,0,49,19,30,0,37,20,17,0
SHIKARPUR,DISTRICT,70 - 74,SEPERATION,10,7,3,0,6,4,2,0,4,3,1,0
SHIKARPUR,DISTRICT,70 - 74,WIDOWED,2840,2289,551,0,1950,1564,386,0,890,725,165,0
SHIKARPUR,DISTRICT,75 & ABOVE,DIVORCED,8,6,2,0,5,5,0,0,3,1,2,0
SHIKARPUR,DISTRICT,75 & ABOVE,MARRIED,4525,1327,3198,0,3511,1010,2501,0,1014,317,697,0
SHIKARPUR,DISTRICT,75 & ABOVE,NEVER MARRIED,73,30,43,0,45,13,32,0,28,17,11,0
SHIKARPUR,DISTRICT,75 & ABOVE,SEPERATION,6,3,3,0,3,2,1,0,3,1,2,0
SHIKARPUR,DISTRICT,75 & ABOVE,WIDOWED,3181,2519,662,0,2223,1768,455,0,958,751,207,0
SUJAWAL,DISTRICT,15 &  ABOVE,DIVORCED,505,365,140,0,356,271,85,0,149,94,55,0
SUJAWAL,DISTRICT,15 &  ABOVE,MARRIED,316332,158531,157801,0,282030,141400,140630,0,34302,17131,17171,0
SUJAWAL,DISTRICT,15 &  ABOVE,NEVER MARRIED,118127,45590,72508,29,100830,38503,62314,13,17297,7087,10194,16
SUJAWAL,DISTRICT,15 &  ABOVE,SEPERATION,459,269,190,0,411,234,177,0,48,35,13,0
SUJAWAL,DISTRICT,15 &  ABOVE,WIDOWED,14891,11210,3681,0,12814,9554,3260,0,2077,1656,421,0
SUJAWAL,DISTRICT,15 - 19,DIVORCED,15,13,2,0,13,12,1,0,2,1,1,0
SUJAWAL,DISTRICT,15 - 19,MARRIED,9997,6963,3034,0,9208,6367,2841,0,789,596,193,0
SUJAWAL,DISTRICT,15 - 19,NEVER MARRIED,66268,28366,37901,1,58463,24786,33676,1,7805,3580,4225,0
SUJAWAL,DISTRICT,15 - 19,SEPERATION,26,11,15,0,24,9,15,0,2,2,0,0
SUJAWAL,DISTRICT,15 - 19,WIDOWED,29,17,12,0,29,17,12,0,0,0,0,0
SUJAWAL,DISTRICT,20 - 24,DIVORCED,57,46,11,0,45,37,8,0,12,9,3,0
SUJAWAL,DISTRICT,20 - 24,MARRIED,34466,21516,12950,0,31551,19594,11957,0,2915,1922,993,0
SUJAWAL,DISTRICT,20 - 24,NEVER MARRIED,27378,9494,17879,5,23035,7807,15226,2,4343,1687,2653,3
SUJAWAL,DISTRICT,20 - 24,SEPERATION,34,25,9,0,33,24,9,0,1,1,0,0
SUJAWAL,DISTRICT,20 - 24,WIDOWED,110,63,47,0,95,55,40,0,15,8,7,0
SUJAWAL,DISTRICT,25 - 29,DIVORCED,54,41,13,0,42,32,10,0,12,9,3,0
SUJAWAL,DISTRICT,25 - 29,MARRIED,43846,23413,20433,0,39440,20903,18537,0,4406,2510,1896,0
SUJAWAL,DISTRICT,25 - 29,NEVER MARRIED,12560,3692,8866,2,10071,2867,7203,1,2489,825,1663,1
SUJAWAL,DISTRICT,25 - 29,SEPERATION,41,21,20,0,38,18,20,0,3,3,0,0
SUJAWAL,DISTRICT,25 - 29,WIDOWED,193,122,71,0,162,98,64,0,31,24,7,0
SUJAWAL,DISTRICT,30 - 34,DIVORCED,78,49,29,0,53,33,20,0,25,16,9,0
SUJAWAL,DISTRICT,30 - 34,MARRIED,43367,22616,20751,0,38745,20162,18583,0,4622,2454,2168,0
SUJAWAL,DISTRICT,30 - 34,NEVER MARRIED,5463,1810,3649,4,4277,1390,2885,2,1186,420,764,2
SUJAWAL,DISTRICT,30 - 34,SEPERATION,51,31,20,0,43,26,17,0,8,5,3,0
SUJAWAL,DISTRICT,30 - 34,WIDOWED,299,190,109,0,277,176,101,0,22,14,8,0
SUJAWAL,DISTRICT,35 - 39,DIVORCED,72,54,18,0,47,38,9,0,25,16,9,0
SUJAWAL,DISTRICT,35 - 39,MARRIED,41950,21136,20814,0,36867,18565,18302,0,5083,2571,2512,0
SUJAWAL,DISTRICT,35 - 39,NEVER MARRIED,2775,970,1805,0,2110,720,1390,0,665,250,415,0
SUJAWAL,DISTRICT,35 - 39,SEPERATION,53,42,11,0,50,39,11,0,3,3,0,0
SUJAWAL,DISTRICT,35 - 39,WIDOWED,547,363,184,0,466,303,163,0,81,60,21,0
SUJAWAL,DISTRICT,40 - 44,DIVORCED,72,50,22,0,50,39,11,0,22,11,11,0
SUJAWAL,DISTRICT,40 - 44,MARRIED,38886,18199,20687,0,34465,16147,18318,0,4421,2052,2369,0
SUJAWAL,DISTRICT,40 - 44,NEVER MARRIED,1539,500,1037,2,1196,376,819,1,343,124,218,1
SUJAWAL,DISTRICT,40 - 44,SEPERATION,60,40,20,0,55,37,18,0,5,3,2,0
SUJAWAL,DISTRICT,40 - 44,WIDOWED,842,564,278,0,734,479,255,0,108,85,23,0
SUJAWAL,DISTRICT,45 - 49,DIVORCED,56,43,13,0,39,31,8,0,17,12,5,0
SUJAWAL,DISTRICT,45 - 49,MARRIED,30492,14442,16050,0,26836,12811,14025,0,3656,1631,2025,0
SUJAWAL,DISTRICT,45 - 49,NEVER MARRIED,887,303,581,3,689,220,466,3,198,83,115,0
SUJAWAL,DISTRICT,45 - 49,SEPERATION,48,30,18,0,41,24,17,0,7,6,1,0
SUJAWAL,DISTRICT,45 - 49,WIDOWED,1084,810,274,0,909,670,239,0,175,140,35,0
SUJAWAL,DISTRICT,50 - 54,DIVORCED,43,27,16,0,21,14,7,0,22,13,9,0
SUJAWAL,DISTRICT,50 - 54,MARRIED,25757,11320,14437,0,22781,10046,12735,0,2976,1274,1702,0
SUJAWAL,DISTRICT,50 - 54,NEVER MARRIED,506,183,320,3,402,138,264,0,104,45,56,3
SUJAWAL,DISTRICT,50 - 54,SEPERATION,43,21,22,0,38,18,20,0,5,3,2,0
SUJAWAL,DISTRICT,50 - 54,WIDOWED,1569,1179,390,0,1351,1000,351,0,218,179,39,0
SUJAWAL,DISTRICT,55 - 59,DIVORCED,28,21,7,0,21,17,4,0,7,4,3,0
SUJAWAL,DISTRICT,55 - 59,MARRIED,17626,7290,10336,0,15527,6436,9091,0,2099,854,1245,0
SUJAWAL,DISTRICT,55 - 59,NEVER MARRIED,329,116,210,3,253,88,162,3,76,28,48,0
SUJAWAL,DISTRICT,55 - 59,SEPERATION,32,17,15,0,26,13,13,0,6,4,2,0
SUJAWAL,DISTRICT,55 - 59,WIDOWED,1661,1269,392,0,1406,1063,343,0,255,206,49,0
SUJAWAL,DISTRICT,60 - 64,DIVORCED,7,7,0,0,6,6,0,0,1,1,0,0
SUJAWAL,DISTRICT,60 - 64,MARRIED,11706,4913,6793,0,10270,4335,5935,0,1436,578,858,0
SUJAWAL,DISTRICT,60 - 64,NEVER MARRIED,186,72,111,3,143,47,96,0,43,25,15,3
SUJAWAL,DISTRICT,60 - 64,SEPERATION,25,11,14,0,20,9,11,0,5,2,3,0
SUJAWAL,DISTRICT,60 - 64,WIDOWED,1961,1547,414,0,1684,1314,370,0,277,233,44,0
SUJAWAL,DISTRICT,65 - 69,DIVORCED,12,6,6,0,9,5,4,0,3,1,2,0
SUJAWAL,DISTRICT,65 - 69,MARRIED,7987,3265,4722,0,7060,2899,4161,0,927,366,561,0
SUJAWAL,DISTRICT,65 - 69,NEVER MARRIED,110,38,70,2,90,31,59,0,20,7,11,2
SUJAWAL,DISTRICT,65 - 69,SEPERATION,16,8,8,0,14,6,8,0,2,2,0,0
SUJAWAL,DISTRICT,65 - 69,WIDOWED,1912,1470,442,0,1622,1238,384,0,290,232,58,0
SUJAWAL,DISTRICT,70 - 74,DIVORCED,9,7,2,0,8,6,2,0,1,1,0,0
SUJAWAL,DISTRICT,70 - 74,MARRIED,5709,1983,3726,0,5092,1776,3316,0,617,207,410,0
SUJAWAL,DISTRICT,70 - 74,NEVER MARRIED,67,26,41,0,56,20,36,0,11,6,5,0
SUJAWAL,DISTRICT,70 - 74,SEPERATION,18,10,8,0,17,9,8,0,1,1,0,0
SUJAWAL,DISTRICT,70 - 74,WIDOWED,2054,1595,459,0,1763,1359,404,0,291,236,55,0
SUJAWAL,DISTRICT,75 & ABOVE,DIVORCED,2,1,1,0,2,1,1,0,0,0,0,0
SUJAWAL,DISTRICT,75 & ABOVE,MARRIED,4543,1475,3068,0,4188,1359,2829,0,355,116,239,0
SUJAWAL,DISTRICT,75 & ABOVE,NEVER MARRIED,59,20,38,1,45,13,32,0,14,7,6,1
SUJAWAL,DISTRICT,75 & ABOVE,SEPERATION,12,2,10,0,12,2,10,0,0,0,0,0
SUJAWAL,DISTRICT,75 & ABOVE,WIDOWED,2630,2021,609,0,2316,1782,534,0,314,239,75,0
SUKKUR,DISTRICT,15 &  ABOVE,DIVORCED,1547,1067,480,0,406,279,127,0,1141,788,353,0
SUKKUR,DISTRICT,15 &  ABOVE,MARRIED,594534,297685,296849,0,300324,151056,149268,0,294210,146629,147581,0
SUKKUR,DISTRICT,15 &  ABOVE,NEVER MARRIED,262882,99618,163194,70,109807,39869,69923,15,153075,59749,93271,55
SUKKUR,DISTRICT,15 &  ABOVE,SEPERATION,785,465,320,0,332,199,133,0,453,266,187,0
SUKKUR,DISTRICT,15 &  ABOVE,WIDOWED,29181,22738,6443,0,12657,9716,2941,0,16524,13022,3502,0
SUKKUR,DISTRICT,15 - 19,DIVORCED,37,31,6,0,15,13,2,0,22,18,4,0
SUKKUR,DISTRICT,15 - 19,MARRIED,20978,14147,6831,0,14229,9367,4862,0,6749,4780,1969,0
SUKKUR,DISTRICT,15 - 19,NEVER MARRIED,146028,60844,85169,15,69017,27717,41294,6,77011,33127,43875,9
SUKKUR,DISTRICT,15 - 19,SEPERATION,37,15,22,0,18,8,10,0,19,7,12,0
SUKKUR,DISTRICT,15 - 19,WIDOWED,61,28,33,0,34,9,25,0,27,19,8,0
SUKKUR,DISTRICT,20 - 24,DIVORCED,132,97,35,0,53,37,16,0,79,60,19,0
SUKKUR,DISTRICT,20 - 24,MARRIED,67082,42058,25024,0,40282,24411,15871,0,26800,17647,9153,0
SUKKUR,DISTRICT,20 - 24,NEVER MARRIED,65220,22598,42610,12,24762,7596,17163,3,40458,15002,25447,9
SUKKUR,DISTRICT,20 - 24,SEPERATION,60,36,24,0,29,20,9,0,31,16,15,0
SUKKUR,DISTRICT,20 - 24,WIDOWED,200,110,90,0,101,44,57,0,99,66,33,0
SUKKUR,DISTRICT,25 - 29,DIVORCED,208,141,67,0,54,32,22,0,154,109,45,0
SUKKUR,DISTRICT,25 - 29,MARRIED,85059,46338,38721,0,44076,23136,20940,0,40983,23202,17781,0
SUKKUR,DISTRICT,25 - 29,NEVER MARRIED,28795,8699,20085,11,9357,2506,6851,0,19438,6193,13234,11
SUKKUR,DISTRICT,25 - 29,SEPERATION,83,47,36,0,31,16,15,0,52,31,21,0
SUKKUR,DISTRICT,25 - 29,WIDOWED,391,226,165,0,187,100,87,0,204,126,78,0
SUKKUR,DISTRICT,30 - 34,DIVORCED,247,172,75,0,57,40,17,0,190,132,58,0
SUKKUR,DISTRICT,30 - 34,MARRIED,84257,43982,40275,0,40877,21232,19645,0,43380,22750,20630,0
SUKKUR,DISTRICT,30 - 34,NEVER MARRIED,11018,3264,7746,8,3270,916,2352,2,7748,2348,5394,6
SUKKUR,DISTRICT,30 - 34,SEPERATION,90,63,27,0,42,29,13,0,48,34,14,0
SUKKUR,DISTRICT,30 - 34,WIDOWED,607,401,206,0,293,177,116,0,314,224,90,0
SUKKUR,DISTRICT,35 - 39,DIVORCED,260,188,72,0,67,50,17,0,193,138,55,0
SUKKUR,DISTRICT,35 - 39,MARRIED,81708,40081,41627,0,39042,19149,19893,0,42666,20932,21734,0
SUKKUR,DISTRICT,35 - 39,NEVER MARRIED,5401,1822,3574,5,1508,478,1029,1,3893,1344,2545,4
SUKKUR,DISTRICT,35 - 39,SEPERATION,116,65,51,0,45,25,20,0,71,40,31,0
SUKKUR,DISTRICT,35 - 39,WIDOWED,1042,766,276,0,493,350,143,0,549,416,133,0
SUKKUR,DISTRICT,40 - 44,DIVORCED,221,149,72,0,51,36,15,0,170,113,57,0
SUKKUR,DISTRICT,40 - 44,MARRIED,73192,34331,38861,0,36173,17051,19122,0,37019,17280,19739,0
SUKKUR,DISTRICT,40 - 44,NEVER MARRIED,2836,942,1888,6,882,271,611,0,1954,671,1277,6
SUKKUR,DISTRICT,40 - 44,SEPERATION,93,61,32,0,41,29,12,0,52,32,20,0
SUKKUR,DISTRICT,40 - 44,WIDOWED,1781,1429,352,0,835,651,184,0,946,778,168,0
SUKKUR,DISTRICT,45 - 49,DIVORCED,168,115,53,0,41,26,15,0,127,89,38,0
SUKKUR,DISTRICT,45 - 49,MARRIED,55408,25460,29948,0,25606,11951,13655,0,29802,13509,16293,0
SUKKUR,DISTRICT,45 - 49,NEVER MARRIED,1507,514,989,4,383,136,247,0,1124,378,742,4
SUKKUR,DISTRICT,45 - 49,SEPERATION,87,55,32,0,32,20,12,0,55,35,20,0
SUKKUR,DISTRICT,45 - 49,WIDOWED,2345,1934,411,0,1068,861,207,0,1277,1073,204,0
SUKKUR,DISTRICT,50 - 54,DIVORCED,111,73,38,0,24,16,8,0,87,57,30,0
SUKKUR,DISTRICT,50 - 54,MARRIED,43575,19344,24231,0,20499,9347,11152,0,23076,9997,13079,0
SUKKUR,DISTRICT,50 - 54,NEVER MARRIED,824,355,463,6,250,104,143,3,574,251,320,3
SUKKUR,DISTRICT,50 - 54,SEPERATION,73,43,30,0,31,18,13,0,42,25,17,0
SUKKUR,DISTRICT,50 - 54,WIDOWED,3354,2757,597,0,1479,1185,294,0,1875,1572,303,0
SUKKUR,DISTRICT,55 - 59,DIVORCED,72,45,27,0,18,12,6,0,54,33,21,0
SUKKUR,DISTRICT,55 - 59,MARRIED,33026,13473,19553,0,14986,6101,8885,0,18040,7372,10668,0
SUKKUR,DISTRICT,55 - 59,NEVER MARRIED,547,232,315,0,173,64,109,0,374,168,206,0
SUKKUR,DISTRICT,55 - 59,SEPERATION,62,35,27,0,24,12,12,0,38,23,15,0
SUKKUR,DISTRICT,55 - 59,WIDOWED,3601,2869,732,0,1465,1150,315,0,2136,1719,417,0
SUKKUR,DISTRICT,60 - 64,DIVORCED,53,33,20,0,16,12,4,0,37,21,16,0
SUKKUR,DISTRICT,60 - 64,MARRIED,21280,8294,12986,0,9814,3996,5818,0,11466,4298,7168,0
SUKKUR,DISTRICT,60 - 64,NEVER MARRIED,323,156,166,1,93,37,56,0,230,119,110,1
SUKKUR,DISTRICT,60 - 64,SEPERATION,33,20,13,0,11,10,1,0,22,10,12,0
SUKKUR,DISTRICT,60 - 64,WIDOWED,4132,3260,872,0,1672,1292,380,0,2460,1968,492,0
SUKKUR,DISTRICT,65 - 69,DIVORCED,15,11,4,0,4,3,1,0,11,8,3,0
SUKKUR,DISTRICT,65 - 69,MARRIED,13585,5092,8493,0,6579,2574,4005,0,7006,2518,4488,0
SUKKUR,DISTRICT,65 - 69,NEVER MARRIED,198,103,95,0,45,18,27,0,153,85,68,0
SUKKUR,DISTRICT,65 - 69,SEPERATION,22,14,8,0,9,6,3,0,13,8,5,0
SUKKUR,DISTRICT,65 - 69,WIDOWED,4038,3154,884,0,1625,1278,347,0,2413,1876,537,0
SUKKUR,DISTRICT,70 - 74,DIVORCED,13,7,6,0,2,1,1,0,11,6,5,0
SUKKUR,DISTRICT,70 - 74,MARRIED,9007,3106,5901,0,4644,1659,2985,0,4363,1447,2916,0
SUKKUR,DISTRICT,70 - 74,NEVER MARRIED,102,51,50,1,36,15,21,0,66,36,29,1
SUKKUR,DISTRICT,70 - 74,SEPERATION,15,7,8,0,7,3,4,0,8,4,4,0
SUKKUR,DISTRICT,70 - 74,WIDOWED,3701,2873,828,0,1631,1273,358,0,2070,1600,470,0
SUKKUR,DISTRICT,75 & ABOVE,DIVORCED,10,5,5,0,4,1,3,0,6,4,2,0
SUKKUR,DISTRICT,75 & ABOVE,MARRIED,6377,1979,4398,0,3517,1082,2435,0,2860,897,1963,0
SUKKUR,DISTRICT,75 & ABOVE,NEVER MARRIED,83,38,44,1,31,11,20,0,52,27,24,1
SUKKUR,DISTRICT,75 & ABOVE,SEPERATION,14,4,10,0,12,3,9,0,2,1,1,0
SUKKUR,DISTRICT,75 & ABOVE,WIDOWED,3928,2931,997,0,1774,1346,428,0,2154,1585,569,0
TANDO ALLAHYAR,DISTRICT,15 &  ABOVE,DIVORCED,979,641,338,0,518,335,183,0,461,306,155,0
TANDO ALLAHYAR,DISTRICT,15 &  ABOVE,MARRIED,361621,180748,180873,0,247177,123660,123517,0,114444,57088,57356,0
TANDO ALLAHYAR,DISTRICT,15 &  ABOVE,NEVER MARRIED,129128,53947,75163,18,79777,33006,46770,1,49351,20941,28393,17
TANDO ALLAHYAR,DISTRICT,15 &  ABOVE,SEPERATION,446,241,205,0,300,164,136,0,146,77,69,0
TANDO ALLAHYAR,DISTRICT,15 &  ABOVE,WIDOWED,20607,15909,4698,0,13454,10402,3052,0,7153,5507,1646,0
TANDO ALLAHYAR,DISTRICT,15 - 19,DIVORCED,44,29,15,0,31,18,13,0,13,11,2,0
TANDO ALLAHYAR,DISTRICT,15 - 19,MARRIED,15799,10389,5410,0,12472,8075,4397,0,3327,2314,1013,0
TANDO ALLAHYAR,DISTRICT,15 - 19,NEVER MARRIED,71915,32331,39582,2,46907,20645,26261,1,25008,11686,13321,1
TANDO ALLAHYAR,DISTRICT,15 - 19,SEPERATION,26,15,11,0,16,8,8,0,10,7,3,0
TANDO ALLAHYAR,DISTRICT,15 - 19,WIDOWED,32,13,19,0,24,9,15,0,8,4,4,0
TANDO ALLAHYAR,DISTRICT,20 - 24,DIVORCED,117,81,36,0,79,55,24,0,38,26,12,0
TANDO ALLAHYAR,DISTRICT,20 - 24,MARRIED,44673,26319,18354,0,33236,19164,14072,0,11437,7155,4282,0
TANDO ALLAHYAR,DISTRICT,20 - 24,NEVER MARRIED,31124,11689,19433,2,18013,6496,11517,0,13111,5193,7916,2
TANDO ALLAHYAR,DISTRICT,20 - 24,SEPERATION,53,23,30,0,40,17,23,0,13,6,7,0
TANDO ALLAHYAR,DISTRICT,20 - 24,WIDOWED,152,70,82,0,121,51,70,0,31,19,12,0
TANDO ALLAHYAR,DISTRICT,25 - 29,DIVORCED,158,97,61,0,83,51,32,0,75,46,29,0
TANDO ALLAHYAR,DISTRICT,25 - 29,MARRIED,52561,27516,25045,0,36534,18719,17815,0,16027,8797,7230,0
TANDO ALLAHYAR,DISTRICT,25 - 29,NEVER MARRIED,13682,5236,8444,2,7695,2953,4742,0,5987,2283,3702,2
TANDO ALLAHYAR,DISTRICT,25 - 29,SEPERATION,56,26,30,0,38,19,19,0,18,7,11,0
TANDO ALLAHYAR,DISTRICT,25 - 29,WIDOWED,253,126,127,0,173,89,84,0,80,37,43,0
TANDO ALLAHYAR,DISTRICT,30 - 34,DIVORCED,160,104,56,0,84,55,29,0,76,49,27,0
TANDO ALLAHYAR,DISTRICT,30 - 34,MARRIED,51708,26665,25043,0,34706,17920,16786,0,17002,8745,8257,0
TANDO ALLAHYAR,DISTRICT,30 - 34,NEVER MARRIED,5662,2163,3497,2,3237,1300,1937,0,2425,863,1560,2
TANDO ALLAHYAR,DISTRICT,30 - 34,SEPERATION,43,25,18,0,29,15,14,0,14,10,4,0
TANDO ALLAHYAR,DISTRICT,30 - 34,WIDOWED,480,311,169,0,334,206,128,0,146,105,41,0
TANDO ALLAHYAR,DISTRICT,35 - 39,DIVORCED,161,105,56,0,82,51,31,0,79,54,25,0
TANDO ALLAHYAR,DISTRICT,35 - 39,MARRIED,49592,24738,24854,0,33130,16580,16550,0,16462,8158,8304,0
TANDO ALLAHYAR,DISTRICT,35 - 39,NEVER MARRIED,2931,1051,1879,1,1694,674,1020,0,1237,377,859,1
TANDO ALLAHYAR,DISTRICT,35 - 39,SEPERATION,48,24,24,0,32,16,16,0,16,8,8,0
TANDO ALLAHYAR,DISTRICT,35 - 39,WIDOWED,750,546,204,0,489,354,135,0,261,192,69,0
TANDO ALLAHYAR,DISTRICT,40 - 44,DIVORCED,137,99,38,0,63,45,18,0,74,54,20,0
TANDO ALLAHYAR,DISTRICT,40 - 44,MARRIED,46109,21818,24291,0,30804,14620,16184,0,15305,7198,8107,0
TANDO ALLAHYAR,DISTRICT,40 - 44,NEVER MARRIED,1631,615,1016,0,947,396,551,0,684,219,465,0
TANDO ALLAHYAR,DISTRICT,40 - 44,SEPERATION,55,36,19,0,37,25,12,0,18,11,7,0
TANDO ALLAHYAR,DISTRICT,40 - 44,WIDOWED,1388,1064,324,0,914,707,207,0,474,357,117,0
TANDO ALLAHYAR,DISTRICT,45 - 49,DIVORCED,73,50,23,0,36,26,10,0,37,24,13,0
TANDO ALLAHYAR,DISTRICT,45 - 49,MARRIED,31662,14810,16852,0,20694,9719,10975,0,10968,5091,5877,0
TANDO ALLAHYAR,DISTRICT,45 - 49,NEVER MARRIED,866,319,544,3,513,208,305,0,353,111,239,3
TANDO ALLAHYAR,DISTRICT,45 - 49,SEPERATION,50,33,17,0,29,22,7,0,21,11,10,0
TANDO ALLAHYAR,DISTRICT,45 - 49,WIDOWED,1744,1401,343,0,1145,926,219,0,599,475,124,0
TANDO ALLAHYAR,DISTRICT,50 - 54,DIVORCED,58,35,23,0,27,17,10,0,31,18,13,0
TANDO ALLAHYAR,DISTRICT,50 - 54,MARRIED,26514,11832,14682,0,17334,7783,9551,0,9180,4049,5131,0
TANDO ALLAHYAR,DISTRICT,50 - 54,NEVER MARRIED,534,202,328,4,297,118,179,0,237,84,149,4
TANDO ALLAHYAR,DISTRICT,50 - 54,SEPERATION,40,26,14,0,25,17,8,0,15,9,6,0
TANDO ALLAHYAR,DISTRICT,50 - 54,WIDOWED,2670,2113,557,0,1745,1364,381,0,925,749,176,0
TANDO ALLAHYAR,DISTRICT,55 - 59,DIVORCED,34,17,17,0,16,9,7,0,18,8,10,0
TANDO ALLAHYAR,DISTRICT,55 - 59,MARRIED,17719,7040,10679,0,11286,4515,6771,0,6433,2525,3908,0
TANDO ALLAHYAR,DISTRICT,55 - 59,NEVER MARRIED,313,134,178,1,185,82,103,0,128,52,75,1
TANDO ALLAHYAR,DISTRICT,55 - 59,SEPERATION,24,13,11,0,15,7,8,0,9,6,3,0
TANDO ALLAHYAR,DISTRICT,55 - 59,WIDOWED,2459,1919,540,0,1526,1194,332,0,933,725,208,0
TANDO ALLAHYAR,DISTRICT,60 - 64,DIVORCED,25,15,10,0,14,6,8,0,11,9,2,0
TANDO ALLAHYAR,DISTRICT,60 - 64,MARRIED,10613,4370,6243,0,6924,2929,3995,0,3689,1441,2248,0
TANDO ALLAHYAR,DISTRICT,60 - 64,NEVER MARRIED,216,91,124,1,118,59,59,0,98,32,65,1
TANDO ALLAHYAR,DISTRICT,60 - 64,SEPERATION,20,9,11,0,13,7,6,0,7,2,5,0
TANDO ALLAHYAR,DISTRICT,60 - 64,WIDOWED,2648,2127,521,0,1709,1379,330,0,939,748,191,0
TANDO ALLAHYAR,DISTRICT,65 - 69,DIVORCED,6,5,1,0,1,1,0,0,5,4,1,0
TANDO ALLAHYAR,DISTRICT,65 - 69,MARRIED,7266,2805,4461,0,4852,1895,2957,0,2414,910,1504,0
TANDO ALLAHYAR,DISTRICT,65 - 69,NEVER MARRIED,119,56,63,0,71,33,38,0,48,23,25,0
TANDO ALLAHYAR,DISTRICT,65 - 69,SEPERATION,17,7,10,0,14,7,7,0,3,0,3,0
TANDO ALLAHYAR,DISTRICT,65 - 69,WIDOWED,2701,2133,568,0,1744,1387,357,0,957,746,211,0
TANDO ALLAHYAR,DISTRICT,70 - 74,DIVORCED,4,2,2,0,1,0,1,0,3,2,1,0
TANDO ALLAHYAR,DISTRICT,70 - 74,MARRIED,4565,1609,2956,0,3178,1160,2018,0,1387,449,938,0
TANDO ALLAHYAR,DISTRICT,70 - 74,NEVER MARRIED,82,40,42,0,61,28,33,0,21,12,9,0
TANDO ALLAHYAR,DISTRICT,70 - 74,SEPERATION,7,1,6,0,5,1,4,0,2,0,2,0
TANDO ALLAHYAR,DISTRICT,70 - 74,WIDOWED,2541,1968,573,0,1663,1297,366,0,878,671,207,0
TANDO ALLAHYAR,DISTRICT,75 & ABOVE,DIVORCED,2,2,0,0,1,1,0,0,1,1,0,0
TANDO ALLAHYAR,DISTRICT,75 & ABOVE,MARRIED,2840,837,2003,0,2027,581,1446,0,813,256,557,0
TANDO ALLAHYAR,DISTRICT,75 & ABOVE,NEVER MARRIED,53,20,33,0,39,14,25,0,14,6,8,0
TANDO ALLAHYAR,DISTRICT,75 & ABOVE,SEPERATION,7,3,4,0,7,3,4,0,0,0,0,0
TANDO ALLAHYAR,DISTRICT,75 & ABOVE,WIDOWED,2789,2118,671,0,1867,1439,428,0,922,679,243,0
TANDO MUHAMMAD KHAN,DISTRICT,15 &  ABOVE,DIVORCED,856,575,281,0,540,361,179,0,316,214,102,0
TANDO MUHAMMAD KHAN,DISTRICT,15 &  ABOVE,MARRIED,297888,149087,148801,0,231677,116050,115627,0,66211,33037,33174,0
TANDO MUHAMMAD KHAN,DISTRICT,15 &  ABOVE,NEVER MARRIED,101922,38948,62954,20,73889,27938,45946,5,28033,11010,17008,15
TANDO MUHAMMAD KHAN,DISTRICT,15 &  ABOVE,SEPERATION,697,415,282,0,500,307,193,0,197,108,89,0
TANDO MUHAMMAD KHAN,DISTRICT,15 &  ABOVE,WIDOWED,18301,13812,4489,0,13562,10222,3340,0,4739,3590,1149,0
TANDO MUHAMMAD KHAN,DISTRICT,15 - 19,DIVORCED,27,18,9,0,18,11,7,0,9,7,2,0
TANDO MUHAMMAD KHAN,DISTRICT,15 - 19,MARRIED,12514,8485,4029,0,10122,6782,3340,0,2392,1703,689,0
TANDO MUHAMMAD KHAN,DISTRICT,15 - 19,NEVER MARRIED,55900,23552,32346,2,42137,17494,24642,1,13763,6058,7704,1
TANDO MUHAMMAD KHAN,DISTRICT,15 - 19,SEPERATION,21,9,12,0,18,7,11,0,3,2,1,0
TANDO MUHAMMAD KHAN,DISTRICT,15 - 19,WIDOWED,34,13,21,0,30,12,18,0,4,1,3,0
TANDO MUHAMMAD KHAN,DISTRICT,20 - 24,DIVORCED,109,69,40,0,74,46,28,0,35,23,12,0
TANDO MUHAMMAD KHAN,DISTRICT,20 - 24,MARRIED,40144,24089,16055,0,32536,19448,13088,0,7608,4641,2967,0
TANDO MUHAMMAD KHAN,DISTRICT,20 - 24,NEVER MARRIED,24023,8300,15721,2,16888,5627,11260,1,7135,2673,4461,1
TANDO MUHAMMAD KHAN,DISTRICT,20 - 24,SEPERATION,54,32,22,0,43,25,18,0,11,7,4,0
TANDO MUHAMMAD KHAN,DISTRICT,20 - 24,WIDOWED,142,80,62,0,108,59,49,0,34,21,13,0
TANDO MUHAMMAD KHAN,DISTRICT,25 - 29,DIVORCED,111,83,28,0,67,48,19,0,44,35,9,0
TANDO MUHAMMAD KHAN,DISTRICT,25 - 29,MARRIED,42372,21917,20455,0,33576,17241,16335,0,8796,4676,4120,0
TANDO MUHAMMAD KHAN,DISTRICT,25 - 29,NEVER MARRIED,10539,3046,7491,2,7149,2000,5149,0,3390,1046,2342,2
TANDO MUHAMMAD KHAN,DISTRICT,25 - 29,SEPERATION,74,39,35,0,54,28,26,0,20,11,9,0
TANDO MUHAMMAD KHAN,DISTRICT,25 - 29,WIDOWED,226,130,96,0,184,105,79,0,42,25,17,0
TANDO MUHAMMAD KHAN,DISTRICT,30 - 34,DIVORCED,128,88,40,0,78,54,24,0,50,34,16,0
TANDO MUHAMMAD KHAN,DISTRICT,30 - 34,MARRIED,41251,21348,19903,0,31806,16396,15410,0,9445,4952,4493,0
TANDO MUHAMMAD KHAN,DISTRICT,30 - 34,NEVER MARRIED,4835,1626,3206,3,3256,1129,2126,1,1579,497,1080,2
TANDO MUHAMMAD KHAN,DISTRICT,30 - 34,SEPERATION,86,51,35,0,61,39,22,0,25,12,13,0
TANDO MUHAMMAD KHAN,DISTRICT,30 - 34,WIDOWED,416,285,131,0,319,212,107,0,97,73,24,0
TANDO MUHAMMAD KHAN,DISTRICT,35 - 39,DIVORCED,148,102,46,0,93,65,28,0,55,37,18,0
TANDO MUHAMMAD KHAN,DISTRICT,35 - 39,MARRIED,38229,18785,19444,0,29088,14352,14736,0,9141,4433,4708,0
TANDO MUHAMMAD KHAN,DISTRICT,35 - 39,NEVER MARRIED,2745,1002,1740,3,1858,703,1155,0,887,299,585,3
TANDO MUHAMMAD KHAN,DISTRICT,35 - 39,SEPERATION,97,56,41,0,69,43,26,0,28,13,15,0
TANDO MUHAMMAD KHAN,DISTRICT,35 - 39,WIDOWED,655,445,210,0,471,318,153,0,184,127,57,0
TANDO MUHAMMAD KHAN,DISTRICT,40 - 44,DIVORCED,121,79,42,0,83,55,28,0,38,24,14,0
TANDO MUHAMMAD KHAN,DISTRICT,40 - 44,MARRIED,38140,18093,20047,0,29600,13951,15649,0,8540,4142,4398,0
TANDO MUHAMMAD KHAN,DISTRICT,40 - 44,NEVER MARRIED,1599,574,1023,2,1062,398,664,0,537,176,359,2
TANDO MUHAMMAD KHAN,DISTRICT,40 - 44,SEPERATION,104,67,37,0,69,46,23,0,35,21,14,0
TANDO MUHAMMAD KHAN,DISTRICT,40 - 44,WIDOWED,1202,898,304,0,928,688,240,0,274,210,64,0
TANDO MUHAMMAD KHAN,DISTRICT,45 - 49,DIVORCED,74,45,29,0,41,24,17,0,33,21,12,0
TANDO MUHAMMAD KHAN,DISTRICT,45 - 49,MARRIED,26033,12004,14029,0,19796,9177,10619,0,6237,2827,3410,0
TANDO MUHAMMAD KHAN,DISTRICT,45 - 49,NEVER MARRIED,925,321,604,0,655,236,419,0,270,85,185,0
TANDO MUHAMMAD KHAN,DISTRICT,45 - 49,SEPERATION,77,48,29,0,51,33,18,0,26,15,11,0
TANDO MUHAMMAD KHAN,DISTRICT,45 - 49,WIDOWED,1498,1125,373,0,1099,812,287,0,399,313,86,0
TANDO MUHAMMAD KHAN,DISTRICT,50 - 54,DIVORCED,53,38,15,0,29,22,7,0,24,16,8,0
TANDO MUHAMMAD KHAN,DISTRICT,50 - 54,MARRIED,21919,9708,12211,0,16808,7472,9336,0,5111,2236,2875,0
TANDO MUHAMMAD KHAN,DISTRICT,50 - 54,NEVER MARRIED,517,205,310,2,340,139,201,0,177,66,109,2
TANDO MUHAMMAD KHAN,DISTRICT,50 - 54,SEPERATION,69,46,23,0,47,34,13,0,22,12,10,0
TANDO MUHAMMAD KHAN,DISTRICT,50 - 54,WIDOWED,2193,1678,515,0,1589,1210,379,0,604,468,136,0
TANDO MUHAMMAD KHAN,DISTRICT,55 - 59,DIVORCED,33,23,10,0,18,11,7,0,15,12,3,0
TANDO MUHAMMAD KHAN,DISTRICT,55 - 59,MARRIED,13800,5484,8316,0,10157,4042,6115,0,3643,1442,2201,0
TANDO MUHAMMAD KHAN,DISTRICT,55 - 59,NEVER MARRIED,352,131,218,3,226,95,129,2,126,36,89,1
TANDO MUHAMMAD KHAN,DISTRICT,55 - 59,SEPERATION,41,24,17,0,32,19,13,0,9,5,4,0
TANDO MUHAMMAD KHAN,DISTRICT,55 - 59,WIDOWED,1914,1450,464,0,1349,1014,335,0,565,436,129,0
TANDO MUHAMMAD KHAN,DISTRICT,60 - 64,DIVORCED,25,14,11,0,18,11,7,0,7,3,4,0
TANDO MUHAMMAD KHAN,DISTRICT,60 - 64,MARRIED,9599,4223,5376,0,7239,3249,3990,0,2360,974,1386,0
TANDO MUHAMMAD KHAN,DISTRICT,60 - 64,NEVER MARRIED,220,84,135,1,145,56,89,0,75,28,46,1
TANDO MUHAMMAD KHAN,DISTRICT,60 - 64,SEPERATION,29,18,11,0,21,14,7,0,8,4,4,0
TANDO MUHAMMAD KHAN,DISTRICT,60 - 64,WIDOWED,2389,1911,478,0,1767,1423,344,0,622,488,134,0
TANDO MUHAMMAD KHAN,DISTRICT,65 - 69,DIVORCED,19,13,6,0,16,11,5,0,3,2,1,0
TANDO MUHAMMAD KHAN,DISTRICT,65 - 69,MARRIED,6484,2500,3984,0,4991,1955,3036,0,1493,545,948,0
TANDO MUHAMMAD KHAN,DISTRICT,65 - 69,NEVER MARRIED,130,61,69,0,77,31,46,0,53,30,23,0
TANDO MUHAMMAD KHAN,DISTRICT,65 - 69,SEPERATION,21,12,9,0,15,9,6,0,6,3,3,0
TANDO MUHAMMAD KHAN,DISTRICT,65 - 69,WIDOWED,2403,1859,544,0,1755,1361,394,0,648,498,150,0
TANDO MUHAMMAD KHAN,DISTRICT,70 - 74,DIVORCED,6,3,3,0,5,3,2,0,1,0,1,0
TANDO MUHAMMAD KHAN,DISTRICT,70 - 74,MARRIED,4539,1616,2923,0,3647,1305,2342,0,892,311,581,0
TANDO MUHAMMAD KHAN,DISTRICT,70 - 74,NEVER MARRIED,91,30,61,0,62,17,45,0,29,13,16,0
TANDO MUHAMMAD KHAN,DISTRICT,70 - 74,SEPERATION,13,9,4,0,11,8,3,0,2,1,1,0
TANDO MUHAMMAD KHAN,DISTRICT,70 - 74,WIDOWED,2491,1907,584,0,1872,1449,423,0,619,458,161,0
TANDO MUHAMMAD KHAN,DISTRICT,75 & ABOVE,DIVORCED,2,0,2,0,0,0,0,0,2,0,2,0
TANDO MUHAMMAD KHAN,DISTRICT,75 & ABOVE,MARRIED,2864,835,2029,0,2311,680,1631,0,553,155,398,0
TANDO MUHAMMAD KHAN,DISTRICT,75 & ABOVE,NEVER MARRIED,46,16,30,0,34,13,21,0,12,3,9,0
TANDO MUHAMMAD KHAN,DISTRICT,75 & ABOVE,SEPERATION,11,4,7,0,9,2,7,0,2,2,0,0
TANDO MUHAMMAD KHAN,DISTRICT,75 & ABOVE,WIDOWED,2738,2031,707,0,2091,1559,532,0,647,472,175,0
THARPARKAR,DISTRICT,15 &  ABOVE,DIVORCED,359,241,118,0,264,184,80,0,95,57,38,0
THARPARKAR,DISTRICT,15 &  ABOVE,MARRIED,639930,320398,319532,0,583977,292618,291359,0,55953,27780,28173,0
THARPARKAR,DISTRICT,15 &  ABOVE,NEVER MARRIED,186233,73641,112562,30,164071,64873,99171,27,22162,8768,13391,3
THARPARKAR,DISTRICT,15 &  ABOVE,SEPERATION,538,264,274,0,487,239,248,0,51,25,26,0
THARPARKAR,DISTRICT,15 &  ABOVE,WIDOWED,28652,22176,6476,0,25743,19757,5986,0,2909,2419,490,0
THARPARKAR,DISTRICT,15 - 19,DIVORCED,12,6,6,0,12,6,6,0,0,0,0,0
THARPARKAR,DISTRICT,15 - 19,MARRIED,33995,21022,12973,0,32592,20088,12504,0,1403,934,469,0
THARPARKAR,DISTRICT,15 - 19,NEVER MARRIED,125438,56212,69220,6,112857,50633,62218,6,12581,5579,7002,0
THARPARKAR,DISTRICT,15 - 19,SEPERATION,47,11,36,0,46,10,36,0,1,1,0,0
THARPARKAR,DISTRICT,15 - 19,WIDOWED,52,23,29,0,49,23,26,0,3,0,3,0
THARPARKAR,DISTRICT,20 - 24,DIVORCED,30,19,11,0,23,13,10,0,7,6,1,0
THARPARKAR,DISTRICT,20 - 24,MARRIED,87549,51584,35965,0,82086,48132,33954,0,5463,3452,2011,0
THARPARKAR,DISTRICT,20 - 24,NEVER MARRIED,37635,12251,25378,6,31580,9973,21601,6,6055,2278,3777,0
THARPARKAR,DISTRICT,20 - 24,SEPERATION,48,13,35,0,47,13,34,0,1,0,1,0
THARPARKAR,DISTRICT,20 - 24,WIDOWED,116,54,62,0,108,52,56,0,8,2,6,0
THARPARKAR,DISTRICT,25 - 29,DIVORCED,62,38,24,0,40,24,16,0,22,14,8,0
THARPARKAR,DISTRICT,25 - 29,MARRIED,95875,49441,46434,0,87706,45018,42688,0,8169,4423,3746,0
THARPARKAR,DISTRICT,25 - 29,NEVER MARRIED,13278,2954,10320,4,10958,2315,8639,4,2320,639,1681,0
THARPARKAR,DISTRICT,25 - 29,SEPERATION,45,29,16,0,38,26,12,0,7,3,4,0
THARPARKAR,DISTRICT,25 - 29,WIDOWED,279,143,136,0,262,133,129,0,17,10,7,0
THARPARKAR,DISTRICT,30 - 34,DIVORCED,59,38,21,0,42,28,14,0,17,10,7,0
THARPARKAR,DISTRICT,30 - 34,MARRIED,80360,41076,39284,0,72253,36962,35291,0,8107,4114,3993,0
THARPARKAR,DISTRICT,30 - 34,NEVER MARRIED,4565,1038,3524,3,3956,897,3056,3,609,141,468,0
THARPARKAR,DISTRICT,30 - 34,SEPERATION,49,26,23,0,38,19,19,0,11,7,4,0
THARPARKAR,DISTRICT,30 - 34,WIDOWED,461,305,156,0,401,256,145,0,60,49,11,0
THARPARKAR,DISTRICT,35 - 39,DIVORCED,56,38,18,0,36,28,8,0,20,10,10,0
THARPARKAR,DISTRICT,35 - 39,MARRIED,77487,38624,38863,0,69735,34812,34923,0,7752,3812,3940,0
THARPARKAR,DISTRICT,35 - 39,NEVER MARRIED,2186,494,1692,0,1920,435,1485,0,266,59,207,0
THARPARKAR,DISTRICT,35 - 39,SEPERATION,71,43,28,0,62,39,23,0,9,4,5,0
THARPARKAR,DISTRICT,35 - 39,WIDOWED,768,550,218,0,691,487,204,0,77,63,14,0
THARPARKAR,DISTRICT,40 - 44,DIVORCED,34,25,9,0,28,21,7,0,6,4,2,0
THARPARKAR,DISTRICT,40 - 44,MARRIED,74042,36143,37899,0,66786,32572,34214,0,7256,3571,3685,0
THARPARKAR,DISTRICT,40 - 44,NEVER MARRIED,1306,282,1024,0,1143,246,897,0,163,36,127,0
THARPARKAR,DISTRICT,40 - 44,SEPERATION,65,39,26,0,58,34,24,0,7,5,2,0
THARPARKAR,DISTRICT,40 - 44,WIDOWED,1367,1032,335,0,1231,919,312,0,136,113,23,0
THARPARKAR,DISTRICT,45 - 49,DIVORCED,38,27,11,0,27,22,5,0,11,5,6,0
THARPARKAR,DISTRICT,45 - 49,MARRIED,51341,24503,26838,0,46131,22084,24047,0,5210,2419,2791,0
THARPARKAR,DISTRICT,45 - 49,NEVER MARRIED,639,149,489,1,575,135,439,1,64,14,50,0
THARPARKAR,DISTRICT,45 - 49,SEPERATION,46,27,19,0,39,24,15,0,7,3,4,0
THARPARKAR,DISTRICT,45 - 49,WIDOWED,1691,1300,391,0,1512,1141,371,0,179,159,20,0
THARPARKAR,DISTRICT,50 - 54,DIVORCED,22,17,5,0,17,14,3,0,5,3,2,0
THARPARKAR,DISTRICT,50 - 54,MARRIED,43125,19944,23181,0,38882,18023,20859,0,4243,1921,2322,0
THARPARKAR,DISTRICT,50 - 54,NEVER MARRIED,402,98,300,4,363,92,269,2,39,6,31,2
THARPARKAR,DISTRICT,50 - 54,SEPERATION,48,27,21,0,45,27,18,0,3,0,3,0
THARPARKAR,DISTRICT,50 - 54,WIDOWED,2373,1858,515,0,2097,1611,486,0,276,247,29,0
THARPARKAR,DISTRICT,55 - 59,DIVORCED,18,12,6,0,14,9,5,0,4,3,1,0
THARPARKAR,DISTRICT,55 - 59,MARRIED,31292,12572,18720,0,28038,11363,16675,0,3254,1209,2045,0
THARPARKAR,DISTRICT,55 - 59,NEVER MARRIED,275,60,214,1,248,55,192,1,27,5,22,0
THARPARKAR,DISTRICT,55 - 59,SEPERATION,36,15,21,0,35,14,21,0,1,1,0,0
THARPARKAR,DISTRICT,55 - 59,WIDOWED,2374,1796,578,0,2079,1566,513,0,295,230,65,0
THARPARKAR,DISTRICT,60 - 64,DIVORCED,12,9,3,0,9,7,2,0,3,2,1,0
THARPARKAR,DISTRICT,60 - 64,MARRIED,21516,9452,12064,0,19625,8658,10967,0,1891,794,1097,0
THARPARKAR,DISTRICT,60 - 64,NEVER MARRIED,195,47,146,2,180,43,135,2,15,4,11,0
THARPARKAR,DISTRICT,60 - 64,SEPERATION,23,12,11,0,21,12,9,0,2,0,2,0
THARPARKAR,DISTRICT,60 - 64,WIDOWED,3066,2421,645,0,2772,2186,586,0,294,235,59,0
THARPARKAR,DISTRICT,65 - 69,DIVORCED,5,3,2,0,5,3,2,0,0,0,0,0
THARPARKAR,DISTRICT,65 - 69,MARRIED,17186,6971,10215,0,15721,6397,9324,0,1465,574,891,0
THARPARKAR,DISTRICT,65 - 69,NEVER MARRIED,119,21,98,0,108,17,91,0,11,4,7,0
THARPARKAR,DISTRICT,65 - 69,SEPERATION,22,10,12,0,20,9,11,0,2,1,1,0
THARPARKAR,DISTRICT,65 - 69,WIDOWED,3508,2690,818,0,3108,2361,747,0,400,329,71,0
THARPARKAR,DISTRICT,70 - 74,DIVORCED,4,3,1,0,4,3,1,0,0,0,0,0
THARPARKAR,DISTRICT,70 - 74,MARRIED,13283,5026,8257,0,12322,4688,7634,0,961,338,623,0
THARPARKAR,DISTRICT,70 - 74,NEVER MARRIED,89,13,75,1,82,11,71,0,7,2,4,1
THARPARKAR,DISTRICT,70 - 74,SEPERATION,15,5,10,0,15,5,10,0,0,0,0,0
THARPARKAR,DISTRICT,70 - 74,WIDOWED,4387,3494,893,0,3946,3114,832,0,441,380,61,0
THARPARKAR,DISTRICT,75 & ABOVE,DIVORCED,7,6,1,0,7,6,1,0,0,0,0,0
THARPARKAR,DISTRICT,75 & ABOVE,MARRIED,12879,4040,8839,0,12100,3821,8279,0,779,219,560,0
THARPARKAR,DISTRICT,75 & ABOVE,NEVER MARRIED,106,22,82,2,101,21,78,2,5,1,4,0
THARPARKAR,DISTRICT,75 & ABOVE,SEPERATION,23,7,16,0,23,7,16,0,0,0,0,0
THARPARKAR,DISTRICT,75 & ABOVE,WIDOWED,8210,6510,1700,0,7487,5908,1579,0,723,602,121,0
THATTA,DISTRICT,15 &  ABOVE,DIVORCED,805,527,278,0,528,339,189,0,277,188,89,0
THATTA,DISTRICT,15 &  ABOVE,MARRIED,410464,204944,205520,0,337217,168466,168751,0,73247,36478,36769,0
THATTA,DISTRICT,15 &  ABOVE,NEVER MARRIED,172495,71417,101040,38,137892,56308,81557,27,34603,15109,19483,11
THATTA,DISTRICT,15 &  ABOVE,SEPERATION,812,382,430,0,637,289,348,0,175,93,82,0
THATTA,DISTRICT,15 &  ABOVE,WIDOWED,19550,14456,5094,0,15763,11471,4292,0,3787,2985,802,0
THATTA,DISTRICT,15 - 19,DIVORCED,24,15,9,0,18,11,7,0,6,4,2,0
THATTA,DISTRICT,15 - 19,MARRIED,12632,8637,3995,0,10868,7398,3470,0,1764,1239,525,0
THATTA,DISTRICT,15 - 19,NEVER MARRIED,93319,42838,50470,11,75696,34412,41273,11,17623,8426,9197,0
THATTA,DISTRICT,15 - 19,SEPERATION,91,13,78,0,77,11,66,0,14,2,12,0
THATTA,DISTRICT,15 - 19,WIDOWED,52,17,35,0,45,14,31,0,7,3,4,0
THATTA,DISTRICT,20 - 24,DIVORCED,67,49,18,0,45,31,14,0,22,18,4,0
THATTA,DISTRICT,20 - 24,MARRIED,40624,25470,15154,0,33826,21118,12708,0,6798,4352,2446,0
THATTA,DISTRICT,20 - 24,NEVER MARRIED,39633,14718,24913,2,31002,11255,19746,1,8631,3463,5167,1
THATTA,DISTRICT,20 - 24,SEPERATION,82,37,45,0,66,28,38,0,16,9,7,0
THATTA,DISTRICT,20 - 24,WIDOWED,146,69,77,0,120,55,65,0,26,14,12,0
THATTA,DISTRICT,25 - 29,DIVORCED,99,64,35,0,62,38,24,0,37,26,11,0
THATTA,DISTRICT,25 - 29,MARRIED,56705,30525,26180,0,46275,24790,21485,0,10430,5735,4695,0
THATTA,DISTRICT,25 - 29,NEVER MARRIED,20172,7402,12766,4,15725,5577,10146,2,4447,1825,2620,2
THATTA,DISTRICT,25 - 29,SEPERATION,95,41,54,0,76,30,46,0,19,11,8,0
THATTA,DISTRICT,25 - 29,WIDOWED,258,142,116,0,204,107,97,0,54,35,19,0
THATTA,DISTRICT,30 - 34,DIVORCED,131,82,49,0,81,50,31,0,50,32,18,0
THATTA,DISTRICT,30 - 34,MARRIED,59519,31763,27756,0,48790,26044,22746,0,10729,5719,5010,0
THATTA,DISTRICT,30 - 34,NEVER MARRIED,8955,3007,5945,3,7109,2346,4761,2,1846,661,1184,1
THATTA,DISTRICT,30 - 34,SEPERATION,75,39,36,0,55,27,28,0,20,12,8,0
THATTA,DISTRICT,30 - 34,WIDOWED,466,299,167,0,394,245,149,0,72,54,18,0
THATTA,DISTRICT,35 - 39,DIVORCED,131,88,43,0,94,59,35,0,37,29,8,0
THATTA,DISTRICT,35 - 39,MARRIED,55899,27562,28337,0,45475,22496,22979,0,10424,5066,5358,0
THATTA,DISTRICT,35 - 39,NEVER MARRIED,4573,1487,3086,0,3658,1169,2489,0,915,318,597,0
THATTA,DISTRICT,35 - 39,SEPERATION,94,46,48,0,77,38,39,0,17,8,9,0
THATTA,DISTRICT,35 - 39,WIDOWED,714,478,236,0,578,380,198,0,136,98,38,0
THATTA,DISTRICT,40 - 44,DIVORCED,111,76,35,0,64,43,21,0,47,33,14,0
THATTA,DISTRICT,40 - 44,MARRIED,51131,23645,27486,0,42057,19448,22609,0,9074,4197,4877,0
THATTA,DISTRICT,40 - 44,NEVER MARRIED,2502,784,1715,3,2051,634,1415,2,451,150,300,1
THATTA,DISTRICT,40 - 44,SEPERATION,87,44,43,0,61,31,30,0,26,13,13,0
THATTA,DISTRICT,40 - 44,WIDOWED,1161,798,363,0,961,648,313,0,200,150,50,0
THATTA,DISTRICT,45 - 49,DIVORCED,81,51,30,0,56,38,18,0,25,13,12,0
THATTA,DISTRICT,45 - 49,MARRIED,40224,18765,21459,0,32970,15349,17621,0,7254,3416,3838,0
THATTA,DISTRICT,45 - 49,NEVER MARRIED,1451,507,940,4,1160,399,759,2,291,108,181,2
THATTA,DISTRICT,45 - 49,SEPERATION,82,48,34,0,64,40,24,0,18,8,10,0
THATTA,DISTRICT,45 - 49,WIDOWED,1432,1052,380,0,1139,827,312,0,293,225,68,0
THATTA,DISTRICT,50 - 54,DIVORCED,62,42,20,0,39,28,11,0,23,14,9,0
THATTA,DISTRICT,50 - 54,MARRIED,31038,13592,17446,0,25453,11177,14276,0,5585,2415,3170,0
THATTA,DISTRICT,50 - 54,NEVER MARRIED,775,276,495,4,604,216,386,2,171,60,109,2
THATTA,DISTRICT,50 - 54,SEPERATION,66,40,26,0,54,33,21,0,12,7,5,0
THATTA,DISTRICT,50 - 54,WIDOWED,2093,1585,508,0,1701,1259,442,0,392,326,66,0
THATTA,DISTRICT,55 - 59,DIVORCED,47,26,21,0,28,15,13,0,19,11,8,0
THATTA,DISTRICT,55 - 59,MARRIED,22851,9449,13402,0,18583,7705,10878,0,4268,1744,2524,0
THATTA,DISTRICT,55 - 59,NEVER MARRIED,488,177,309,2,389,136,251,2,99,41,58,0
THATTA,DISTRICT,55 - 59,SEPERATION,48,27,21,0,35,18,17,0,13,9,4,0
THATTA,DISTRICT,55 - 59,WIDOWED,2247,1623,624,0,1765,1230,535,0,482,393,89,0
THATTA,DISTRICT,60 - 64,DIVORCED,25,15,10,0,22,13,9,0,3,2,1,0
THATTA,DISTRICT,60 - 64,MARRIED,15657,6585,9072,0,12860,5466,7394,0,2797,1119,1678,0
THATTA,DISTRICT,60 - 64,NEVER MARRIED,274,100,171,3,215,77,136,2,59,23,35,1
THATTA,DISTRICT,60 - 64,SEPERATION,37,20,17,0,27,12,15,0,10,8,2,0
THATTA,DISTRICT,60 - 64,WIDOWED,2478,1953,525,0,1966,1536,430,0,512,417,95,0
THATTA,DISTRICT,65 - 69,DIVORCED,13,8,5,0,10,6,4,0,3,2,1,0
THATTA,DISTRICT,65 - 69,MARRIED,10911,4368,6543,0,8900,3592,5308,0,2011,776,1235,0
THATTA,DISTRICT,65 - 69,NEVER MARRIED,171,66,104,1,133,48,85,0,38,18,19,1
THATTA,DISTRICT,65 - 69,SEPERATION,20,10,10,0,16,7,9,0,4,3,1,0
THATTA,DISTRICT,65 - 69,WIDOWED,2476,1871,605,0,2000,1490,510,0,476,381,95,0
THATTA,DISTRICT,70 - 74,DIVORCED,6,5,1,0,3,3,0,0,3,2,1,0
THATTA,DISTRICT,70 - 74,MARRIED,7481,2718,4763,0,6212,2279,3933,0,1269,439,830,0
THATTA,DISTRICT,70 - 74,NEVER MARRIED,89,27,62,0,76,20,56,0,13,7,6,0
THATTA,DISTRICT,70 - 74,SEPERATION,16,9,7,0,12,7,5,0,4,2,2,0
THATTA,DISTRICT,70 - 74,WIDOWED,2602,1975,627,0,2097,1578,519,0,505,397,108,0
THATTA,DISTRICT,75 & ABOVE,DIVORCED,8,6,2,0,6,4,2,0,2,2,0,0
THATTA,DISTRICT,75 & ABOVE,MARRIED,5792,1865,3927,0,4948,1604,3344,0,844,261,583,0
THATTA,DISTRICT,75 & ABOVE,NEVER MARRIED,93,28,64,1,74,19,54,1,19,9,10,0
THATTA,DISTRICT,75 & ABOVE,SEPERATION,19,8,11,0,17,7,10,0,2,1,1,0
THATTA,DISTRICT,75 & ABOVE,WIDOWED,3425,2594,831,0,2793,2102,691,0,632,492,140,0
UMER KOT,DISTRICT,15 &  ABOVE,DIVORCED,726,470,256,0,452,307,145,0,274,163,111,0
UMER KOT,DISTRICT,15 &  ABOVE,MARRIED,446485,223527,222958,0,340624,170758,169866,0,105861,52769,53092,0
UMER KOT,DISTRICT,15 &  ABOVE,NEVER MARRIED,133893,49570,84303,20,94578,34399,60168,11,39315,15171,24135,9
UMER KOT,DISTRICT,15 &  ABOVE,SEPERATION,504,303,201,0,387,232,155,0,117,71,46,0
UMER KOT,DISTRICT,15 &  ABOVE,WIDOWED,22932,18650,4282,0,16977,13749,3228,0,5955,4901,1054,0
UMER KOT,DISTRICT,15 - 19,DIVORCED,11,9,2,0,7,5,2,0,4,4,0,0
UMER KOT,DISTRICT,15 - 19,MARRIED,16166,10270,5896,0,13308,8379,4929,0,2858,1891,967,0
UMER KOT,DISTRICT,15 - 19,NEVER MARRIED,85326,34598,50725,3,63193,25190,38001,2,22133,9408,12724,1
UMER KOT,DISTRICT,15 - 19,SEPERATION,22,11,11,0,22,11,11,0,0,0,0,0
UMER KOT,DISTRICT,15 - 19,WIDOWED,30,18,12,0,27,15,12,0,3,3,0,0
UMER KOT,DISTRICT,20 - 24,DIVORCED,78,60,18,0,60,48,12,0,18,12,6,0
UMER KOT,DISTRICT,20 - 24,MARRIED,61357,35638,25719,0,50037,28669,21368,0,11320,6969,4351,0
UMER KOT,DISTRICT,20 - 24,NEVER MARRIED,30148,9610,20535,3,19520,5811,13706,3,10628,3799,6829,0
UMER KOT,DISTRICT,20 - 24,SEPERATION,55,31,24,0,47,26,21,0,8,5,3,0
UMER KOT,DISTRICT,20 - 24,WIDOWED,146,80,66,0,128,69,59,0,18,11,7,0
UMER KOT,DISTRICT,25 - 29,DIVORCED,138,84,54,0,94,59,35,0,44,25,19,0
UMER KOT,DISTRICT,25 - 29,MARRIED,64791,33033,31758,0,49660,25006,24654,0,15131,8027,7104,0
UMER KOT,DISTRICT,25 - 29,NEVER MARRIED,10922,3003,7918,1,6770,1742,5027,1,4152,1261,2891,0
UMER KOT,DISTRICT,25 - 29,SEPERATION,53,31,22,0,42,26,16,0,11,5,6,0
UMER KOT,DISTRICT,25 - 29,WIDOWED,224,138,86,0,182,110,72,0,42,28,14,0
UMER KOT,DISTRICT,30 - 34,DIVORCED,141,92,49,0,86,61,25,0,55,31,24,0
UMER KOT,DISTRICT,30 - 34,MARRIED,62601,31744,30857,0,47009,23969,23040,0,15592,7775,7817,0
UMER KOT,DISTRICT,30 - 34,NEVER MARRIED,3754,1085,2667,2,2513,757,1754,2,1241,328,913,0
UMER KOT,DISTRICT,30 - 34,SEPERATION,64,41,23,0,48,31,17,0,16,10,6,0
UMER KOT,DISTRICT,30 - 34,WIDOWED,470,340,130,0,369,265,104,0,101,75,26,0
UMER KOT,DISTRICT,35 - 39,DIVORCED,110,66,44,0,71,44,27,0,39,22,17,0
UMER KOT,DISTRICT,35 - 39,MARRIED,59441,29527,29914,0,44285,22136,22149,0,15156,7391,7765,0
UMER KOT,DISTRICT,35 - 39,NEVER MARRIED,1669,514,1154,1,1137,357,779,1,532,157,375,0
UMER KOT,DISTRICT,35 - 39,SEPERATION,49,34,15,0,34,23,11,0,15,11,4,0
UMER KOT,DISTRICT,35 - 39,WIDOWED,818,619,199,0,604,457,147,0,214,162,52,0
UMER KOT,DISTRICT,40 - 44,DIVORCED,101,74,27,0,52,39,13,0,49,35,14,0
UMER KOT,DISTRICT,40 - 44,MARRIED,56862,28210,28652,0,42720,21222,21498,0,14142,6988,7154,0
UMER KOT,DISTRICT,40 - 44,NEVER MARRIED,908,330,574,4,628,241,387,0,280,89,187,4
UMER KOT,DISTRICT,40 - 44,SEPERATION,73,45,28,0,55,35,20,0,18,10,8,0
UMER KOT,DISTRICT,40 - 44,WIDOWED,1421,1144,277,0,1056,834,222,0,365,310,55,0
UMER KOT,DISTRICT,45 - 49,DIVORCED,67,36,31,0,37,20,17,0,30,16,14,0
UMER KOT,DISTRICT,45 - 49,MARRIED,36505,17405,19100,0,27090,12964,14126,0,9415,4441,4974,0
UMER KOT,DISTRICT,45 - 49,NEVER MARRIED,465,152,311,2,317,104,212,1,148,48,99,1
UMER KOT,DISTRICT,45 - 49,SEPERATION,59,37,22,0,36,22,14,0,23,15,8,0
UMER KOT,DISTRICT,45 - 49,WIDOWED,1582,1323,259,0,1160,967,193,0,422,356,66,0
UMER KOT,DISTRICT,50 - 54,DIVORCED,44,25,19,0,27,17,10,0,17,8,9,0
UMER KOT,DISTRICT,50 - 54,MARRIED,31906,14961,16945,0,23861,11193,12668,0,8045,3768,4277,0
UMER KOT,DISTRICT,50 - 54,NEVER MARRIED,266,109,155,2,183,74,108,1,83,35,47,1
UMER KOT,DISTRICT,50 - 54,SEPERATION,43,23,20,0,35,18,17,0,8,5,3,0
UMER KOT,DISTRICT,50 - 54,WIDOWED,2364,1972,392,0,1750,1455,295,0,614,517,97,0
UMER KOT,DISTRICT,55 - 59,DIVORCED,15,10,5,0,7,5,2,0,8,5,3,0
UMER KOT,DISTRICT,55 - 59,MARRIED,21773,8928,12845,0,15986,6600,9386,0,5787,2328,3459,0
UMER KOT,DISTRICT,55 - 59,NEVER MARRIED,169,64,105,0,121,46,75,0,48,18,30,0
UMER KOT,DISTRICT,55 - 59,SEPERATION,33,23,10,0,24,17,7,0,9,6,3,0
UMER KOT,DISTRICT,55 - 59,WIDOWED,2333,1884,449,0,1655,1320,335,0,678,564,114,0
UMER KOT,DISTRICT,60 - 64,DIVORCED,12,9,3,0,6,5,1,0,6,4,2,0
UMER KOT,DISTRICT,60 - 64,MARRIED,13245,5571,7674,0,9907,4271,5636,0,3338,1300,2038,0
UMER KOT,DISTRICT,60 - 64,NEVER MARRIED,117,48,68,1,87,39,48,0,30,9,20,1
UMER KOT,DISTRICT,60 - 64,SEPERATION,22,14,8,0,15,10,5,0,7,4,3,0
UMER KOT,DISTRICT,60 - 64,WIDOWED,2527,2094,433,0,1853,1544,309,0,674,550,124,0
UMER KOT,DISTRICT,65 - 69,DIVORCED,5,3,2,0,4,3,1,0,1,0,1,0
UMER KOT,DISTRICT,65 - 69,MARRIED,9659,4017,5642,0,7262,3017,4245,0,2397,1000,1397,0
UMER KOT,DISTRICT,65 - 69,NEVER MARRIED,72,32,40,0,52,21,31,0,20,11,9,0
UMER KOT,DISTRICT,65 - 69,SEPERATION,11,9,2,0,10,9,1,0,1,0,1,0
UMER KOT,DISTRICT,65 - 69,WIDOWED,2902,2424,478,0,2072,1723,349,0,830,701,129,0
UMER KOT,DISTRICT,70 - 74,DIVORCED,3,2,1,0,1,1,0,0,2,1,1,0
UMER KOT,DISTRICT,70 - 74,MARRIED,6810,2569,4241,0,5248,1999,3249,0,1562,570,992,0
UMER KOT,DISTRICT,70 - 74,NEVER MARRIED,46,16,29,1,32,10,22,0,14,6,7,1
UMER KOT,DISTRICT,70 - 74,SEPERATION,11,3,8,0,10,3,7,0,1,0,1,0
UMER KOT,DISTRICT,70 - 74,WIDOWED,3218,2653,565,0,2431,2013,418,0,787,640,147,0
UMER KOT,DISTRICT,75 & ABOVE,DIVORCED,1,0,1,0,0,0,0,0,1,0,1,0
UMER KOT,DISTRICT,75 & ABOVE,MARRIED,5369,1654,3715,0,4251,1333,2918,0,1118,321,797,0
UMER KOT,DISTRICT,75 & ABOVE,NEVER MARRIED,31,9,22,0,25,7,18,0,6,2,4,0
UMER KOT,DISTRICT,75 & ABOVE,SEPERATION,9,1,8,0,9,1,8,0,0,0,0,0
UMER KOT,DISTRICT,75 & ABOVE,WIDOWED,4897,3961,936,0,3690,2977,713,0,1207,984,223,0
