name_admin_unit,part_of_district,admin_unit,sex___age_group__in_years_,all_sexes_overall,male_overall,female_overall,transgender_overall,all_sexes_rural,male_rural,female_rural,transgender_rural,all_sexes_urban,male_urban,female_urban,transgender_urban
ATTOCK,ATTOCK,DISTRICT,ALL AGES,2133005,1071693,1061231,81,1546356,775739,770599,18,586649,295954,290632,63
ATTOCK,ATTOCK,DISTRICT,UNDER 1,36042,18112,17930,,26655,13481,13174,,9387,4631,4756,
ATTOCK,ATTOCK,DISTRICT,UNDER 5,242301,121659,120642,,176066,88443,87623,,66235,33216,33019,
ATTOCK,ATTOCK,DISTRICT,UNDER 10,473463,237549,235914,,342189,171683,170506,,131274,65866,65408,
ATTOCK,ATTOCK,DISTRICT,UNDER 15,704284,353986,350297,1,505659,253890,251768,1,198625,100096,98529,
ATTOCK,ATTOCK,DISTRICT,05 - 24,838749,421934,416790,25,600830,301502,299320,8,237919,120432,117470,17
ATTOCK,ATTOCK,DISTRICT,15 - 49,1085185,538321,546791,73,782199,387552,394632,15,302986,150769,152159,58
ATTOCK,ATTOCK,DISTRICT,15 - 64,1311285,656132,655075,78,949693,474262,475415,16,361592,181870,179660,62
ATTOCK,ATTOCK,DISTRICT,18 - 60,1140222,567567,572584,71,826114,410873,415229,12,314108,156694,157355,59
ATTOCK,ATTOCK,DISTRICT,18 &  ABOVE,1304558,654717,649767,74,952003,477354,474636,13,352555,177363,175131,61
ATTOCK,ATTOCK,DISTRICT,60 &  ABOVE,178447,94363,84081,3,136384,71869,64514,1,42063,22494,19567,2
ATTOCK,ATTOCK,DISTRICT,65 &  ABOVE,117436,61575,55859,2,91004,47587,43416,1,26432,13988,12443,1
BAHAWALNAGAR,BAHAWALNAGAR,DISTRICT,ALL AGES,3544911,1842888,1701653,370,2571296,1336950,1234246,100,973615,505938,467407,270
BAHAWALNAGAR,BAHAWALNAGAR,DISTRICT,UNDER 1,82644,42545,40099,,62428,32064,30364,,20216,10481,9735,
BAHAWALNAGAR,BAHAWALNAGAR,DISTRICT,UNDER 5,492678,255505,237173,,372426,193408,179018,,120252,62097,58155,
BAHAWALNAGAR,BAHAWALNAGAR,DISTRICT,UNDER 10,971921,506050,465871,,730322,380606,349716,,241599,125444,116155,
BAHAWALNAGAR,BAHAWALNAGAR,DISTRICT,UNDER 15,1422368,750449,671905,14,1054742,555502,499229,11,367626,194947,172676,3
BAHAWALNAGAR,BAHAWALNAGAR,DISTRICT,05 - 24,1564111,823528,740475,108,1130720,594490,536191,39,433391,229038,204284,69
BAHAWALNAGAR,BAHAWALNAGAR,DISTRICT,15 - 49,1656708,843332,813067,309,1176647,599750,576820,77,480061,243582,236247,232
BAHAWALNAGAR,BAHAWALNAGAR,DISTRICT,15 - 64,1978187,1013649,964189,349,1407922,721982,685852,88,570265,291667,278337,261
BAHAWALNAGAR,BAHAWALNAGAR,DISTRICT,18 - 60,1699512,864400,834789,323,1210292,616534,593687,71,489220,247866,241102,252
BAHAWALNAGAR,BAHAWALNAGAR,DISTRICT,18 &  ABOVE,1905181,976156,928692,333,1363059,699601,663386,72,542122,276555,265306,261
BAHAWALNAGAR,BAHAWALNAGAR,DISTRICT,60 &  ABOVE,225309,122029,103265,15,167221,90600,76618,3,58088,31429,26647,12
BAHAWALNAGAR,BAHAWALNAGAR,DISTRICT,65 &  ABOVE,144356,78790,65559,7,108632,59466,49165,1,35724,19324,16394,6
BAHAWALPUR,BAHAWALPUR,DISTRICT,ALL AGES,4264457,2165158,2098830,469,2662487,1350146,1312204,137,1601970,815012,786626,332
BAHAWALPUR,BAHAWALPUR,DISTRICT,UNDER 1,98488,49555,48933,,65236,33071,32165,,33252,16484,16768,
BAHAWALPUR,BAHAWALPUR,DISTRICT,UNDER 5,648391,327153,321238,,425688,214443,211245,,222703,112710,109993,
BAHAWALPUR,BAHAWALPUR,DISTRICT,UNDER 10,1231401,621096,610305,,810526,408308,402218,,420875,212788,208087,
BAHAWALPUR,BAHAWALPUR,DISTRICT,UNDER 15,1743712,880903,862791,18,1134011,572023,561978,10,609701,308880,300813,8
BAHAWALPUR,BAHAWALPUR,DISTRICT,05 - 24,1867130,942704,924269,157,1168874,589304,579525,45,698256,353400,344744,112
BAHAWALPUR,BAHAWALPUR,DISTRICT,15 - 49,2012350,1013130,998815,405,1212500,610455,601937,108,799850,402675,396878,297
BAHAWALPUR,BAHAWALPUR,DISTRICT,15 - 64,2365200,1200957,1163802,441,1427203,724072,703010,121,937997,476885,460792,320
BAHAWALPUR,BAHAWALPUR,DISTRICT,18 - 60,2047295,1036582,1010307,406,1233367,624817,608444,106,813928,411765,401863,300
BAHAWALPUR,BAHAWALPUR,DISTRICT,18 &  ABOVE,2270437,1156101,1113919,417,1375694,700450,675132,112,894743,455651,438787,305
BAHAWALPUR,BAHAWALPUR,DISTRICT,60 &  ABOVE,244347,130869,113462,16,155150,82487,72656,7,89197,48382,40806,9
BAHAWALPUR,BAHAWALPUR,DISTRICT,65 &  ABOVE,155545,83298,72237,10,101273,54051,47216,6,54272,29247,25021,4
BHAKKAR,BHAKKAR,DISTRICT,ALL AGES,1956971,1016124,940770,77,1604680,833033,771611,36,352291,183091,169159,41
BHAKKAR,BHAKKAR,DISTRICT,UNDER 1,74322,40225,34097,,61743,33508,28235,,12579,6717,5862,
BHAKKAR,BHAKKAR,DISTRICT,UNDER 5,350083,188537,161546,,290240,155990,134250,,59843,32547,27296,
BHAKKAR,BHAKKAR,DISTRICT,UNDER 10,593924,314658,279266,,493889,261481,232408,,100035,53177,46858,
BHAKKAR,BHAKKAR,DISTRICT,UNDER 15,810806,429024,381779,3,673154,355791,317360,3,137652,73233,64419,
BHAKKAR,BHAKKAR,DISTRICT,05 - 24,801860,416700,385136,24,661033,343482,317536,15,140827,73218,67600,9
BHAKKAR,BHAKKAR,DISTRICT,15 - 49,902627,456285,446278,64,732486,370118,362339,29,170141,86167,83939,35
BHAKKAR,BHAKKAR,DISTRICT,15 - 64,1070920,545969,524878,73,869179,442971,426175,33,201741,102998,98703,40
BHAKKAR,BHAKKAR,DISTRICT,18 - 60,923928,468016,455851,61,749521,379710,369785,26,174407,88306,86066,35
BHAKKAR,BHAKKAR,DISTRICT,18 &  ABOVE,1032028,527089,504875,64,838142,428258,409858,26,193886,98831,95017,38
BHAKKAR,BHAKKAR,DISTRICT,60 &  ABOVE,117485,64170,53311,4,96215,52712,43503,,21270,11458,9808,4
BHAKKAR,BHAKKAR,DISTRICT,65 &  ABOVE,75245,41131,34113,1,62347,34271,28076,,12898,6860,6037,1
CHAKWAL,CHAKWAL,DISTRICT,ALL AGES,1731689,862509,869091,89,1296931,643656,653260,15,434758,218853,215831,74
CHAKWAL,CHAKWAL,DISTRICT,UNDER 1,41580,19629,21951,,31300,14863,16437,,10280,4766,5514,
CHAKWAL,CHAKWAL,DISTRICT,UNDER 5,223007,110124,112883,,164308,81422,82886,,58699,28702,29997,
CHAKWAL,CHAKWAL,DISTRICT,UNDER 10,398401,198531,199870,,293390,146627,146763,,105011,51904,53107,
CHAKWAL,CHAKWAL,DISTRICT,UNDER 15,571696,288862,282829,5,420098,212459,207639,,151598,76403,75190,5
CHAKWAL,CHAKWAL,DISTRICT,05 - 24,635359,325385,309943,31,466912,238257,228651,4,168447,87128,81292,27
CHAKWAL,CHAKWAL,DISTRICT,15 - 49,852566,418660,433835,71,636908,311352,325543,13,215658,107308,108292,58
CHAKWAL,CHAKWAL,DISTRICT,15 - 64,1045873,515709,530083,81,785656,385538,400104,14,260217,130171,129979,67
CHAKWAL,CHAKWAL,DISTRICT,18 - 60,907706,443248,464388,70,682872,332145,350714,13,224834,111103,113674,57
CHAKWAL,CHAKWAL,DISTRICT,18 &  ABOVE,1065414,523722,541617,75,808107,395293,412800,14,257307,128429,128817,61
CHAKWAL,CHAKWAL,DISTRICT,60 &  ABOVE,168649,86082,82561,6,133485,67374,66110,1,35164,18708,16451,5
CHAKWAL,CHAKWAL,DISTRICT,65 &  ABOVE,114120,57938,56179,3,91177,45659,45517,1,22943,12279,10662,2
CHINIOT,CHINIOT,DISTRICT,ALL AGES,1563024,790731,772126,167,1071352,542708,528595,49,491672,248023,243531,118
CHINIOT,CHINIOT,DISTRICT,UNDER 1,36916,18690,18226,,27007,13710,13297,,9909,4980,4929,
CHINIOT,CHINIOT,DISTRICT,UNDER 5,216063,108882,107181,,155898,78799,77099,,60165,30083,30082,
CHINIOT,CHINIOT,DISTRICT,UNDER 10,417070,209934,207136,,298053,150589,147464,,119017,59345,59672,
CHINIOT,CHINIOT,DISTRICT,UNDER 15,603222,304122,299099,1,423677,214321,209355,1,179545,89801,89744,
CHINIOT,CHINIOT,DISTRICT,05 - 24,668831,336926,331854,51,455900,230501,225381,18,212931,106425,106473,33
CHINIOT,CHINIOT,DISTRICT,15 - 49,743672,371489,372035,148,496112,247599,248474,39,247560,123890,123561,109
CHINIOT,CHINIOT,DISTRICT,15 - 64,887859,447315,440384,160,595423,299871,295506,46,292436,147444,144878,114
CHINIOT,CHINIOT,DISTRICT,18 - 60,763091,383099,379848,144,511106,256308,254759,39,251985,126791,125089,105
CHINIOT,CHINIOT,DISTRICT,18 &  ABOVE,864151,437784,426215,152,583620,295473,288106,41,280531,142311,138109,111
CHINIOT,CHINIOT,DISTRICT,60 &  ABOVE,110984,59825,51150,9,79521,42781,36738,2,31463,17044,14412,7
CHINIOT,CHINIOT,DISTRICT,65 &  ABOVE,71943,39294,32643,6,52252,28516,23734,2,19691,10778,8909,4
DERA GHAZI KHAN,DERA GHAZI KHAN,DISTRICT,ALL AGES,3386575,1709510,1676944,121,2581903,1302359,1279508,36,804672,407151,397436,85
DERA GHAZI KHAN,DERA GHAZI KHAN,DISTRICT,UNDER 1,87925,44459,43466,,69280,35211,34069,,18645,9248,9397,
DERA GHAZI KHAN,DERA GHAZI KHAN,DISTRICT,UNDER 5,623649,314290,309359,,494060,249067,244993,,129589,65223,64366,
DERA GHAZI KHAN,DERA GHAZI KHAN,DISTRICT,UNDER 10,1151122,580555,570567,,914339,461297,453042,,236783,119258,117525,
DERA GHAZI KHAN,DERA GHAZI KHAN,DISTRICT,UNDER 15,1582819,799820,782995,4,1247040,630570,616467,3,335779,169250,166528,1
DERA GHAZI KHAN,DERA GHAZI KHAN,DISTRICT,05 - 24,1555455,785506,769889,60,1199569,606038,593515,16,355886,179468,176374,44
DERA GHAZI KHAN,DERA GHAZI KHAN,DISTRICT,15 - 49,1461488,728783,732598,107,1081325,538454,542843,28,380163,190329,189755,79
DERA GHAZI KHAN,DERA GHAZI KHAN,DISTRICT,15 - 64,1690929,849340,841474,115,1248775,625766,622977,32,442154,223574,218497,83
DERA GHAZI KHAN,DERA GHAZI KHAN,DISTRICT,18 - 60,1448654,723104,725443,107,1068471,531980,536466,25,380183,191124,188977,82
DERA GHAZI KHAN,DERA GHAZI KHAN,DISTRICT,18 &  ABOVE,1605777,807240,798427,110,1186825,595157,591641,27,418952,212083,206786,83
DERA GHAZI KHAN,DERA GHAZI KHAN,DISTRICT,60 &  ABOVE,172025,92026,79995,4,129389,69063,60323,3,42636,22963,19672,1
DERA GHAZI KHAN,DERA GHAZI KHAN,DISTRICT,65 &  ABOVE,112827,60350,52475,2,86088,46023,40064,1,26739,14327,12411,1
FAISALABAD,FAISALABAD,DISTRICT,ALL AGES,9065306,4726182,4338162,962,4682740,2438955,2243493,292,4382566,2287227,2094669,670
FAISALABAD,FAISALABAD,DISTRICT,UNDER 1,193174,100353,92821,,110605,57546,53059,,82569,42807,39762,
FAISALABAD,FAISALABAD,DISTRICT,UNDER 5,1165432,603576,561856,,633713,328687,305026,,531719,274889,256830,
FAISALABAD,FAISALABAD,DISTRICT,UNDER 10,2200114,1133806,1066308,,1197733,618432,579301,,1002381,515374,487007,
FAISALABAD,FAISALABAD,DISTRICT,UNDER 15,3206901,1663385,1543489,27,1725619,896289,829315,15,1481282,767096,714174,12
FAISALABAD,FAISALABAD,DISTRICT,05 - 24,3769171,1961205,1807693,273,1958010,1018391,939524,95,1811161,942814,868169,178
FAISALABAD,FAISALABAD,DISTRICT,15 - 49,4662304,2409766,2251741,797,2327148,1199076,1127847,225,2335156,1210690,1123894,572
FAISALABAD,FAISALABAD,DISTRICT,15 - 64,5504718,2863176,2640633,909,2757707,1430160,1327285,262,2747011,1433016,1313348,647
FAISALABAD,FAISALABAD,DISTRICT,18 - 60,4786338,2480490,2304987,861,2384583,1231511,1152830,242,2401755,1248979,1152157,619
FAISALABAD,FAISALABAD,DISTRICT,18 &  ABOVE,5310172,2774294,2534980,898,2672530,1392940,1279329,261,2637642,1381354,1255651,637
FAISALABAD,FAISALABAD,DISTRICT,60 &  ABOVE,576731,321972,254710,49,315386,176016,139350,20,261345,145956,115360,29
FAISALABAD,FAISALABAD,DISTRICT,65 &  ABOVE,353687,199621,154040,26,199414,112506,86893,15,154273,87115,67147,11
GUJRANWALA,GUJRANWALA,DISTRICT,ALL AGES,5940173,3018895,2920741,537,2365418,1193507,1171757,154,3574755,1825388,1748984,383
GUJRANWALA,GUJRANWALA,DISTRICT,UNDER 1,146099,73723,72376,,63674,32101,31573,,82425,41622,40803,
GUJRANWALA,GUJRANWALA,DISTRICT,UNDER 5,923550,466571,456979,,369663,186388,183275,,553887,280183,273704,
GUJRANWALA,GUJRANWALA,DISTRICT,UNDER 10,1594275,803782,790493,,643982,324204,319778,,950293,479578,470715,
GUJRANWALA,GUJRANWALA,DISTRICT,UNDER 15,2280331,1150513,1129799,19,917125,461743,455375,7,1363206,688770,674424,12
GUJRANWALA,GUJRANWALA,DISTRICT,05 - 24,2483033,1250706,1232139,188,998095,499147,498889,59,1484938,751559,733250,129
GUJRANWALA,GUJRANWALA,DISTRICT,15 - 49,2937561,1469437,1467666,458,1148205,567107,580975,123,1789356,902330,886691,335
GUJRANWALA,GUJRANWALA,DISTRICT,15 - 64,3447222,1745001,1701713,508,1354030,677797,676091,142,2093192,1067204,1025622,366
GUJRANWALA,GUJRANWALA,DISTRICT,18 - 60,2984037,1505832,1477738,467,1167006,582426,584455,125,1817031,923406,893283,342
GUJRANWALA,GUJRANWALA,DISTRICT,18 &  ABOVE,3294658,1684070,1610107,481,1301563,658811,642619,133,1993095,1025259,967488,348
GUJRANWALA,GUJRANWALA,DISTRICT,60 &  ABOVE,347142,198048,149072,22,148518,83829,64680,9,198624,114219,84392,13
GUJRANWALA,GUJRANWALA,DISTRICT,65 &  ABOVE,212620,123381,89229,10,94263,53967,40291,5,118357,69414,48938,5
GUJRAT,GUJRAT,DISTRICT,ALL AGES,3216000,1606601,1609209,190,1892820,934454,958324,42,1323180,672147,650885,148
GUJRAT,GUJRAT,DISTRICT,UNDER 1,60971,30448,30523,,37840,18825,19015,,23131,11623,11508,
GUJRAT,GUJRAT,DISTRICT,UNDER 5,378857,188910,189947,,225969,112634,113335,,152888,76276,76612,
GUJRAT,GUJRAT,DISTRICT,UNDER 10,717826,358124,359702,,426133,212659,213474,,291693,145465,146228,
GUJRAT,GUJRAT,DISTRICT,UNDER 15,1068091,532399,535688,4,632055,314938,317116,1,436036,217461,218572,3
GUJRAT,GUJRAT,DISTRICT,05 - 24,1280088,636402,643637,49,753971,373171,380789,11,526117,263231,262848,38
GUJRAT,GUJRAT,DISTRICT,15 - 49,1644055,809992,833917,146,950623,458868,491729,26,693432,351124,342188,120
GUJRAT,GUJRAT,DISTRICT,15 - 64,1969462,977219,992067,176,1145128,557646,587446,36,824334,419573,404621,140
GUJRAT,GUJRAT,DISTRICT,18 - 60,1710528,846184,864187,157,990587,480335,510224,28,719941,365849,353963,129
GUJRAT,GUJRAT,DISTRICT,18 &  ABOVE,1959045,979843,979029,173,1148900,564146,584720,34,810145,415697,394309,139
GUJRAT,GUJRAT,DISTRICT,60 &  ABOVE,269808,144553,125239,16,171226,90350,80870,6,98582,54203,44369,10
GUJRAT,GUJRAT,DISTRICT,65 &  ABOVE,178447,96983,81454,10,115637,61870,53762,5,62810,35113,27692,5
HAFIZABAD,HAFIZABAD,DISTRICT,ALL AGES,1319651,669900,649691,60,815517,414531,400966,20,504134,255369,248725,40
HAFIZABAD,HAFIZABAD,DISTRICT,UNDER 1,28927,14644,14283,,18207,9311,8896,,10720,5333,5387,
HAFIZABAD,HAFIZABAD,DISTRICT,UNDER 5,178061,89484,88577,,111224,56164,55060,,66837,33320,33517,
HAFIZABAD,HAFIZABAD,DISTRICT,UNDER 10,331008,166168,164840,,207105,104325,102780,,123903,61843,62060,
HAFIZABAD,HAFIZABAD,DISTRICT,UNDER 15,484473,243312,241159,2,301503,151754,149747,2,182970,91558,91412,
HAFIZABAD,HAFIZABAD,DISTRICT,05 - 24,555929,279186,276725,18,342353,172283,170062,8,213576,106903,106663,10
HAFIZABAD,HAFIZABAD,DISTRICT,15 - 49,656233,327975,328209,49,398949,199308,199624,17,257284,128667,128585,32
HAFIZABAD,HAFIZABAD,DISTRICT,15 - 64,776096,392770,383268,58,473686,239705,233963,18,302410,153065,149305,40
HAFIZABAD,HAFIZABAD,DISTRICT,18 - 60,670602,338764,331786,52,408774,206406,202353,15,261828,132358,129433,37
HAFIZABAD,HAFIZABAD,DISTRICT,18 &  ABOVE,752477,385101,367324,52,463481,237346,226120,15,288996,147755,141204,37
HAFIZABAD,HAFIZABAD,DISTRICT,60 &  ABOVE,90727,51092,39634,1,60336,33922,26414,,30391,17170,13220,1
HAFIZABAD,HAFIZABAD,DISTRICT,65 &  ABOVE,59082,33818,25264,,40328,23072,17256,,18754,10746,8008,
JHANG,JHANG,DISTRICT,ALL AGES,3065639,1585616,1479771,252,2264713,1172367,1092267,79,800926,413249,387504,173
JHANG,JHANG,DISTRICT,UNDER 1,74492,39238,35254,,56066,29712,26354,,18426,9526,8900,
JHANG,JHANG,DISTRICT,UNDER 5,432004,224909,207095,,329753,171747,158006,,102251,53162,49089,
JHANG,JHANG,DISTRICT,UNDER 10,837169,433834,403335,,640039,332021,308018,,197130,101813,95317,
JHANG,JHANG,DISTRICT,UNDER 15,1205557,628236,577318,3,914452,477042,437408,2,291105,151194,139910,1
JHANG,JHANG,DISTRICT,05 - 24,1329508,692549,636883,76,987477,515459,471999,19,342031,177090,164884,57
JHANG,JHANG,DISTRICT,15 - 49,1455060,740870,713970,220,1048997,534076,514859,62,406063,206794,199111,158
JHANG,JHANG,DISTRICT,15 - 64,1729240,885532,843468,240,1249518,639743,609703,72,479722,245789,233765,168
JHANG,JHANG,DISTRICT,18 - 60,1489393,757224,731947,222,1075057,546537,528457,63,414336,210687,203490,159
JHANG,JHANG,DISTRICT,18 &  ABOVE,1674414,858369,815808,237,1215627,623526,592031,70,458787,234843,223777,167
JHANG,JHANG,DISTRICT,60 &  ABOVE,201765,109868,91879,18,152933,83402,69523,8,48832,26466,22356,10
JHANG,JHANG,DISTRICT,65 &  ABOVE,130842,71848,58985,9,100743,55582,45156,5,30099,16266,13829,4
JHELUM,JHELUM,DISTRICT,ALL AGES,1366297,695983,670216,98,837927,425051,412859,17,528370,270932,257357,81
JHELUM,JHELUM,DISTRICT,UNDER 1,22792,11703,11089,,14355,7363,6992,,8437,4340,4097,
JHELUM,JHELUM,DISTRICT,UNDER 5,147274,75478,71796,,91780,47079,44701,,55494,28399,27095,
JHELUM,JHELUM,DISTRICT,UNDER 10,284927,145031,139896,,176313,89891,86422,,108614,55140,53474,
JHELUM,JHELUM,DISTRICT,UNDER 15,425753,219149,206603,1,261259,134356,126902,1,164494,84793,79701,
JHELUM,JHELUM,DISTRICT,05 - 24,521211,268749,252447,15,316496,162621,153869,6,204715,106128,98578,9
JHELUM,JHELUM,DISTRICT,15 - 49,709184,357147,351955,82,429836,215380,214442,14,279348,141767,137513,68
JHELUM,JHELUM,DISTRICT,15 - 64,859846,434113,425639,94,523313,262712,260585,16,336533,171401,165054,78
JHELUM,JHELUM,DISTRICT,18 - 60,748701,375765,372847,89,455130,227086,228029,15,293571,148679,144818,74
JHELUM,JHELUM,DISTRICT,18 &  ABOVE,862967,436007,426865,95,529746,266097,263634,15,333221,169910,163231,80
JHELUM,JHELUM,DISTRICT,60 &  ABOVE,123412,64955,58451,6,80213,41884,38329,,43199,23071,20122,6
JHELUM,JHELUM,DISTRICT,65 &  ABOVE,80698,42721,37974,3,53355,27983,25372,,27343,14738,12602,3
KASUR,KASUR,DISTRICT,ALL AGES,4081568,2085912,1995257,399,2840199,1454358,1385702,139,1241369,631554,609555,260
KASUR,KASUR,DISTRICT,UNDER 1,108758,55399,53359,,75427,38332,37095,,33331,17067,16264,
KASUR,KASUR,DISTRICT,UNDER 5,633768,319609,314159,,446927,225335,221592,,186841,94274,92567,
KASUR,KASUR,DISTRICT,UNDER 10,1146988,577539,569449,,813116,409405,403711,,333872,168134,165738,
KASUR,KASUR,DISTRICT,UNDER 15,1625043,818658,806368,17,1150772,579660,571105,7,474271,238998,235263,10
KASUR,KASUR,DISTRICT,05 - 24,1751984,883123,868714,147,1234947,624105,610791,51,517037,259018,257923,96
KASUR,KASUR,DISTRICT,15 - 49,1981440,1010541,970555,344,1360393,697361,662913,119,621047,313180,307642,225
KASUR,KASUR,DISTRICT,15 - 64,2312789,1188243,1124177,369,1587112,818478,768508,126,725677,369765,355669,243
KASUR,KASUR,DISTRICT,18 - 60,1993932,1025537,968065,330,1363370,704369,658891,110,630562,321168,309174,220
KASUR,KASUR,DISTRICT,18 &  ABOVE,2201901,1139517,1062041,343,1510133,784600,725417,116,691768,354917,336624,227
KASUR,KASUR,DISTRICT,60 &  ABOVE,230095,125840,104240,15,162012,88386,73620,6,68083,37454,30620,9
KASUR,KASUR,DISTRICT,65 &  ABOVE,143736,79011,64712,13,102315,56220,46089,6,41421,22791,18623,7
KHANEWAL,KHANEWAL,DISTRICT,ALL AGES,3363589,1734421,1628782,386,2646990,1367101,1279743,146,716599,367320,349039,240
KHANEWAL,KHANEWAL,DISTRICT,UNDER 1,79144,41465,37679,,64169,33555,30614,,14975,7910,7065,
KHANEWAL,KHANEWAL,DISTRICT,UNDER 5,474879,247050,227829,,384489,200265,184224,,90390,46785,43605,
KHANEWAL,KHANEWAL,DISTRICT,UNDER 10,907441,470685,436756,,732862,380750,352112,,174579,89935,84644,
KHANEWAL,KHANEWAL,DISTRICT,UNDER 15,1305910,680244,625656,10,1047596,546686,500901,9,258314,133558,124755,1
KHANEWAL,KHANEWAL,DISTRICT,05 - 24,1445937,749911,695897,129,1142672,594133,548489,50,303265,155778,147408,79
KHANEWAL,KHANEWAL,DISTRICT,15 - 49,1635975,831159,804477,339,1269861,646464,623280,117,366114,184695,181197,222
KHANEWAL,KHANEWAL,DISTRICT,15 - 64,1928354,985058,942928,368,1495870,765060,730676,134,432484,219998,212252,234
KHANEWAL,KHANEWAL,DISTRICT,18 - 60,1664231,845468,818427,336,1289631,656051,633462,118,374600,189417,184965,218
KHANEWAL,KHANEWAL,DISTRICT,18 &  ABOVE,1852918,946381,906190,347,1439436,736034,703279,123,413482,210347,202911,224
KHANEWAL,KHANEWAL,DISTRICT,60 &  ABOVE,206230,110076,96140,14,163599,87202,76390,7,42631,22874,19750,7
KHANEWAL,KHANEWAL,DISTRICT,65 &  ABOVE,129325,69119,60198,8,103524,55355,48166,3,25801,13764,12032,5
KHUSHAB,KHUSHAB,DISTRICT,ALL AGES,1500835,768006,732780,49,1082124,552375,529733,16,418711,215631,203047,33
KHUSHAB,KHUSHAB,DISTRICT,UNDER 1,34980,18264,16716,,25394,13158,12236,,9586,5106,4480,
KHUSHAB,KHUSHAB,DISTRICT,UNDER 5,207224,109797,97427,,147416,77322,70094,,59808,32475,27333,
KHUSHAB,KHUSHAB,DISTRICT,UNDER 10,371528,194313,177215,,266913,138536,128377,,104615,55777,48838,
KHUSHAB,KHUSHAB,DISTRICT,UNDER 15,529997,278006,251990,1,381239,198689,182549,1,148758,79317,69441,
KHUSHAB,KHUSHAB,DISTRICT,05 - 24,588472,304602,283855,15,424097,219104,204987,6,164375,85498,78868,9
KHUSHAB,KHUSHAB,DISTRICT,15 - 49,737116,367903,369168,45,528602,263824,264765,13,208514,104079,104403,32
KHUSHAB,KHUSHAB,DISTRICT,15 - 64,892577,448546,443983,48,641740,322289,319436,15,250837,126257,124547,33
KHUSHAB,KHUSHAB,DISTRICT,18 - 60,773147,385110,387991,46,555634,276620,279001,13,217513,108490,108990,33
KHUSHAB,KHUSHAB,DISTRICT,18 &  ABOVE,883693,443916,439731,46,638436,320656,317767,13,245257,123260,121964,33
KHUSHAB,KHUSHAB,DISTRICT,60 &  ABOVE,119696,63704,55991,1,89441,47577,41863,1,30255,16127,14128,
KHUSHAB,KHUSHAB,DISTRICT,65 &  ABOVE,78261,41454,36807,,59145,31397,27748,,19116,10057,9059,
LAHORE,LAHORE,DISTRICT,ALL AGES,12978661,6869574,6105711,3376,,,,,12978661,6869574,6105711,3376
LAHORE,LAHORE,DISTRICT,UNDER 1,253672,130775,122897,,,,,,253672,130775,122897,
LAHORE,LAHORE,DISTRICT,UNDER 5,1827636,949192,878444,,,,,,1827636,949192,878444,
LAHORE,LAHORE,DISTRICT,UNDER 10,3231990,1670348,1561642,,,,,,3231990,1670348,1561642,
LAHORE,LAHORE,DISTRICT,UNDER 15,4650433,2418492,2231847,94,,,,,4650433,2418492,2231847,94
LAHORE,LAHORE,DISTRICT,05 - 24,5260826,2763622,2496287,917,,,,,5260826,2763622,2496287,917
LAHORE,LAHORE,DISTRICT,15 - 49,6747489,3565859,3178604,3026,,,,,6747489,3565859,3178604,3026
LAHORE,LAHORE,DISTRICT,15 - 64,7877902,4188041,3686617,3244,,,,,7877902,4188041,3686617,3244
LAHORE,LAHORE,DISTRICT,18 - 60,6895145,3656718,3235342,3085,,,,,6895145,3656718,3235342,3085
LAHORE,LAHORE,DISTRICT,18 &  ABOVE,7565042,4044255,3517650,3137,,,,,7565042,4044255,3517650,3137
LAHORE,LAHORE,DISTRICT,60 &  ABOVE,750722,431599,319050,73,,,,,750722,431599,319050,73
LAHORE,LAHORE,DISTRICT,65 &  ABOVE,450326,263041,187247,38,,,,,450326,263041,187247,38
LAYYAH,LAYYAH,DISTRICT,ALL AGES,2102361,1082910,1019362,89,1716092,885141,830916,35,386269,197769,188446,54
LAYYAH,LAYYAH,DISTRICT,UNDER 1,65263,33947,31316,,55403,28705,26698,,9860,5242,4618,
LAYYAH,LAYYAH,DISTRICT,UNDER 5,330842,172282,158560,,278114,144834,133280,,52728,27448,25280,
LAYYAH,LAYYAH,DISTRICT,UNDER 10,604722,312080,292642,,506160,261366,244794,,98562,50714,47848,
LAYYAH,LAYYAH,DISTRICT,UNDER 15,859487,444481,415006,,716349,370527,345822,,143138,73954,69184,
LAYYAH,LAYYAH,DISTRICT,05 - 24,915687,471625,444043,19,753973,388899,365068,6,161714,82726,78975,13
LAYYAH,LAYYAH,DISTRICT,15 - 49,996485,505954,490453,78,803516,409123,394362,31,192969,96831,96091,47
LAYYAH,LAYYAH,DISTRICT,15 - 64,1169011,598576,570347,88,940114,482428,457651,35,228897,116148,112696,53
LAYYAH,LAYYAH,DISTRICT,18 - 60,1004939,511625,493230,84,806578,411631,394914,33,198361,99994,98316,51
LAYYAH,LAYYAH,DISTRICT,18 &  ABOVE,1111457,569543,541828,86,891813,457966,433813,34,219644,111577,108015,52
LAYYAH,LAYYAH,DISTRICT,60 &  ABOVE,115627,62940,52684,3,92408,50339,42068,1,23219,12601,10616,2
LAYYAH,LAYYAH,DISTRICT,65 &  ABOVE,73863,39853,34009,1,59629,32186,27443,,14234,7667,6566,1
LODHRAN,LODHRAN,DISTRICT,ALL AGES,1926357,996914,929326,117,1603155,830759,772347,49,323202,166155,156979,68
LODHRAN,LODHRAN,DISTRICT,UNDER 1,46210,24204,22006,,39054,20468,18586,,7156,3736,3420,
LODHRAN,LODHRAN,DISTRICT,UNDER 5,278877,145300,133577,,236508,123447,113061,,42369,21853,20516,
LODHRAN,LODHRAN,DISTRICT,UNDER 10,540664,280950,259714,,457467,238263,219204,,83197,42687,40510,
LODHRAN,LODHRAN,DISTRICT,UNDER 15,776354,406078,370274,2,653911,342669,311242,,122443,63409,59032,2
LODHRAN,LODHRAN,DISTRICT,05 - 24,851179,444558,406598,23,709123,371196,337920,7,142056,73362,68678,16
LODHRAN,LODHRAN,DISTRICT,15 - 49,921451,470947,450408,96,758495,388204,370251,40,162956,82743,80157,56
LODHRAN,LODHRAN,DISTRICT,15 - 64,1080129,554154,525862,113,890096,456878,433171,47,190033,97276,92691,66
LODHRAN,LODHRAN,DISTRICT,18 - 60,932869,476223,456539,107,768200,392321,375836,43,164669,83902,80703,64
LODHRAN,LODHRAN,DISTRICT,18 &  ABOVE,1032750,528679,503959,112,852417,436642,415728,47,180333,92037,88231,65
LODHRAN,LODHRAN,DISTRICT,60 &  ABOVE,109217,57312,51898,7,91938,48304,43628,6,17279,9008,8270,1
LODHRAN,LODHRAN,DISTRICT,65 &  ABOVE,69874,36682,33190,2,59148,31212,27934,2,10726,5470,5256,
MANDI BAHAUDDIN,MANDI BAHAUDDIN,DISTRICT,ALL AGES,1829152,916966,912047,139,1483259,743128,740049,82,345893,173838,171998,57
MANDI BAHAUDDIN,MANDI BAHAUDDIN,DISTRICT,UNDER 1,42430,22204,20226,,34691,18180,16511,,7739,4024,3715,
MANDI BAHAUDDIN,MANDI BAHAUDDIN,DISTRICT,UNDER 5,249176,129108,120068,,202685,105060,97625,,46491,24048,22443,
MANDI BAHAUDDIN,MANDI BAHAUDDIN,DISTRICT,UNDER 10,457547,235359,222188,,371647,191171,180476,,85900,44188,41712,
MANDI BAHAUDDIN,MANDI BAHAUDDIN,DISTRICT,UNDER 15,662274,342424,319848,2,537306,277763,259541,2,124968,64661,60307,
MANDI BAHAUDDIN,MANDI BAHAUDDIN,DISTRICT,05 - 24,743180,376497,366638,45,601859,304525,297301,33,141321,71972,69337,12
MANDI BAHAUDDIN,MANDI BAHAUDDIN,DISTRICT,15 - 49,887128,423126,463883,119,714048,339401,374577,70,173080,83725,89306,49
MANDI BAHAUDDIN,MANDI BAHAUDDIN,DISTRICT,15 - 64,1071555,520879,550542,134,864748,419486,445184,78,206807,101393,105358,56
MANDI BAHAUDDIN,MANDI BAHAUDDIN,DISTRICT,18 - 60,925110,444513,480471,126,745941,357531,388338,72,179169,86982,92133,54
MANDI BAHAUDDIN,MANDI BAHAUDDIN,DISTRICT,18 &  ABOVE,1058341,519015,539195,131,858151,420440,437636,75,200190,98575,101559,56
MANDI BAHAUDDIN,MANDI BAHAUDDIN,DISTRICT,60 &  ABOVE,144913,80797,64110,6,121902,68161,53738,3,23011,12636,10372,3
MANDI BAHAUDDIN,MANDI BAHAUDDIN,DISTRICT,65 &  ABOVE,95323,53663,41657,3,81205,45879,35324,2,14118,7784,6333,1
MIANWALI,MIANWALI,DISTRICT,ALL AGES,1795897,916977,878855,65,1432505,731081,701398,26,363392,185896,177457,39
MIANWALI,MIANWALI,DISTRICT,UNDER 1,37212,19283,17929,,30779,15929,14850,,6433,3354,3079,
MIANWALI,MIANWALI,DISTRICT,UNDER 5,245779,127487,118292,,200140,103839,96301,,45639,23648,21991,
MIANWALI,MIANWALI,DISTRICT,UNDER 10,454517,234591,219926,,368984,190523,178461,,85533,44068,41465,
MIANWALI,MIANWALI,DISTRICT,UNDER 15,653637,339255,314380,2,529929,275105,254822,2,123708,64150,59558,
MIANWALI,MIANWALI,DISTRICT,05 - 24,735836,381012,354797,27,593430,307676,285739,15,142406,73336,69058,12
MIANWALI,MIANWALI,DISTRICT,15 - 49,889013,446910,442047,56,703202,353254,349927,21,185811,93656,92120,35
MIANWALI,MIANWALI,DISTRICT,15 - 64,1059899,534488,525349,62,837402,421676,415703,23,222497,112812,109646,39
MIANWALI,MIANWALI,DISTRICT,18 - 60,914626,457678,456892,56,720653,359909,360724,20,193973,97769,96168,36
MIANWALI,MIANWALI,DISTRICT,18 &  ABOVE,1032869,520047,512764,58,813997,409195,404781,21,218872,110852,107983,37
MIANWALI,MIANWALI,DISTRICT,60 &  ABOVE,128611,67607,61002,2,101596,53452,48143,1,27015,14155,12859,1
MIANWALI,MIANWALI,DISTRICT,65 &  ABOVE,82361,43234,39126,1,65174,34300,30873,1,17187,8934,8253,
MULTAN,MULTAN,DISTRICT,ALL AGES,5340762,2720277,2620078,407,2859260,1450811,1408313,136,2481502,1269466,1211765,271
MULTAN,MULTAN,DISTRICT,UNDER 1,110143,55467,54676,,63840,32044,31796,,46303,23423,22880,
MULTAN,MULTAN,DISTRICT,UNDER 5,730275,367792,362483,,414169,207513,206656,,316106,160279,155827,
MULTAN,MULTAN,DISTRICT,UNDER 10,1398159,703614,694545,,803524,403668,399856,,594635,299946,294689,
MULTAN,MULTAN,DISTRICT,UNDER 15,2031752,1024001,1007740,11,1152465,579534,572923,8,879287,444467,434817,3
MULTAN,MULTAN,DISTRICT,05 - 24,2309198,1165168,1143900,130,1267574,638005,629527,42,1041624,527163,514373,88
MULTAN,MULTAN,DISTRICT,15 - 49,2677111,1356761,1320008,342,1381002,699219,681671,112,1296109,657542,638337,230
MULTAN,MULTAN,DISTRICT,15 - 64,3127784,1598534,1528864,386,1608827,819521,789182,124,1518957,779013,739682,262
MULTAN,MULTAN,DISTRICT,18 - 60,2716833,1385743,1330737,353,1392107,707984,684008,115,1324726,677759,646729,238
MULTAN,MULTAN,DISTRICT,18 &  ABOVE,2984597,1530414,1453819,364,1534099,783046,750934,119,1450498,747368,702885,245
MULTAN,MULTAN,DISTRICT,60 &  ABOVE,294803,159034,135752,17,155423,82139,73280,4,139380,76895,62472,13
MULTAN,MULTAN,DISTRICT,65 &  ABOVE,181226,97742,83474,10,97968,51756,46208,4,83258,45986,37266,6
MUZAFFARGARH,MUZAFFARGARH,DISTRICT,ALL AGES,5012124,2545343,2466672,109,4066845,2066288,2000493,64,945279,479055,466179,45
MUZAFFARGARH,MUZAFFARGARH,DISTRICT,UNDER 1,126945,63596,63349,,103769,52074,51695,,23176,11522,11654,
MUZAFFARGARH,MUZAFFARGARH,DISTRICT,UNDER 5,873811,441017,432794,,719654,362678,356976,,154157,78339,75818,
MUZAFFARGARH,MUZAFFARGARH,DISTRICT,UNDER 10,1617648,816143,801505,,1339808,675668,664140,,277840,140475,137365,
MUZAFFARGARH,MUZAFFARGARH,DISTRICT,UNDER 15,2267401,1145430,1121963,8,1873941,946696,927240,5,393460,198734,194723,3
MUZAFFARGARH,MUZAFFARGARH,DISTRICT,05 - 24,2295846,1160117,1135682,47,1882548,952682,929837,29,413298,207435,205845,18
MUZAFFARGARH,MUZAFFARGARH,DISTRICT,15 - 49,2247863,1136021,1111763,79,1797527,909710,887768,49,450336,226311,223995,30
MUZAFFARGARH,MUZAFFARGARH,DISTRICT,15 - 64,2589923,1317121,1272706,96,2067350,1052118,1015177,55,522573,265003,257529,41
MUZAFFARGARH,MUZAFFARGARH,DISTRICT,18 - 60,2213452,1122585,1090793,74,1764264,895680,868544,40,449188,226905,222249,34
MUZAFFARGARH,MUZAFFARGARH,DISTRICT,18 &  ABOVE,2432285,1239628,1192576,81,1940344,990093,950207,44,491941,249535,242369,37
MUZAFFARGARH,MUZAFFARGARH,DISTRICT,60 &  ABOVE,240047,128428,111611,8,192839,103411,89423,5,47208,25017,22188,3
MUZAFFARGARH,MUZAFFARGARH,DISTRICT,65 &  ABOVE,154800,82792,72003,5,125554,67474,58076,4,29246,15318,13927,1
NANKANA SAHIB,NANKANA SAHIB,DISTRICT,ALL AGES,1634871,831931,802859,81,1311483,669583,641867,33,323388,162348,160992,48
NANKANA SAHIB,NANKANA SAHIB,DISTRICT,UNDER 1,32502,16310,16192,,26567,13374,13193,,5935,2936,2999,
NANKANA SAHIB,NANKANA SAHIB,DISTRICT,UNDER 5,225626,113675,111951,,184736,93198,91538,,40890,20477,20413,
NANKANA SAHIB,NANKANA SAHIB,DISTRICT,UNDER 10,428600,215687,212913,,350988,177042,173946,,77612,38645,38967,
NANKANA SAHIB,NANKANA SAHIB,DISTRICT,UNDER 15,622023,313411,308609,3,505852,255327,250523,2,116171,58084,58086,1
NANKANA SAHIB,NANKANA SAHIB,DISTRICT,05 - 24,699279,352167,347099,13,562452,284072,278373,7,136827,68095,68726,6
NANKANA SAHIB,NANKANA SAHIB,DISTRICT,15 - 49,800681,402019,398602,60,635420,320671,314725,24,165261,81348,83877,36
NANKANA SAHIB,NANKANA SAHIB,DISTRICT,15 - 64,945979,480444,465461,74,750614,382825,367760,29,195365,97619,97701,45
NANKANA SAHIB,NANKANA SAHIB,DISTRICT,18 - 60,817227,413871,403286,70,648279,329999,318255,25,168948,83872,85031,45
NANKANA SAHIB,NANKANA SAHIB,DISTRICT,18 &  ABOVE,912417,467719,444623,75,725904,374009,351867,28,186513,93710,92756,47
NANKANA SAHIB,NANKANA SAHIB,DISTRICT,60 &  ABOVE,105734,59437,46290,7,86254,48587,37663,4,19480,10850,8627,3
NANKANA SAHIB,NANKANA SAHIB,DISTRICT,65 &  ABOVE,66869,38076,28789,4,55017,31431,23584,2,11852,6645,5205,2
NAROWAL,NAROWAL,DISTRICT,ALL AGES,1950769,996357,954327,85,1601749,818879,782824,46,349020,177478,171503,39
NAROWAL,NAROWAL,DISTRICT,UNDER 1,43429,22494,20935,,36440,18934,17506,,6989,3560,3429,
NAROWAL,NAROWAL,DISTRICT,UNDER 5,264740,136165,128575,,221256,113713,107543,,43484,22452,21032,
NAROWAL,NAROWAL,DISTRICT,UNDER 10,494799,253603,241196,,411942,211088,200854,,82857,42515,40342,
NAROWAL,NAROWAL,DISTRICT,UNDER 15,726378,372933,353443,2,602066,308824,293240,2,124312,64109,60203,
NAROWAL,NAROWAL,DISTRICT,05 - 24,843724,431178,412522,24,693636,354489,339131,16,150088,76689,73391,8
NAROWAL,NAROWAL,DISTRICT,15 - 49,962570,484428,478070,72,784582,396305,388240,37,177988,88123,89830,35
NAROWAL,NAROWAL,DISTRICT,15 - 64,1135801,575861,559858,82,924559,469898,454617,44,211242,105963,105241,38
NAROWAL,NAROWAL,DISTRICT,18 - 60,975833,493320,482436,77,793626,402632,390953,41,182207,90688,91483,36
NAROWAL,NAROWAL,DISTRICT,18 &  ABOVE,1099146,559781,539287,78,897212,458197,438974,41,201934,101584,100313,37
NAROWAL,NAROWAL,DISTRICT,60 &  ABOVE,135147,72725,62421,1,113297,60691,52606,,21850,12034,9815,1
NAROWAL,NAROWAL,DISTRICT,65 &  ABOVE,88590,47563,41026,1,75124,40157,34967,,13466,7406,6059,1
OKARA,OKARA,DISTRICT,ALL AGES,3503451,1783966,1719150,335,2327975,1187264,1140630,81,1175476,596702,578520,254
OKARA,OKARA,DISTRICT,UNDER 1,83210,42016,41194,,57199,29059,28140,,26011,12957,13054,
OKARA,OKARA,DISTRICT,UNDER 5,510496,257354,253142,,353822,178905,174917,,156674,78449,78225,
OKARA,OKARA,DISTRICT,UNDER 10,958545,482680,475865,,660492,333320,327172,,298053,149360,148693,
OKARA,OKARA,DISTRICT,UNDER 15,1366965,688742,678218,5,930593,469626,460964,3,436372,219116,217254,2
OKARA,OKARA,DISTRICT,05 - 24,1488690,749486,739126,78,991742,500451,491272,19,496948,249035,247854,59
OKARA,OKARA,DISTRICT,15 - 49,1683811,850138,833394,279,1091828,552551,539214,63,591983,297587,294180,216
OKARA,OKARA,DISTRICT,15 - 64,1992297,1015135,976842,320,1296580,661769,634736,75,695717,353366,342106,245
OKARA,OKARA,DISTRICT,18 - 60,1722582,875630,846652,300,1118455,569540,548847,68,604127,306090,297805,232
OKARA,OKARA,DISTRICT,18 &  ABOVE,1927822,989027,938481,314,1260033,647577,612384,72,667789,341450,326097,242
OKARA,OKARA,DISTRICT,60 &  ABOVE,225925,124376,101534,15,155491,85388,70099,4,70434,38988,31435,11
OKARA,OKARA,DISTRICT,65 &  ABOVE,144189,80089,64090,10,100802,55869,44930,3,43387,24220,19160,7
PAKPATTAN,PAKPATTAN,DISTRICT,ALL AGES,2135511,1085000,1050351,160,1662991,845572,817371,48,472520,239428,232980,112
PAKPATTAN,PAKPATTAN,DISTRICT,UNDER 1,60602,30656,29946,,47947,24236,23711,,12655,6420,6235,
PAKPATTAN,PAKPATTAN,DISTRICT,UNDER 5,339749,171837,167912,,269945,136439,133506,,69804,35398,34406,
PAKPATTAN,PAKPATTAN,DISTRICT,UNDER 10,613557,309577,303980,,487320,246129,241191,,126237,63448,62789,
PAKPATTAN,PAKPATTAN,DISTRICT,UNDER 15,865146,436746,428398,2,682732,344667,338064,1,182414,92079,90334,1
PAKPATTAN,PAKPATTAN,DISTRICT,05 - 24,898187,452897,445247,43,700113,353428,346672,13,198074,99469,98575,30
PAKPATTAN,PAKPATTAN,DISTRICT,15 - 49,997134,502286,494710,138,766067,386414,379615,38,231067,115872,115095,100
PAKPATTAN,PAKPATTAN,DISTRICT,15 - 64,1184386,601439,582789,158,911182,463093,448042,47,273204,138346,134747,111
PAKPATTAN,PAKPATTAN,DISTRICT,18 - 60,1018512,516002,502364,146,782579,396966,385571,42,235933,119036,116793,104
PAKPATTAN,PAKPATTAN,DISTRICT,18 &  ABOVE,1142695,583169,559379,147,881795,450763,430989,43,260900,132406,128390,104
PAKPATTAN,PAKPATTAN,DISTRICT,60 &  ABOVE,135017,73090,61924,3,107726,58428,49295,3,27291,14662,12629,
PAKPATTAN,PAKPATTAN,DISTRICT,65 &  ABOVE,85979,46815,39164,,69077,37812,31265,,16902,9003,7899,
RAHIM YAR KHAN,RAHIM YAR KHAN,DISTRICT,ALL AGES,5561720,2895390,2665779,551,4221634,2202377,2019061,196,1340086,693013,646718,355
RAHIM YAR KHAN,RAHIM YAR KHAN,DISTRICT,UNDER 1,130949,69354,61595,,100725,53342,47383,,30224,16012,14212,
RAHIM YAR KHAN,RAHIM YAR KHAN,DISTRICT,UNDER 5,884206,461982,422224,,695373,363166,332207,,188833,98816,90017,
RAHIM YAR KHAN,RAHIM YAR KHAN,DISTRICT,UNDER 10,1684241,880672,803569,,1326488,694238,632250,,357753,186434,171319,
RAHIM YAR KHAN,RAHIM YAR KHAN,DISTRICT,UNDER 15,2359967,1242553,1117405,9,1842525,971092,871430,3,517442,271461,245975,6
RAHIM YAR KHAN,RAHIM YAR KHAN,DISTRICT,05 - 24,2485728,1306286,1179290,152,1901974,1002019,899889,66,583754,304267,279401,86
RAHIM YAR KHAN,RAHIM YAR KHAN,DISTRICT,15 - 49,2578530,1322985,1255055,490,1915680,986333,929173,174,662850,336652,325882,316
RAHIM YAR KHAN,RAHIM YAR KHAN,DISTRICT,15 - 64,3009501,1550121,1458853,527,2232425,1152955,1079283,187,777076,397166,379570,340
RAHIM YAR KHAN,RAHIM YAR KHAN,DISTRICT,18 - 60,2596894,1330017,1266380,497,1924378,988444,935770,164,672516,341573,330610,333
RAHIM YAR KHAN,RAHIM YAR KHAN,DISTRICT,18 &  ABOVE,2871487,1476291,1394678,518,2131280,1098387,1032720,173,740207,377904,361958,345
RAHIM YAR KHAN,RAHIM YAR KHAN,DISTRICT,60 &  ABOVE,302147,160224,141895,28,227689,120411,107268,10,74458,39813,34627,18
RAHIM YAR KHAN,RAHIM YAR KHAN,DISTRICT,65 &  ABOVE,192252,102716,89521,15,146684,78330,68348,6,45568,24386,21173,9
RAJANPUR,RAJANPUR,DISTRICT,ALL AGES,2323980,1181789,1142073,118,1694281,865366,828896,19,629699,316423,313177,99
RAJANPUR,RAJANPUR,DISTRICT,UNDER 1,54793,27850,26943,,40742,20644,20098,,14051,7206,6845,
RAJANPUR,RAJANPUR,DISTRICT,UNDER 5,432259,218124,214135,,329056,166282,162774,,103203,51842,51361,
RAJANPUR,RAJANPUR,DISTRICT,UNDER 10,816895,412984,403911,,624037,316534,307503,,192858,96450,96408,
RAJANPUR,RAJANPUR,DISTRICT,UNDER 15,1120165,567502,552657,6,847719,431389,416327,3,272446,136113,136330,3
RAJANPUR,RAJANPUR,DISTRICT,05 - 24,1090832,553299,537497,36,803798,410980,392807,11,287034,142319,144690,25
RAJANPUR,RAJANPUR,DISTRICT,15 - 49,983689,497080,486505,104,691190,350814,340362,14,292499,146266,146143,90
RAJANPUR,RAJANPUR,DISTRICT,15 - 64,1133821,576911,556799,111,796066,406696,389354,16,337755,170215,167445,95
RAJANPUR,RAJANPUR,DISTRICT,18 - 60,967146,489887,477158,101,677989,344252,333727,10,289157,145635,143431,91
RAJANPUR,RAJANPUR,DISTRICT,18 &  ABOVE,1065405,542416,522886,103,748073,382021,366042,10,317332,160395,156844,93
RAJANPUR,RAJANPUR,DISTRICT,60 &  ABOVE,108053,57701,50349,3,77145,41543,35601,1,30908,16158,14748,2
RAJANPUR,RAJANPUR,DISTRICT,65 &  ABOVE,69994,37376,32617,1,50496,27281,23215,,19498,10095,9402,1
RAWALPINDI,RAWALPINDI,DISTRICT,ALL AGES,6058540,3080830,2976366,1344,1907111,940438,966634,39,4151429,2140392,2009732,1305
RAWALPINDI,RAWALPINDI,DISTRICT,UNDER 1,99994,49826,50168,,31931,15860,16071,,68063,33966,34097,
RAWALPINDI,RAWALPINDI,DISTRICT,UNDER 5,720719,360954,359765,,219302,108954,110348,,501417,252000,249417,
RAWALPINDI,RAWALPINDI,DISTRICT,UNDER 10,1361599,681771,679828,,420937,208760,212177,,940662,473011,467651,
RAWALPINDI,RAWALPINDI,DISTRICT,UNDER 15,2018679,1011168,1007498,13,623233,308625,314608,,1395446,702543,692890,13
RAWALPINDI,RAWALPINDI,DISTRICT,05 - 24,2402521,1205837,1196404,280,737240,361592,375639,9,1665281,844245,820765,271
RAWALPINDI,RAWALPINDI,DISTRICT,15 - 49,3155573,1594656,1559679,1238,964074,468354,495690,30,2191499,1126302,1063989,1208
RAWALPINDI,RAWALPINDI,DISTRICT,15 - 64,3758078,1915938,1840828,1312,1168594,572163,596396,35,2589484,1343775,1244432,1277
RAWALPINDI,RAWALPINDI,DISTRICT,18 - 60,3277665,1668399,1607984,1282,1014446,495030,519384,32,2263219,1173369,1088600,1250
RAWALPINDI,RAWALPINDI,DISTRICT,18 &  ABOVE,3683757,1890616,1791838,1303,1174248,578190,596022,36,2509509,1312426,1195816,1267
RAWALPINDI,RAWALPINDI,DISTRICT,60 &  ABOVE,444786,242386,202370,30,173222,89948,83270,4,271564,152438,119100,26
RAWALPINDI,RAWALPINDI,DISTRICT,65 &  ABOVE,281783,153724,128040,19,115284,59650,55630,4,166499,94074,72410,15
SAHIWAL,SAHIWAL,DISTRICT,ALL AGES,2878122,1458981,1418988,153,2124128,1077060,1046981,87,753994,381921,372007,66
SAHIWAL,SAHIWAL,DISTRICT,UNDER 1,76287,39199,37088,,57884,29935,27949,,18403,9264,9139,
SAHIWAL,SAHIWAL,DISTRICT,UNDER 5,423460,213805,209655,,319596,161542,158054,,103864,52263,51601,
SAHIWAL,SAHIWAL,DISTRICT,UNDER 10,772183,389221,382962,,583848,294971,288877,,188335,94250,94085,
SAHIWAL,SAHIWAL,DISTRICT,UNDER 15,1095044,552226,542809,9,821692,414752,406934,6,273352,137474,135875,3
SAHIWAL,SAHIWAL,DISTRICT,05 - 24,1177306,592907,584357,42,871657,438969,432661,27,305649,153938,151696,15
SAHIWAL,SAHIWAL,DISTRICT,15 - 49,1388059,695369,692573,117,1008770,505454,503253,63,379289,189915,189320,54
SAHIWAL,SAHIWAL,DISTRICT,15 - 64,1660566,839776,820653,137,1208412,610975,597362,75,452154,228801,223291,62
SAHIWAL,SAHIWAL,DISTRICT,18 - 60,1435549,723415,712006,128,1043256,525897,517293,66,392293,197518,194713,62
SAHIWAL,SAHIWAL,DISTRICT,18 &  ABOVE,1615324,821275,793913,136,1179885,600064,579748,73,435439,221211,214165,63
SAHIWAL,SAHIWAL,DISTRICT,60 &  ABOVE,195906,106546,89349,11,148532,80600,67923,9,47374,25946,21426,2
SAHIWAL,SAHIWAL,DISTRICT,65 &  ABOVE,122512,66979,55526,7,94024,51333,42685,6,28488,15646,12841,1
SARGODHA,SARGODHA,DISTRICT,ALL AGES,4327263,2190707,2136175,381,2722559,1378026,1344409,124,1604704,812681,791766,257
SARGODHA,SARGODHA,DISTRICT,UNDER 1,98484,49910,48574,,65880,33721,32159,,32604,16189,16415,
SARGODHA,SARGODHA,DISTRICT,UNDER 5,592348,297927,294421,,385381,194567,190814,,206967,103360,103607,
SARGODHA,SARGODHA,DISTRICT,UNDER 10,1089643,547438,542205,,706438,355595,350843,,383205,191843,191362,
SARGODHA,SARGODHA,DISTRICT,UNDER 15,1577387,792941,784440,6,1012129,508698,503426,5,565258,284243,281014,1
SARGODHA,SARGODHA,DISTRICT,05 - 24,1787958,897891,889943,124,1121169,561955,559168,46,666789,335936,330775,78
SARGODHA,SARGODHA,DISTRICT,15 - 49,2136588,1066000,1070251,337,1316276,656378,659788,110,820312,409622,410463,227
SARGODHA,SARGODHA,DISTRICT,15 - 64,2550022,1286693,1262962,367,1576368,794900,781350,118,973654,491793,481612,249
SARGODHA,SARGODHA,DISTRICT,18 - 60,2202854,1106610,1095899,345,1358975,682623,676242,110,843879,423987,419657,235
SARGODHA,SARGODHA,DISTRICT,18 &  ABOVE,2485801,1263840,1221604,357,1545408,785950,759346,112,940393,477890,462258,245
SARGODHA,SARGODHA,DISTRICT,60 &  ABOVE,310545,171843,138684,18,203871,112573,91292,6,106674,59270,47392,12
SARGODHA,SARGODHA,DISTRICT,65 &  ABOVE,199854,111073,88773,8,134062,74428,59633,1,65792,36645,29140,7
SHEIKHUPURA,SHEIKHUPURA,DISTRICT,ALL AGES,4049377,2079359,1969412,606,2498625,1286433,1211837,355,1550752,792926,757575,251
SHEIKHUPURA,SHEIKHUPURA,DISTRICT,UNDER 1,94139,47243,46896,,59886,30217,29669,,34253,17026,17227,
SHEIKHUPURA,SHEIKHUPURA,DISTRICT,UNDER 5,603772,305007,298765,,377892,190710,187182,,225880,114297,111583,
SHEIKHUPURA,SHEIKHUPURA,DISTRICT,UNDER 10,1087191,548078,539113,,683023,344203,338820,,404168,203875,200293,
SHEIKHUPURA,SHEIKHUPURA,DISTRICT,UNDER 15,1558354,786110,772208,36,975037,490789,484225,23,583317,295321,287983,13
SHEIKHUPURA,SHEIKHUPURA,DISTRICT,05 - 24,1732576,874640,857659,277,1078543,544505,533842,196,654033,330135,323817,81
SHEIKHUPURA,SHEIKHUPURA,DISTRICT,15 - 49,2018767,1028119,990113,535,1233643,632322,601006,315,785124,395797,389107,220
SHEIKHUPURA,SHEIKHUPURA,DISTRICT,15 - 64,2355333,1213509,1141261,563,1437979,745303,692347,329,917354,468206,448914,234
SHEIKHUPURA,SHEIKHUPURA,DISTRICT,18 - 60,2040427,1050735,989232,460,1243873,645268,598351,254,796554,405467,390881,206
SHEIKHUPURA,SHEIKHUPURA,DISTRICT,18 &  ABOVE,2238363,1165876,1072018,469,1367231,717177,649796,258,871132,448699,422222,211
SHEIKHUPURA,SHEIKHUPURA,DISTRICT,60 &  ABOVE,223387,129030,94343,14,138937,80444,58488,5,84450,48586,35855,9
SHEIKHUPURA,SHEIKHUPURA,DISTRICT,65 &  ABOVE,135690,79740,55943,7,85609,50341,35265,3,50081,29399,20678,4
SIALKOT,SIALKOT,DISTRICT,ALL AGES,4472462,2265012,2206591,859,3017087,1519345,1497543,199,1455375,745667,709048,660
SIALKOT,SIALKOT,DISTRICT,UNDER 1,95350,49376,45974,,66673,34400,32273,,28677,14976,13701,
SIALKOT,SIALKOT,DISTRICT,UNDER 5,606524,314078,292446,,417596,215873,201723,,188928,98205,90723,
SIALKOT,SIALKOT,DISTRICT,UNDER 10,1116259,574768,541491,,767921,394480,373441,,348338,180288,168050,
SIALKOT,SIALKOT,DISTRICT,UNDER 15,1632098,843903,787798,397,1119387,577462,541922,3,512711,266441,245876,394
SIALKOT,SIALKOT,DISTRICT,05 - 24,1896348,969058,926773,517,1294419,658094,636269,56,601929,310964,290504,461
SIALKOT,SIALKOT,DISTRICT,15 - 49,2236469,1096520,1139543,406,1493025,725121,767732,172,743444,371399,371811,234
SIALKOT,SIALKOT,DISTRICT,15 - 64,2649852,1314755,1334644,453,1766572,869254,897128,190,883280,445501,437516,263
SIALKOT,SIALKOT,DISTRICT,18 - 60,2287938,1125227,1162283,428,1520386,740986,779224,176,767552,384241,383059,252
SIALKOT,SIALKOT,DISTRICT,18 &  ABOVE,2559384,1276385,1282559,440,1705271,843258,861830,183,854113,433127,420729,257
SIALKOT,SIALKOT,DISTRICT,60 &  ABOVE,301486,166958,134513,15,204586,112592,91987,7,96900,54366,42526,8
SIALKOT,SIALKOT,DISTRICT,65 &  ABOVE,190512,106354,84149,9,131128,72629,58493,6,59384,33725,25656,3
TOBA TEK SINGH,TOBA TEK SINGH,DISTRICT,ALL AGES,2524044,1295646,1228162,236,1960519,1006994,953434,91,563525,288652,274728,145
TOBA TEK SINGH,TOBA TEK SINGH,DISTRICT,UNDER 1,54526,28492,26034,,43154,22523,20631,,11372,5969,5403,
TOBA TEK SINGH,TOBA TEK SINGH,DISTRICT,UNDER 5,323405,167549,155856,,256557,132808,123749,,66848,34741,32107,
TOBA TEK SINGH,TOBA TEK SINGH,DISTRICT,UNDER 10,621491,319491,302000,,492591,253064,239527,,128900,66427,62473,
TOBA TEK SINGH,TOBA TEK SINGH,DISTRICT,UNDER 15,906891,468916,437973,2,713311,368329,344980,2,193580,100587,92993,
TOBA TEK SINGH,TOBA TEK SINGH,DISTRICT,05 - 24,1049793,540425,509324,44,817203,420704,396481,18,232590,119721,112843,26
TOBA TEK SINGH,TOBA TEK SINGH,DISTRICT,15 - 49,1255313,632222,622894,197,964236,486404,477757,75,291077,145818,145137,122
TOBA TEK SINGH,TOBA TEK SINGH,DISTRICT,15 - 64,1499870,761424,738217,229,1153088,586205,566795,88,346782,175219,171422,141
TOBA TEK SINGH,TOBA TEK SINGH,DISTRICT,18 - 60,1298267,654897,643152,218,997097,503909,493107,81,301170,150988,150045,137
TOBA TEK SINGH,TOBA TEK SINGH,DISTRICT,18 &  ABOVE,1465741,747526,717989,226,1130226,577590,552552,84,335515,169936,165437,142
TOBA TEK SINGH,TOBA TEK SINGH,DISTRICT,60 &  ABOVE,182912,100515,82387,10,145146,79808,65334,4,37766,20707,17053,6
TOBA TEK SINGH,TOBA TEK SINGH,DISTRICT,65 &  ABOVE,117283,65306,51972,5,94120,52460,41659,1,23163,12846,10313,4
VEHARI,VEHARI,DISTRICT,ALL AGES,3428191,1733665,1694087,439,2645727,1339615,1305872,240,782464,394050,388215,199
VEHARI,VEHARI,DISTRICT,UNDER 1,82831,41393,41438,,64608,32351,32257,,18223,9042,9181,
VEHARI,VEHARI,DISTRICT,UNDER 5,509050,256032,253018,,396361,199673,196688,,112689,56359,56330,
VEHARI,VEHARI,DISTRICT,UNDER 10,940756,472603,468153,,734070,369043,365027,,206686,103560,103126,
VEHARI,VEHARI,DISTRICT,UNDER 15,1337959,672674,665258,27,1040186,523372,516792,22,297773,149302,148466,5
VEHARI,VEHARI,DISTRICT,05 - 24,1442169,724452,717553,164,1113768,560043,553606,119,328401,164409,163947,45
VEHARI,VEHARI,DISTRICT,15 - 49,1649707,825579,823763,365,1262807,633285,629322,200,386900,192294,194441,165
VEHARI,VEHARI,DISTRICT,15 - 64,1957284,988529,968349,406,1499826,758659,740952,215,457458,229870,227397,191
VEHARI,VEHARI,DISTRICT,18 - 60,1695438,853906,841176,356,1299253,655693,643383,177,396185,198213,197793,179
VEHARI,VEHARI,DISTRICT,18 &  ABOVE,1888478,958716,929396,366,1451233,738037,713014,182,437245,220679,216382,184
VEHARI,VEHARI,DISTRICT,60 &  ABOVE,212866,115027,97827,12,167272,90187,77079,6,45594,24840,20748,6
VEHARI,VEHARI,DISTRICT,65 &  ABOVE,132948,72462,60480,6,105715,57584,48128,3,27233,14878,12352,3
